fighter_name,date,opponent,method,method_points,strike_bonus,round_bonus,total_points
Tony Ferguson,2015-02-28,Gleison Tibau,Submission,90,9,0,99
Tony Ferguson,2023-07-29,Bobby Green,Submission,0,0,0,0
Tony Ferguson,2020-05-09,Justin Gaethje,KO/TKO,0,0,25,25
Tony Ferguson,2021-05-15,Beneil Dariush,Decision - Unanimous,0,0,0,0
Tony Ferguson,2011-06-04,Ramsey Nijem,KO/TKO,100,9,0,109
Tony Ferguson,2015-12-11,Edson Barboza,Submission,90,20,0,110
Tony Ferguson,2015-07-15,Josh Thomson,Decision - Unanimous,80,50,0,130
Tony Ferguson,2020-12-12,Charles Oliveira,Decision - Unanimous,0,0,0,0
Tony Ferguson,2014-08-30,Danny Castillo,Decision - Split,70,0,0,70
Tony Ferguson,2023-12-16,Paddy Pimblett,Decision - Unanimous,0,0,0,0
Tony Ferguson,2022-05-07,Michael Chandler,KO/TKO,0,0,0,0
Tony Ferguson,2016-11-05,Rafael Dos Anjos,Decision - Unanimous,80,78,25,183
Tony Ferguson,2018-10-06,Anthony Pettis,KO/TKO,100,69,0,169
Tony Ferguson,2016-07-13,Lando Vannata,Submission,90,26,0,116
Tony Ferguson,2022-09-10,Nate Diaz,Submission,0,0,25,25
Tony Ferguson,2014-12-06,Abel Trujillo,Submission,90,5,0,95
Tony Ferguson,2013-10-19,Mike Rio,Submission,90,1,0,91
Tony Ferguson,2011-09-24,Aaron Riley,TKO - Doctor's Stoppage,0,20,0,20
Tony Ferguson,2011-12-03,Yves Edwards,Decision - Unanimous,80,16,0,96
Tony Ferguson,2019-06-08,Donald Cerrone,TKO - Doctor's Stoppage,0,36,0,36
Tony Ferguson,2024-08-03,Michael Chiesa,Submission,0,6,0,6
Tony Ferguson,2012-05-05,Michael Johnson,Decision - Unanimous,0,0,0,0
Tony Ferguson,2017-10-07,Kevin Lee,Submission,90,0,25,115
Tony Ferguson,2014-05-24,Katsunori Kikuno,KO/TKO,100,16,0,116
Gleison Tibau,2015-02-28,Tony Ferguson,Submission,0,0,0,0
Gleison Tibau,2007-06-12,Jeff Cox,Submission,90,3,0,93
Gleison Tibau,2013-05-18,John Cholish,Submission,90,12,0,102
Gleison Tibau,2011-03-19,Kurt Pellegrino,Decision - Split,70,0,0,70
Gleison Tibau,2012-07-07,Khabib Nurmagomedov,Decision - Unanimous,0,3,0,3
Gleison Tibau,2008-02-02,Tyson Griffin,Decision - Unanimous,0,0,0,0
Gleison Tibau,2009-02-07,Rich Clementi,Submission,90,6,0,96
Gleison Tibau,2018-01-20,Islam Makhachev,KO/TKO,0,0,0,0
Gleison Tibau,2013-12-28,Michael Johnson,KO/TKO,0,0,0,0
Gleison Tibau,2006-11-18,Nick Diaz,KO/TKO,0,0,0,0
Gleison Tibau,2014-07-16,Pat Healy,Decision - Unanimous,80,0,0,80
Gleison Tibau,2009-06-20,Melvin Guillard,Decision - Split,0,1,0,1
Gleison Tibau,2011-11-19,Rafael Dos Anjos,Decision - Split,70,31,0,101
Gleison Tibau,2009-04-01,Jeremy Stephens,Decision - Unanimous,80,0,0,80
Gleison Tibau,2007-09-08,Terry Etim,Decision - Unanimous,80,0,0,80
Gleison Tibau,2009-10-24,Josh Neer,Decision - Unanimous,80,0,0,80
Gleison Tibau,2007-03-03,Jason Dent,Decision - Unanimous,80,24,0,104
Gleison Tibau,2013-08-31,Jamie Varner,Decision - Split,70,0,0,70
Gleison Tibau,2011-05-28,Rafaello Oliveira,Submission,90,7,0,97
Gleison Tibau,2008-07-05,Joe Stevenson,Submission,0,0,0,0
Gleison Tibau,2015-11-07,Abel Trujillo,DQ,0,3,0,3
Gleison Tibau,2010-03-31,Caol Uno,KO/TKO,100,16,0,116
Gleison Tibau,2012-10-13,Francisco Trinaldo,Decision - Unanimous,80,0,0,80
Gleison Tibau,2015-01-18,Norman Parke,Decision - Split,70,0,0,70
Gleison Tibau,2014-09-13,Piotr Hallmann,Decision - Split,70,0,0,70
Gleison Tibau,2013-02-02,Evan Dunham,Decision - Split,0,0,0,0
Gleison Tibau,2018-06-01,Desmond Green,Decision - Unanimous,0,0,0,0
Gleison Tibau,2010-09-15,Jim Miller,Decision - Unanimous,0,0,0,0
Jailton Almeida,2023-01-21,Shamil Abdurakhimov,KO/TKO,100,44,0,144
Jailton Almeida,2022-02-05,Danilo Marques,KO/TKO,100,30,0,130
Jailton Almeida,2024-06-01,Alexandr Romanov,Submission,90,0,0,90
Jailton Almeida,2023-11-04,Derrick Lewis,Decision - Unanimous,80,18,25,123
Jailton Almeida,2023-05-13,Jairzinho Rozenstruik,Submission,90,4,25,119
Jailton Almeida,2022-09-10,Anton Turkalj,Submission,90,16,0,106
Jailton Almeida,2021-09-14,Nasrudin Nasrudinov,Submission,90,0,0,90
Jailton Almeida,2022-05-21,Parker Porter,Submission,90,18,0,108
Jailton Almeida,2024-03-09,Curtis Blaydes,KO/TKO,0,0,0,0
Shamil Abdurakhimov,2023-01-21,Jailton Almeida,KO/TKO,0,0,0,0
Shamil Abdurakhimov,2015-04-04,Timothy Johnson,KO/TKO,0,0,0,0
Shamil Abdurakhimov,2021-09-25,Chris Daukaus,KO/TKO,0,0,0,0
Shamil Abdurakhimov,2016-02-21,Anthony Hamilton,Decision - Unanimous,80,22,0,102
Shamil Abdurakhimov,2016-12-09,Derrick Lewis,KO/TKO,0,0,25,25
Shamil Abdurakhimov,2022-03-19,Sergei Pavlovich,KO/TKO,0,0,0,0
Shamil Abdurakhimov,2018-09-15,Andrei Arlovski,Decision - Unanimous,80,14,0,94
Shamil Abdurakhimov,2017-11-25,Chase Sherman,KO/TKO,100,1,0,101
Shamil Abdurakhimov,2016-10-01,Walt Harris,Decision - Split,70,14,0,84
Shamil Abdurakhimov,2019-04-20,Marcin Tybura,KO/TKO,100,8,0,108
Shamil Abdurakhimov,2019-09-07,Curtis Blaydes,KO/TKO,0,0,0,0
Tim Boetsch,2013-10-19,CB Dollaway,Decision - Split,70,0,0,70
Tim Boetsch,2016-01-17,Ed Herman,KO/TKO,0,0,0,0
Tim Boetsch,2012-02-25,Yushin Okami,KO/TKO,100,13,0,113
Tim Boetsch,2008-04-02,Matt Hamill,KO/TKO,0,0,0,0
Tim Boetsch,2008-02-02,David Heath,KO/TKO,100,35,0,135
Tim Boetsch,2017-02-11,Jacare Souza,Submission,0,0,0,0
Tim Boetsch,2012-07-21,Hector Lombard,Decision - Split,70,28,0,98
Tim Boetsch,2019-03-09,Omari Akhmedov,Decision - Unanimous,0,0,0,0
Tim Boetsch,2014-04-26,Luke Rockhold,Submission,0,0,0,0
Tim Boetsch,2015-06-06,Dan Henderson,KO/TKO,0,0,25,25
Tim Boetsch,2013-07-06,Mark Munoz,Decision - Unanimous,0,0,0,0
Tim Boetsch,2011-09-24,Nick Ring,Decision - Unanimous,80,17,0,97
Tim Boetsch,2014-08-16,Brad Tavares,KO/TKO,100,0,0,100
Tim Boetsch,2016-11-12,Rafael Natal,KO/TKO,100,9,0,109
Tim Boetsch,2015-01-31,Thales Leites,Submission,0,6,0,6
Tim Boetsch,2010-11-20,Phil Davis,Submission,0,0,0,0
Tim Boetsch,2012-12-29,Constantinos Philippou,KO/TKO,0,0,0,0
Tim Boetsch,2018-04-14,Antonio Carlos Junior,Submission,0,0,0,0
Tim Boetsch,2011-05-28,Kendall Grove,Decision - Unanimous,80,0,0,80
Tim Boetsch,2009-03-07,Jason Brilz,Decision - Unanimous,0,0,0,0
Tim Boetsch,2016-07-13,Josh Samman,KO/TKO,100,21,0,121
Tim Boetsch,2017-06-25,Johny Hendricks,KO/TKO,100,31,0,131
Tim Boetsch,2008-09-06,Michael Patt,KO/TKO,100,6,0,106
Tim Boetsch,2010-08-07,Todd Brown,Decision - Unanimous,80,32,0,112
CB Dollaway,2013-10-19,Tim Boetsch,Decision - Split,0,16,0,16
CB Dollaway,2009-07-11,Tom Lawlor,Submission,0,1,0,1
CB Dollaway,2014-03-23,Cezar Ferreira,KO/TKO,100,9,0,109
CB Dollaway,2010-02-20,Goran Reljic,Decision - Unanimous,80,5,0,85
CB Dollaway,2009-09-16,Jay Silva,Decision - Unanimous,80,13,0,93
CB Dollaway,2012-05-26,Jason Miller,Decision - Unanimous,80,15,0,95
CB Dollaway,2018-09-15,Khalid Murtazaliev,KO/TKO,0,0,0,0
CB Dollaway,2015-04-25,Michael Bisping,Decision - Unanimous,0,0,0,0
CB Dollaway,2008-12-27,Mike Massenzio,KO/TKO,100,6,0,106
CB Dollaway,2014-12-20,Lyoto Machida,KO/TKO,0,0,25,25
CB Dollaway,2017-07-07,Ed Herman,Decision - Unanimous,80,30,0,110
CB Dollaway,2011-08-14,Jared Hamman,KO/TKO,0,0,0,0
CB Dollaway,2018-03-03,Hector Lombard,DQ,0,0,0,0
CB Dollaway,2013-01-19,Daniel Sarafian,Decision - Split,70,24,0,94
CB Dollaway,2008-07-19,Jesse Taylor,Submission,90,0,0,90
CB Dollaway,2015-12-19,Nate Marquardt,KO/TKO,0,0,0,0
CB Dollaway,2010-09-25,Joe Doerksen,Submission,90,0,0,90
CB Dollaway,2014-05-31,Francis Carmont,Decision - Unanimous,80,15,0,95
CB Dollaway,2011-03-03,Mark Munoz,KO/TKO,0,0,0,0
CB Dollaway,2008-06-21,Amir Sadollah,Submission,0,4,0,4
Kimo Leopoldo,2003-06-06,David Abbott,Submission,90,1,0,91
Kimo Leopoldo,1994-09-09,Royce Gracie,Submission,0,4,0,4
Kimo Leopoldo,1998-03-13,Tsuyoshi Kohsaka,Decision - Unanimous,0,0,0,0
Kimo Leopoldo,2005-07-17,Ikuhisa Minowa,Submission,0,0,0,0
Kimo Leopoldo,2004-06-19,Ken Shamrock,KO/TKO,0,0,0,0
Kimo Leopoldo,1996-02-16,Ken Shamrock,Submission,0,4,0,4
Kimo Leopoldo,1996-12-07,Paul Varelans,KO/TKO,100,0,0,100
David Abbott,2003-06-06,Kimo Leopoldo,Submission,0,0,0,0
David Abbott,1998-10-16,Pedro Rizzo,KO/TKO,0,0,0,0
David Abbott,1996-12-07,Cal Worsham,KO/TKO,100,0,0,100
David Abbott,1996-12-07,Don Frye,Submission,0,7,0,7
David Abbott,2003-11-21,Wesley Correira,TKO - Doctor's Stoppage,0,0,0,0
David Abbott,1996-12-07,Steve Nelmark,KO/TKO,100,7,0,107
David Abbott,1997-10-17,Maurice Smith,Submission,0,0,0,0
David Abbott,2003-02-28,Frank Mir,Submission,0,1,0,1
David Abbott,1996-09-20,Scott Ferrozzo,Decision - Unanimous,0,0,0,0
David Abbott,1995-07-14,John Matua,KO/TKO,100,7,0,107
David Abbott,1997-12-21,Yoji Anjo,Decision - Unanimous,80,4,0,84
David Abbott,2008-02-16,Kevin Ferguson,KO/TKO,0,0,0,0
David Abbott,1995-12-16,Steve Jennum,Submission,90,1,0,91
David Abbott,1995-07-14,Oleg Taktarov,Submission,0,13,0,13
David Abbott,2006-10-07,Paul Buentello,KO/TKO,0,0,0,0
David Abbott,1995-07-14,Paul Varelans,KO/TKO,100,13,0,113
David Abbott,1996-09-20,Sam Adkins,Submission,90,8,0,98
David Abbott,1998-05-15,Hugo Duarte,KO/TKO,100,11,0,111
David Abbott,2005-08-28,Hidehiko Yoshida,Submission,0,0,0,0
David Abbott,1997-05-30,Vitor Belfort,KO/TKO,0,0,0,0
David Abbott,1995-12-16,Dan Severn,Decision - Unanimous,0,0,0,0
Rodrigo Gracie,2003-10-05,Daiju Takase,Decision - Unanimous,80,29,0,109
Rodrigo Gracie,2002-12-23,Yuki Sasaki,Decision - Unanimous,80,6,0,86
Rodrigo Gracie,2004-11-20,BJ Penn,Decision - Unanimous,0,0,0,0
Rodrigo Gracie,2004-02-15,Hayato Sakurai,Decision - Unanimous,80,14,0,94
Rodrigo Gracie,2002-02-24,Daijiro Matsui,Submission,90,14,0,104
Daiju Takase,2003-10-05,Rodrigo Gracie,Decision - Unanimous,0,0,0,0
Daiju Takase,2004-05-23,Carlos Newton,Decision - Split,70,0,0,70
Daiju Takase,1999-11-19,Kenichi Yamamoto,Decision - Unanimous,0,0,0,0
Daiju Takase,2003-06-08,Anderson Silva,Submission,90,0,0,90
Daiju Takase,2004-02-15,Chris Brennan,Decision - Unanimous,80,2,0,82
Daiju Takase,2003-12-31,Hayato Sakurai,Decision - Unanimous,0,0,0,0
Daiju Takase,2000-12-16,Fabiano Iha,KO/TKO,0,0,0,0
Daiju Takase,1998-06-24,Emmanuel Yarborough,KO/TKO,100,14,0,114
Daiju Takase,2005-04-03,Daniel Acacio,KO/TKO,0,0,0,0
Daiju Takase,1999-07-16,Jeremy Horn,KO/TKO,0,0,0,0
Tim Sylvia,2002-09-27,Wesley Correira,KO/TKO,100,112,0,212
Tim Sylvia,2008-02-02,Antonio Rodrigo Nogueira,Submission,0,25,25,50
Tim Sylvia,2004-06-19,Frank Mir,Submission,0,0,25,25
Tim Sylvia,2005-02-05,Andrei Arlovski,Submission,0,0,25,25
Tim Sylvia,2005-08-20,Tra Telligman,KO/TKO,100,18,0,118
Tim Sylvia,2007-03-03,Randy Couture,Decision - Unanimous,0,0,25,25
Tim Sylvia,2003-09-26,Gan McGee,KO/TKO,100,3,25,128
Tim Sylvia,2006-04-15,Andrei Arlovski,KO/TKO,100,2,25,127
Tim Sylvia,2006-01-16,Assuerio Silva,Decision - Unanimous,80,49,0,129
Tim Sylvia,2006-07-08,Andrei Arlovski,Decision - Unanimous,80,31,25,136
Tim Sylvia,2003-02-28,Ricco Rodriguez,KO/TKO,100,5,25,130
Tim Sylvia,2008-07-19,Fedor Emelianenko,Submission,0,0,25,25
Tim Sylvia,2006-11-18,Jeff Monson,Decision - Unanimous,80,37,25,142
Tim Sylvia,2007-10-20,Brandon Vera,Decision - Unanimous,80,10,0,90
Wesley Correira,2002-09-27,Tim Sylvia,KO/TKO,0,0,0,0
Wesley Correira,2003-11-21,David Abbott,TKO - Doctor's Stoppage,0,2,0,2
Wesley Correira,2007-02-10,Antonio Silva,KO/TKO,0,0,0,0
Wesley Correira,2003-04-25,Sean Alvarez,KO/TKO,100,16,0,116
Wesley Correira,2004-04-02,Andrei Arlovski,KO/TKO,0,0,0,0
Darren Elkins,2014-10-25,Lucas Martins,Decision - Split,70,21,0,91
Darren Elkins,2018-11-17,Ricardo Lamas,KO/TKO,0,0,0,0
Darren Elkins,2010-03-21,Duane Ludwig,KO/TKO,100,0,0,100
Darren Elkins,2020-05-16,Nate Landwehr,Decision - Unanimous,0,3,0,3
Darren Elkins,2012-11-17,Steven Siler,Decision - Unanimous,80,29,0,109
Darren Elkins,2013-08-28,Hatsu Hioki,Decision - Unanimous,80,17,0,97
Darren Elkins,2010-08-01,Charles Oliveira,Submission,0,0,0,0
Darren Elkins,2018-01-14,Michael Johnson,Submission,90,0,0,90
Darren Elkins,2016-03-05,Chas Skelly,Decision - Unanimous,80,77,0,157
Darren Elkins,2013-04-20,Chad Mendes,KO/TKO,0,0,0,0
Darren Elkins,2015-10-24,Robert Whiteford,Decision - Unanimous,80,17,0,97
Darren Elkins,2022-12-03,Jonathan Pearce,Decision - Unanimous,0,0,0,0
Darren Elkins,2012-05-26,Diego Brandao,Decision - Unanimous,80,13,0,93
Darren Elkins,2011-10-08,Zhang Tiequan,Decision - Unanimous,80,25,0,105
Darren Elkins,2014-12-20,Hacran Dias,Decision - Unanimous,0,7,0,7
Darren Elkins,2017-07-22,Dennis Bermudez,Decision - Split,70,1,0,71
Darren Elkins,2013-03-16,Antonio Carvalho,KO/TKO,100,5,0,105
Darren Elkins,2022-04-30,Tristan Connelly,Decision - Unanimous,80,9,0,89
Darren Elkins,2014-01-25,Jeremy Stephens,Decision - Unanimous,0,0,0,0
Darren Elkins,2020-11-07,Eduardo Garagorri,Submission,90,0,0,90
Darren Elkins,2018-07-14,Alexander Volkanovski,Decision - Unanimous,0,0,0,0
Darren Elkins,2017-03-04,Mirsad Bektic,KO/TKO,100,0,0,100
Darren Elkins,2023-10-14,TJ Brown,Submission,90,0,0,90
Darren Elkins,2019-07-13,Ryan Hall,Decision - Unanimous,0,0,0,0
Darren Elkins,2021-12-18,Cub Swanson,KO/TKO,0,0,0,0
Darren Elkins,2011-06-11,Michihiro Omigawa,Decision - Unanimous,80,13,0,93
Darren Elkins,2016-07-23,Godofredo Pepey,Decision - Unanimous,80,13,0,93
Darren Elkins,2021-07-24,Darrick Minner,KO/TKO,100,1,0,101
Darren Elkins,2024-10-19,Daniel Pineda,Decision - Unanimous,80,8,0,88
Lucas Martins,2014-10-25,Darren Elkins,Decision - Split,0,0,0,0
Lucas Martins,2013-05-18,Jeremy Larsen,KO/TKO,100,0,0,100
Lucas Martins,2015-05-30,Mirsad Bektic,KO/TKO,0,0,0,0
Lucas Martins,2013-09-04,Ramiro Hernandez,Submission,90,6,0,96
Lucas Martins,2013-01-19,Edson Barboza,KO/TKO,0,0,0,0
Lucas Martins,2016-04-10,Robert Whiteford,Decision - Split,70,0,0,70
Lucas Martins,2014-07-16,Alex White,KO/TKO,100,11,0,111
Sean Strickland,2021-05-01,Krzysztof Jotko,Decision - Unanimous,80,47,0,127
Sean Strickland,2020-11-14,Brendan Allen,KO/TKO,100,43,0,143
Sean Strickland,2023-07-01,Abus Magomedov,KO/TKO,100,34,25,159
Sean Strickland,2017-11-11,Court McGee,Decision - Unanimous,80,16,0,96
Sean Strickland,2017-04-08,Kamaru Usman,Decision - Unanimous,0,0,0,0
Sean Strickland,2024-06-01,Paulo Costa,Decision - Split,70,24,25,119
Sean Strickland,2014-03-15,Robert McDaniel,Submission,90,16,0,106
Sean Strickland,2023-01-14,Nassourdine Imavov,Decision - Unanimous,80,59,25,164
Sean Strickland,2021-07-31,Uriah Hall,Decision - Unanimous,80,79,25,184
Sean Strickland,2015-02-22,Santiago Ponzinibbio,Decision - Unanimous,0,0,0,0
Sean Strickland,2023-09-09,Israel Adesanya,Decision - Unanimous,80,43,25,148
Sean Strickland,2018-10-27,Nordine Taleb,KO/TKO,100,17,0,117
Sean Strickland,2018-05-12,Elizeu Zaleski dos Santos,KO/TKO,0,0,0,0
Sean Strickland,2016-02-21,Alex Garcia,KO/TKO,100,61,0,161
Sean Strickland,2015-07-15,Igor Araujo,Decision - Unanimous,80,32,0,112
Sean Strickland,2022-12-17,Jared Cannonier,Decision - Split,0,11,25,36
Sean Strickland,2022-02-05,Jack Hermansson,Decision - Split,70,16,25,111
Sean Strickland,2016-06-04,Tom Breese,Decision - Split,70,11,0,81
Sean Strickland,2014-05-31,Luke Barnatt,Decision - Split,70,4,0,74
Sean Strickland,2024-01-20,Dricus Du Plessis,Decision - Split,0,36,25,61
Sean Strickland,2020-10-31,Jack Marshman,Decision - Unanimous,80,58,0,138
Sean Strickland,2022-07-02,Alex Pereira,KO/TKO,0,0,0,0
Krzysztof Jotko,2021-05-01,Sean Strickland,Decision - Unanimous,0,0,0,0
Krzysztof Jotko,2019-04-20,Alen Amedovski,Decision - Unanimous,80,37,0,117
Krzysztof Jotko,2019-07-27,Marc-Andre Barriault,Decision - Split,70,1,0,71
Krzysztof Jotko,2021-10-02,Misha Cirkunov,Decision - Split,70,0,0,70
Krzysztof Jotko,2022-10-01,Brendan Allen,Submission,0,0,0,0
Krzysztof Jotko,2020-05-16,Eryk Anders,Decision - Unanimous,80,25,0,105
Krzysztof Jotko,2017-09-16,Uriah Hall,KO/TKO,0,18,0,18
Krzysztof Jotko,2014-10-04,Tor Troeng,Decision - Unanimous,80,59,0,139
Krzysztof Jotko,2022-04-30,Gerald Meerschaert,Decision - Unanimous,80,28,0,108
Krzysztof Jotko,2016-06-18,Tamdan McCrory,KO/TKO,100,2,0,102
Krzysztof Jotko,2013-12-06,Bruno Santos,Decision - Unanimous,80,5,0,85
Krzysztof Jotko,2014-05-31,Magnus Cedenblad,Submission,0,0,0,0
Krzysztof Jotko,2015-10-24,Scott Askham,Decision - Split,70,16,0,86
Krzysztof Jotko,2016-11-19,Thales Leites,Decision - Unanimous,80,38,0,118
Krzysztof Jotko,2017-05-13,David Branch,Decision - Split,0,0,0,0
Krzysztof Jotko,2016-02-27,Brad Scott,Decision - Unanimous,80,14,0,94
Krzysztof Jotko,2018-04-14,Brad Tavares,KO/TKO,0,0,0,0
Royce Gracie,1993-11-12,Ken Shamrock,Submission,90,0,0,90
Royce Gracie,1994-03-11,Minoki Ichihara,Submission,90,0,0,90
Royce Gracie,1994-09-09,Kimo Leopoldo,Submission,90,0,0,90
Royce Gracie,1994-12-16,Dan Severn,Submission,90,0,0,90
Royce Gracie,2006-05-27,Matt Hughes,KO/TKO,0,0,0,0
Royce Gracie,1993-11-12,Art Jimmerson,Submission,90,0,0,90
Royce Gracie,2000-01-30,Nobuhiko Takada,Decision - Unanimous,80,0,0,80
Royce Gracie,2000-05-01,Kazushi Sakuraba,KO/TKO,0,0,0,0
Royce Gracie,1994-03-11,Remco Pardoel,Submission,90,0,0,90
Royce Gracie,1994-12-16,Keith Hackney,Submission,90,7,0,97
Royce Gracie,1993-11-12,Gerard Gordeau,Submission,90,1,0,91
Royce Gracie,1994-03-11,Jason DeLucia,Submission,90,0,0,90
Royce Gracie,2007-06-02,Kazushi Sakuraba,Decision - Unanimous,80,9,0,89
Royce Gracie,1994-12-16,Ron van Clief,Submission,90,7,0,97
Royce Gracie,1994-03-11,Patrick Smith,KO/TKO,100,3,0,103
Ken Shamrock,1993-11-12,Royce Gracie,Submission,0,0,0,0
Ken Shamrock,1996-12-07,Brian Johnston,Submission,90,21,0,111
Ken Shamrock,2006-07-08,Tito Ortiz,KO/TKO,0,0,0,0
Ken Shamrock,1995-07-14,Dan Severn,Submission,90,0,0,90
Ken Shamrock,2000-05-01,Alexander Otsuka,KO/TKO,100,32,0,132
Ken Shamrock,2005-04-09,Rich Franklin,KO/TKO,0,0,0,0
Ken Shamrock,2002-11-22,Tito Ortiz,KO/TKO,0,0,25,25
Ken Shamrock,2005-10-23,Kazushi Sakuraba,KO/TKO,0,0,0,0
Ken Shamrock,1996-05-17,Dan Severn,Decision - Split,0,2,0,2
Ken Shamrock,2004-06-19,Kimo Leopoldo,KO/TKO,100,8,0,108
Ken Shamrock,2002-02-24,Don Frye,Decision - Split,0,0,0,0
Ken Shamrock,1994-09-09,Christophe Leninger,KO/TKO,100,7,0,107
Ken Shamrock,1994-09-09,Felix Lee Mitchell,Submission,90,1,0,91
Ken Shamrock,1993-11-12,Patrick Smith,Submission,90,0,0,90
Ken Shamrock,2006-10-10,Tito Ortiz,KO/TKO,0,0,0,0
Ken Shamrock,2000-08-27,Kazuyuki Fujita,KO/TKO,0,14,0,14
Ken Shamrock,1996-02-16,Kimo Leopoldo,Submission,90,0,0,90
Jeff Cox,2007-06-12,Gleison Tibau,Submission,0,0,0,0
Jeff Cox,2008-04-02,Manvel Gamburyan,Submission,0,0,0,0
Elves Brener,2023-11-04,Kaynan Kruschewsky,KO/TKO,100,8,0,108
Elves Brener,2024-08-03,Joel Alvarez,KO/TKO,0,0,0,0
Elves Brener,2024-05-04,Myktybek Orolbai,Decision - Unanimous,0,0,0,0
Elves Brener,2023-07-01,Guram Kutateladze,KO/TKO,100,0,0,100
Elves Brener,2023-02-11,Zubaira Tukhugov,Decision - Split,70,0,0,70
Kaynan Kruschewsky,2023-11-04,Elves Brener,KO/TKO,0,0,0,0
Kaynan Kruschewsky,2024-07-20,Kurt Holobaugh,Decision - Unanimous,0,0,0,0
Kaynan Kruschewsky,2023-09-19,Dylan Mantello,Submission,90,10,0,100
Joachim Hansen,2005-07-17,Masakazu Imanari,KO/TKO,100,3,0,103
Joachim Hansen,2006-12-31,Shinya Aoki,Submission,0,0,0,0
Joachim Hansen,2005-09-25,Hayato Sakurai,Decision - Unanimous,0,0,0,0
Joachim Hansen,2005-09-25,Yves Edwards,Decision - Split,70,0,0,70
Joachim Hansen,2010-03-22,Bibiano Fernandes,Decision - Split,0,9,0,9
Joachim Hansen,2010-05-29,Hiroyuki Takaya,KO/TKO,0,1,0,1
Joachim Hansen,2011-09-24,Tatsuya Kawajiri,Submission,0,0,0,0
Joachim Hansen,2008-03-15,Kotetsu Boku,Decision - Unanimous,80,5,0,85
Joachim Hansen,2007-02-24,Jason Ireland,Submission,90,11,0,101
Joachim Hansen,2008-07-21,Shinya Aoki,KO/TKO,100,11,0,111
Joachim Hansen,2006-04-02,Luiz Azeredo,KO/TKO,100,0,0,100
Joachim Hansen,2011-05-29,Mitsuhiro Ishida,Decision - Split,70,0,0,70
Joachim Hansen,2008-05-11,Eddie Alvarez,Decision - Unanimous,0,0,0,0
Joachim Hansen,2009-10-06,Shinya Aoki,Submission,0,10,0,10
Joachim Hansen,2008-07-21,Kultar Gill,Submission,90,0,0,90
Joachim Hansen,2010-09-25,Hideo Tokoro,Submission,90,9,0,99
Masakazu Imanari,2005-07-17,Joachim Hansen,KO/TKO,0,0,0,0
Masakazu Imanari,2011-05-29,Kenji Osawa,Submission,90,0,0,90
Masakazu Imanari,2011-07-16,Hideo Tokoro,Decision - Unanimous,0,0,0,0
Masakazu Imanari,2009-03-08,Atsushi Yamamoto,Decision - Split,70,0,0,70
Masakazu Imanari,2004-10-14,Luiz Firmino,Decision - Unanimous,0,0,0,0
Masakazu Imanari,2009-05-26,Bibiano Fernandes,Decision - Unanimous,0,0,0,0
Masakazu Imanari,2011-12-31,Antonio Banuelos,Decision - Split,0,0,0,0
Masakazu Imanari,2011-09-24,Abel Cullum,Submission,90,0,0,90
Jacare Souza,2014-02-15,Francis Carmont,Decision - Unanimous,80,0,0,80
Jacare Souza,2015-12-12,Yoel Romero,Decision - Split,0,0,0,0
Jacare Souza,2015-04-18,Chris Camozzi,Submission,90,0,0,90
Jacare Souza,2019-04-27,Jack Hermansson,Decision - Unanimous,0,0,25,25
Jacare Souza,2018-05-12,Kelvin Gastelum,Decision - Split,0,11,0,11
Jacare Souza,2017-02-11,Tim Boetsch,Submission,90,1,0,91
Jacare Souza,2009-12-19,Matt Lindland,Submission,90,9,0,99
Jacare Souza,2021-05-15,Andre Muniz,Submission,0,4,0,4
Jacare Souza,2019-11-16,Jan Blachowicz,Decision - Split,0,0,25,25
Jacare Souza,2018-11-03,Chris Weidman,KO/TKO,100,6,0,106
Jacare Souza,2008-04-29,Ian Murphy,Submission,90,7,0,97
Jacare Souza,2013-05-18,Chris Camozzi,Submission,90,4,0,94
Jacare Souza,2010-05-15,Joey Villasenor,Decision - Unanimous,80,32,0,112
Jacare Souza,2013-09-04,Yushin Okami,KO/TKO,100,27,0,127
Jacare Souza,2013-01-12,Ed Herman,Submission,90,4,0,94
Jacare Souza,2014-09-05,Gegard Mousasi,Submission,90,6,25,121
Jacare Souza,2016-05-14,Vitor Belfort,KO/TKO,100,35,0,135
Jacare Souza,2010-08-21,Tim Kennedy,Decision - Unanimous,80,0,25,105
Jacare Souza,2011-01-29,Robbie Lawler,Submission,90,0,25,115
Jacare Souza,2011-09-10,Luke Rockhold,Decision - Unanimous,0,0,25,25
Jacare Souza,2012-03-03,Bristol Marunde,Submission,90,27,0,117
Jacare Souza,2020-12-12,Kevin Holland,KO/TKO,0,0,0,0
Jacare Souza,2008-09-23,Gegard Mousasi,KO/TKO,0,0,0,0
Jacare Souza,2018-01-27,Derek Brunson,KO/TKO,100,1,25,126
Jacare Souza,2008-06-15,Jason Miller,Decision - Unanimous,80,0,0,80
Jacare Souza,2008-09-23,Zelg Galesic,Submission,90,3,0,93
Jacare Souza,2017-04-15,Robert Whittaker,KO/TKO,0,0,0,0
Jacare Souza,2012-08-18,Derek Brunson,KO/TKO,100,5,0,105
Francis Carmont,2014-02-15,Jacare Souza,Decision - Unanimous,0,3,0,3
Francis Carmont,2011-10-29,Chris Camozzi,Decision - Unanimous,80,29,0,109
Francis Carmont,2013-09-21,Constantinos Philippou,Decision - Unanimous,80,22,0,102
Francis Carmont,2012-07-11,Karlos Vemola,Submission,90,1,0,91
Francis Carmont,2012-04-14,Magnus Cedenblad,Submission,90,17,0,107
Francis Carmont,2014-08-23,Thales Leites,KO/TKO,0,0,0,0
Francis Carmont,2012-11-17,Tom Lawlor,Decision - Split,70,14,0,84
Francis Carmont,2013-04-20,Lorenz Larkin,Decision - Unanimous,80,0,0,80
Francis Carmont,2014-05-31,CB Dollaway,Decision - Unanimous,0,0,0,0
Mike Swick,2008-06-07,Marcus Davis,Decision - Unanimous,80,1,0,81
Mike Swick,2006-03-04,Steve Vigneault,Submission,90,7,0,97
Mike Swick,2009-06-13,Ben Saunders,KO/TKO,100,0,0,100
Mike Swick,2003-03-27,Kengo Ura,KO/TKO,100,14,0,114
Mike Swick,2007-04-07,Yushin Okami,Decision - Unanimous,0,0,0,0
Mike Swick,2006-05-27,Joe Riggs,Submission,90,4,0,94
Mike Swick,2009-11-14,Dan Hardy,Decision - Unanimous,0,0,0,0
Mike Swick,2004-01-16,Chris Leben,KO/TKO,0,0,25,25
Mike Swick,2005-08-06,Gideon Ray,KO/TKO,100,6,0,106
Mike Swick,2015-07-11,Alex Garcia,Decision - Unanimous,0,0,0,0
Mike Swick,2005-04-09,Alex Schoenauer,KO/TKO,100,6,0,106
Mike Swick,2010-02-06,Paulo Thiago,Submission,0,0,0,0
Mike Swick,2012-12-08,Matt Brown,KO/TKO,0,0,0,0
Mike Swick,2008-01-23,Joshua Burkman,Decision - Majority,75,15,0,90
Mike Swick,2012-08-04,DaMarques Johnson,KO/TKO,100,2,0,102
Mike Swick,2008-12-10,Jonathan Goulet,KO/TKO,100,6,0,106
Mike Swick,2006-09-23,David Loiseau,Decision - Unanimous,80,0,0,80
Marcus Davis,2008-06-07,Mike Swick,Decision - Unanimous,0,0,0,0
Marcus Davis,2005-11-05,Melvin Guillard,TKO - Doctor's Stoppage,0,0,0,0
Marcus Davis,2007-04-07,Pete Spratt,Submission,90,0,0,90
Marcus Davis,2007-06-16,Jason Tan,KO/TKO,100,3,0,103
Marcus Davis,2009-01-17,Chris Lytle,Decision - Split,70,0,0,70
Marcus Davis,2011-01-01,Jeremy Stephens,KO/TKO,0,0,0,0
Marcus Davis,2008-10-18,Paul Kelly,Submission,90,22,0,112
Marcus Davis,2007-09-08,Paul Taylor,Submission,90,8,0,98
Marcus Davis,2006-10-10,Forrest Petz,Submission,90,28,0,118
Marcus Davis,2006-12-13,Shonie Carter,Decision - Unanimous,80,27,0,107
Marcus Davis,2010-05-08,Jonathan Goulet,KO/TKO,100,6,0,106
Marcus Davis,2008-01-19,Jess Liaudin,KO/TKO,100,1,0,101
Marcus Davis,2010-08-28,Nate Diaz,Submission,0,0,0,0
Marcus Davis,2009-06-13,Dan Hardy,Decision - Split,0,0,0,0
Marcus Davis,2009-11-21,Ben Saunders,KO/TKO,0,0,0,0
Charles Oliveira,2015-05-30,Nik Lentz,Submission,90,27,0,117
Charles Oliveira,2021-05-15,Michael Chandler,KO/TKO,100,0,25,125
Charles Oliveira,2018-12-15,Jim Miller,Submission,90,0,0,90
Charles Oliveira,2018-06-09,Clay Guida,Submission,90,5,0,95
Charles Oliveira,2016-11-05,Ricardo Lamas,Submission,0,2,0,2
Charles Oliveira,2020-03-14,Kevin Lee,Submission,90,2,25,117
Charles Oliveira,2010-08-01,Darren Elkins,Submission,90,3,0,93
Charles Oliveira,2017-12-02,Paul Felder,KO/TKO,0,0,0,0
Charles Oliveira,2018-09-22,Christos Giagos,Submission,90,10,0,100
Charles Oliveira,2014-02-15,Andy Ogle,Submission,90,2,0,92
Charles Oliveira,2020-12-12,Tony Ferguson,Decision - Unanimous,80,22,0,102
Charles Oliveira,2021-12-11,Dustin Poirier,Submission,90,15,25,130
Charles Oliveira,2014-06-28,Hatsu Hioki,Submission,90,13,0,103
Charles Oliveira,2010-09-15,Efrain Escudero,Submission,90,22,0,112
Charles Oliveira,2019-02-02,David Teymur,Submission,90,2,0,92
Charles Oliveira,2022-05-07,Justin Gaethje,Submission,90,9,25,124
Charles Oliveira,2019-11-16,Jared Gordon,KO/TKO,100,3,0,103
Charles Oliveira,2012-01-28,Eric Wisely,Submission,90,4,0,94
Charles Oliveira,2010-12-11,Jim Miller,Submission,0,4,0,4
Charles Oliveira,2013-07-06,Frankie Edgar,Decision - Unanimous,0,0,0,0
Charles Oliveira,2019-05-18,Nik Lentz,KO/TKO,100,20,0,120
Charles Oliveira,2017-04-08,Will Brooks,Submission,90,0,0,90
Charles Oliveira,2022-10-22,Islam Makhachev,Submission,0,0,25,25
Charles Oliveira,2016-08-27,Anthony Pettis,Submission,0,0,0,0
Charles Oliveira,2024-11-16,Michael Chandler,Decision - Unanimous,80,4,25,109
Charles Oliveira,2023-06-10,Beneil Dariush,KO/TKO,100,14,0,114
Charles Oliveira,2012-09-22,Cub Swanson,KO/TKO,0,0,0,0
Charles Oliveira,2011-08-14,Donald Cerrone,KO/TKO,0,0,0,0
Charles Oliveira,2014-12-12,Jeremy Stephens,Decision - Unanimous,80,0,0,80
Charles Oliveira,2015-12-19,Myles Jury,Submission,90,0,0,90
Charles Oliveira,2012-06-01,Jonathan Brookins,Submission,90,15,0,105
Charles Oliveira,2015-08-23,Max Holloway,KO/TKO,0,0,25,25
Charles Oliveira,2024-04-13,Arman Tsarukyan,Decision - Split,0,0,0,0
Nik Lentz,2015-05-30,Charles Oliveira,Submission,0,0,0,0
Nik Lentz,2017-11-18,Will Brooks,Submission,90,0,0,90
Nik Lentz,2019-02-17,Scott Holtzman,Decision - Unanimous,80,17,0,97
Nik Lentz,2021-01-23,Movsar Evloev,Decision - Split,0,0,0,0
Nik Lentz,2020-01-25,Arnold Allen,Decision - Unanimous,0,0,0,0
Nik Lentz,2012-01-28,Evan Dunham,TKO - Doctor's Stoppage,0,0,0,0
Nik Lentz,2017-02-11,Islam Makhachev,Decision - Unanimous,0,0,0,0
Nik Lentz,2013-05-18,Hacran Dias,Decision - Unanimous,80,2,0,82
Nik Lentz,2010-03-31,Rob Emerson,Decision - Unanimous,80,22,0,102
Nik Lentz,2018-06-01,David Teymur,Decision - Unanimous,0,0,0,0
Nik Lentz,2018-10-06,Gray Maynard,KO/TKO,100,62,0,162
Nik Lentz,2016-09-10,Michael McBride,KO/TKO,100,22,0,122
Nik Lentz,2009-09-19,Rafaello Oliveira,Decision - Unanimous,80,38,0,118
Nik Lentz,2010-11-20,Tyson Griffin,Decision - Split,70,3,0,73
Nik Lentz,2011-12-10,Mark Bocek,Decision - Unanimous,0,0,0,0
Nik Lentz,2014-05-10,Manvel Gamburyan,Decision - Unanimous,80,24,0,104
Nik Lentz,2010-08-28,Andre Winner,Decision - Unanimous,80,3,0,83
Nik Lentz,2013-12-14,Chad Mendes,Decision - Unanimous,0,5,0,5
Nik Lentz,2019-05-18,Charles Oliveira,KO/TKO,0,0,0,0
Nik Lentz,2012-08-11,Eiji Mitsuoka,KO/TKO,100,28,0,128
Nik Lentz,2013-01-19,Diego Nunes,Decision - Unanimous,80,38,0,118
Nik Lentz,2015-12-19,Danny Castillo,Decision - Split,70,2,0,72
Nik Lentz,2011-03-26,Waylon Lowe,Submission,90,5,0,95
Anthony Smith,2017-09-16,Hector Lombard,KO/TKO,100,0,0,100
Anthony Smith,2013-01-12,Roger Gracie,Submission,0,1,0,1
Anthony Smith,2011-11-18,Adlan Amagov,KO/TKO,0,0,0,0
Anthony Smith,2016-02-21,Leonardo Guimaraes,Decision - Unanimous,80,0,0,80
Anthony Smith,2021-09-18,Ryan Spann,Submission,90,9,25,124
Anthony Smith,2023-08-26,Ryan Spann,Decision - Split,70,32,0,102
Anthony Smith,2023-05-13,Johnny Walker,Decision - Unanimous,0,0,0,0
Anthony Smith,2024-06-29,Roman Dolidze,Decision - Unanimous,0,0,0,0
Anthony Smith,2018-02-03,Thiago Santos,KO/TKO,0,0,0,0
Anthony Smith,2024-05-04,Vitor Petrino,Submission,90,1,0,91
Anthony Smith,2024-12-07,Dominick Reyes,KO/TKO,0,0,0,0
Anthony Smith,2018-10-27,Volkan Oezdemir,Submission,90,0,25,115
Anthony Smith,2023-12-09,Khalil Rountree Jr.,KO/TKO,0,0,0,0
Anthony Smith,2018-06-09,Rashad Evans,KO/TKO,100,5,0,105
Anthony Smith,2020-05-13,Glover Teixeira,KO/TKO,0,0,25,25
Anthony Smith,2013-06-08,Antonio Braga Neto,Submission,0,0,0,0
Anthony Smith,2018-07-22,Mauricio Rua,KO/TKO,100,19,25,144
Anthony Smith,2019-03-02,Jon Jones,Decision - Unanimous,0,0,25,25
Anthony Smith,2019-06-01,Alexander Gustafsson,Submission,90,0,25,115
Anthony Smith,2012-08-18,Lumumba Sayers,Submission,90,11,0,101
Anthony Smith,2020-08-29,Aleksandar Rakic,Decision - Unanimous,0,0,0,0
Anthony Smith,2016-12-03,Elvis Mutapcic,KO/TKO,100,19,0,119
Anthony Smith,2016-07-08,Cezar Ferreira,Decision - Unanimous,0,3,0,3
Anthony Smith,2020-11-28,Devin Clark,Submission,90,0,25,115
Anthony Smith,2017-04-15,Andrew Sanchez,KO/TKO,100,0,0,100
Anthony Smith,2022-07-30,Magomed Ankalaev,KO/TKO,0,0,0,0
Anthony Smith,2021-04-24,Jimmy Crute,TKO - Doctor's Stoppage,0,8,0,8
Hector Lombard,2017-09-16,Anthony Smith,KO/TKO,0,30,0,30
Hector Lombard,2013-03-02,Yushin Okami,Decision - Split,0,8,0,8
Hector Lombard,2006-11-05,Gegard Mousasi,Decision - Unanimous,0,0,0,0
Hector Lombard,2018-09-22,Thales Leites,Decision - Unanimous,0,0,0,0
Hector Lombard,2016-06-04,Dan Henderson,KO/TKO,0,10,0,10
Hector Lombard,2012-07-21,Tim Boetsch,Decision - Split,0,0,0,0
Hector Lombard,2017-02-19,Johny Hendricks,Decision - Unanimous,0,0,0,0
Hector Lombard,2016-03-19,Neil Magny,KO/TKO,0,0,0,0
Hector Lombard,2018-03-03,CB Dollaway,DQ,0,6,0,6
Hector Lombard,2012-12-14,Rousimar Palhares,KO/TKO,100,18,0,118
Hector Lombard,2014-03-15,Jake Shields,Decision - Unanimous,80,23,0,103
Hector Lombard,2013-10-19,Nate Marquardt,KO/TKO,100,6,0,106
Hector Lombard,2006-06-04,Akihiro Gono,Decision - Unanimous,0,0,0,0
Blagoy Ivanov,2022-05-07,Marcos Rogerio de Lima,Decision - Unanimous,80,0,0,80
Blagoy Ivanov,2019-11-02,Derrick Lewis,Decision - Split,0,0,0,0
Blagoy Ivanov,2019-06-08,Tai Tuivasa,Decision - Unanimous,80,9,0,89
Blagoy Ivanov,2023-07-01,Alexandr Romanov,Decision - Unanimous,0,0,0,0
Blagoy Ivanov,2020-05-30,Augusto Sakai,Decision - Split,0,0,0,0
Blagoy Ivanov,2023-02-04,Marcin Tybura,Decision - Unanimous,0,0,0,0
Blagoy Ivanov,2019-03-09,Ben Rothwell,Decision - Unanimous,80,2,0,82
Blagoy Ivanov,2018-07-14,Junior Dos Santos,Decision - Unanimous,0,0,25,25
Marcos Rogerio de Lima,2022-05-07,Blagoy Ivanov,Decision - Unanimous,0,6,0,6
Marcos Rogerio de Lima,2023-07-29,Derrick Lewis,KO/TKO,0,0,0,0
Marcos Rogerio de Lima,2014-12-20,Igor Pokrajac,KO/TKO,100,15,0,115
Marcos Rogerio de Lima,2016-04-23,Clint Hester,Submission,90,29,0,119
Marcos Rogerio de Lima,2011-09-10,Mike Kyle,Decision - Unanimous,0,0,0,0
Marcos Rogerio de Lima,2014-05-31,Richardson Moreira,KO/TKO,100,4,0,104
Marcos Rogerio de Lima,2016-11-19,Gadzhimurad Antigulov,Submission,0,2,0,2
Marcos Rogerio de Lima,2020-02-22,Ben Sosoli,KO/TKO,100,14,0,114
Marcos Rogerio de Lima,2017-01-28,Jeremy Kimball,KO/TKO,100,7,0,107
Marcos Rogerio de Lima,2023-04-29,Waldo Cortes-Acosta,Decision - Unanimous,80,0,0,80
Marcos Rogerio de Lima,2022-10-29,Andrei Arlovski,Submission,90,4,0,94
Marcos Rogerio de Lima,2017-04-22,Ovince Saint Preux,Submission,0,0,0,0
Marcos Rogerio de Lima,2019-02-23,Stefan Struve,Submission,0,25,0,25
Marcos Rogerio de Lima,2021-05-08,Maurice Greene,Decision - Unanimous,80,9,0,89
Marcos Rogerio de Lima,2018-11-03,Adam Wieczorek,Decision - Unanimous,80,21,0,101
Marcos Rogerio de Lima,2020-11-07,Alexandr Romanov,Submission,0,12,0,12
Marcos Rogerio de Lima,2015-08-23,Nikita Krylov,Submission,0,0,0,0
Marcos Rogerio de Lima,2024-02-17,Junior Tafa,KO/TKO,100,22,0,122
Marcos Rogerio de Lima,2021-11-13,Ben Rothwell,KO/TKO,100,12,0,112
Lukasz Brzeski,2024-04-06,Valter Walker,Decision - Unanimous,80,25,0,105
Lukasz Brzeski,2024-12-07,Kennedy Nzechukwu,KO/TKO,0,3,0,3
Lukasz Brzeski,2023-03-11,Karl Williams,Decision - Unanimous,0,0,0,0
Lukasz Brzeski,2021-09-14,Dylan Potter,Submission,90,37,0,127
Lukasz Brzeski,2023-08-26,Waldo Cortes-Acosta,KO/TKO,0,0,0,0
Lukasz Brzeski,2022-08-13,Martin Buday,Decision - Split,0,52,0,52
Lukasz Brzeski,2024-07-27,Mick Parkin,KO/TKO,0,0,0,0
Valter Walker,2024-04-06,Lukasz Brzeski,Decision - Unanimous,0,0,0,0
Valter Walker,2024-08-17,Junior Tafa,Submission,90,0,0,90
Takanori Gomi,2006-11-05,Marcus Aurelio,Decision - Split,70,3,0,73
Takanori Gomi,2004-05-23,Ralph Gracie,KO/TKO,100,5,0,105
Takanori Gomi,2011-09-24,Nate Diaz,Submission,0,0,0,0
Takanori Gomi,2017-06-17,Jon Tuck,Submission,0,0,0,0
Takanori Gomi,2011-01-01,Clay Guida,Submission,0,2,0,2
Takanori Gomi,2005-05-22,Luiz Azeredo,KO/TKO,100,0,0,100
Takanori Gomi,2004-02-15,Jadson Costa,KO/TKO,100,14,0,114
Takanori Gomi,2003-10-10,BJ Penn,Submission,0,0,0,0
Takanori Gomi,2006-04-02,Marcus Aurelio,Submission,0,0,0,0
Takanori Gomi,2015-07-25,Joe Lauzon,KO/TKO,0,0,0,0
Takanori Gomi,2017-09-22,Dong Hyun Ma,KO/TKO,0,0,0,0
Takanori Gomi,2010-08-01,Tyson Griffin,KO/TKO,100,2,0,102
Takanori Gomi,2004-10-14,Charles Bennett,Submission,90,8,0,98
Takanori Gomi,2004-12-31,Jens Pulver,KO/TKO,100,27,0,127
Takanori Gomi,2010-03-31,Kenny Florian,Submission,0,0,0,0
Takanori Gomi,2005-09-25,Tatsuya Kawajiri,Submission,90,13,0,103
Takanori Gomi,2006-08-27,David Baron,Submission,90,11,0,101
Takanori Gomi,2014-09-20,Myles Jury,KO/TKO,0,0,0,0
Takanori Gomi,2016-07-09,Jim Miller,KO/TKO,0,0,0,0
Takanori Gomi,2005-12-31,Hayato Sakurai,KO/TKO,100,11,0,111
Takanori Gomi,2014-04-26,Isaac Vallie-Flagg,Decision - Unanimous,80,23,0,103
Takanori Gomi,2005-07-17,Jean Silva,Decision - Unanimous,80,33,0,113
Takanori Gomi,2006-12-31,Mitsuhiro Ishida,KO/TKO,100,14,0,114
Takanori Gomi,2012-02-25,Eiji Mitsuoka,KO/TKO,100,16,0,116
Takanori Gomi,2013-03-02,Diego Sanchez,Decision - Split,0,16,0,16
Takanori Gomi,2005-09-25,Luiz Azeredo,Decision - Unanimous,80,13,0,93
Takanori Gomi,2004-07-19,Fabio Mello,KO/TKO,100,25,0,125
Takanori Gomi,2012-11-10,Mac Danzig,Decision - Split,70,0,0,70
Marcus Aurelio,2006-11-05,Takanori Gomi,Decision - Split,0,0,0,0
Marcus Aurelio,2007-08-25,Clay Guida,Decision - Split,0,0,0,0
Marcus Aurelio,2005-04-03,Daisuke Nakamura,Decision - Unanimous,80,6,0,86
Marcus Aurelio,2006-04-02,Takanori Gomi,Submission,90,3,0,93
Marcus Aurelio,2005-07-17,Jutaro Nakao,Decision - Unanimous,80,12,0,92
Marcus Aurelio,2009-08-29,Evan Dunham,Decision - Split,0,0,0,0
Marcus Aurelio,2008-10-25,Hermes Franca,Decision - Unanimous,0,0,0,0
Marcus Aurelio,2010-09-25,Shinya Aoki,Decision - Unanimous,0,0,0,0
Marcus Aurelio,2004-07-19,Dokonjonosuke Mishima,Decision - Split,0,0,0,0
Marcus Aurelio,2008-04-02,Ryan Roberts,Submission,90,6,0,96
Marcus Aurelio,2007-11-17,Luke Caudillo,KO/TKO,100,14,0,114
Marcus Aurelio,2008-07-05,Tyson Griffin,Decision - Unanimous,0,0,0,0
Marcus Aurelio,2006-06-04,Mitsuhiro Ishida,Decision - Unanimous,0,0,0,0
James Thompson,2005-12-31,Paulo Cesar Silva,KO/TKO,100,8,0,108
James Thompson,2010-09-25,Yusuke Kawaguchi,Decision - Split,0,16,0,16
James Thompson,2006-05-05,Kazuyuki Fujita,KO/TKO,0,20,0,20
James Thompson,2006-12-31,Hidehiko Yoshida,KO/TKO,100,19,0,119
James Thompson,2004-10-31,Aleksander Emelianenko,KO/TKO,0,0,0,0
James Thompson,2009-10-25,Alistair Overeem,Submission,0,0,0,0
James Thompson,2007-04-08,Don Frye,KO/TKO,100,57,0,157
James Thompson,2008-05-31,Kevin Ferguson,KO/TKO,0,1,0,1
James Thompson,2005-10-23,Alexandru Lungu,KO/TKO,100,8,0,108
James Thompson,2005-07-17,Henry Miller,KO/TKO,100,7,0,107
James Thompson,2008-02-16,Brett Rogers,KO/TKO,0,0,0,0
Paulo Cesar Silva,2005-12-31,James Thompson,KO/TKO,0,0,0,0
Paulo Cesar Silva,2006-04-02,Ikuhisa Minowa,KO/TKO,0,0,0,0
Paulo Cesar Silva,2004-12-31,Mu Bae Choi,Submission,0,0,0,0
Paulo Cesar Silva,2004-07-19,Takashi Sugiura,KO/TKO,0,0,0,0
Paulo Cesar Silva,2004-04-25,Henry Miller,Submission,90,0,0,90
Paulo Cesar Silva,2003-12-31,Heath Herring,Submission,0,0,0,0
Paulo Cesar Silva,2004-06-20,Naoya Ogawa,KO/TKO,0,0,0,0
Karolina Kowalkiewicz,2022-11-12,Silvana Gomez Juarez,Decision - Unanimous,80,0,0,80
Karolina Kowalkiewicz,2021-08-07,Jessica Penne,Submission,0,0,0,0
Karolina Kowalkiewicz,2024-11-09,Denise Gomes,Decision - Unanimous,0,0,0,0
Karolina Kowalkiewicz,2018-09-08,Jessica Andrade,KO/TKO,0,0,0,0
Karolina Kowalkiewicz,2017-10-21,Jodie Esquibel,Decision - Unanimous,80,62,0,142
Karolina Kowalkiewicz,2024-05-04,Iasmin Lucindo,Decision - Unanimous,0,0,0,0
Karolina Kowalkiewicz,2016-05-08,Heather Clark,Decision - Unanimous,80,49,0,129
Karolina Kowalkiewicz,2019-03-30,Michelle Waterson-Gomez,Decision - Unanimous,0,0,0,0
Karolina Kowalkiewicz,2023-10-07,Diana Belbita,Decision - Unanimous,80,42,0,122
Karolina Kowalkiewicz,2019-06-08,Alexa Grasso,Decision - Unanimous,0,0,0,0
Karolina Kowalkiewicz,2015-12-19,Randa Markos,Decision - Unanimous,80,32,0,112
Karolina Kowalkiewicz,2016-07-30,Rose Namajunas,Decision - Split,70,14,0,84
Karolina Kowalkiewicz,2017-06-03,Claudia Gadelha,Submission,0,1,0,1
Karolina Kowalkiewicz,2018-04-07,Felice Herrig,Decision - Split,70,40,0,110
Karolina Kowalkiewicz,2022-06-04,Felice Herrig,Submission,90,27,0,117
Karolina Kowalkiewicz,2016-11-12,Joanna Jedrzejczyk,Decision - Unanimous,0,0,25,25
Karolina Kowalkiewicz,2023-05-20,Vanessa Demopoulos,Decision - Unanimous,80,71,0,151
Karolina Kowalkiewicz,2020-02-22,Yan Xiaonan,Decision - Unanimous,0,0,0,0
Silvana Gomez Juarez,2022-11-12,Karolina Kowalkiewicz,Decision - Unanimous,0,3,0,3
Silvana Gomez Juarez,2021-10-09,Loopy Godinez,Submission,0,0,0,0
Silvana Gomez Juarez,2022-06-11,Liang Na,KO/TKO,100,4,0,104
Silvana Gomez Juarez,2022-01-22,Vanessa Demopoulos,Submission,0,6,0,6
Askar Askarov,2020-01-18,Tim Elliott,Decision - Unanimous,80,26,0,106
Askar Askarov,2020-07-18,Alexandre Pantoja,Decision - Unanimous,80,9,0,89
Askar Askarov,2021-03-06,Joseph Benavidez,Decision - Unanimous,80,12,0,92
Askar Askarov,2022-03-26,Kai Kara-France,Decision - Unanimous,0,0,0,0
Tim Elliott,2020-01-18,Askar Askarov,Decision - Unanimous,0,0,0,0
Tim Elliott,2023-12-09,Sumudaerji,Submission,90,0,0,90
Tim Elliott,2023-10-21,Muhammad Mokaev,Submission,0,16,0,16
Tim Elliott,2012-05-05,John Dodson,Decision - Unanimous,0,0,0,0
Tim Elliott,2022-03-05,Tagir Ulanbekov,Decision - Unanimous,80,0,0,80
Tim Elliott,2012-12-15,Jared Papazian,Decision - Unanimous,80,0,0,80
Tim Elliott,2015-02-14,Zach Makovsky,Decision - Unanimous,0,22,0,22
Tim Elliott,2023-06-03,Victor Altamirano,Decision - Unanimous,80,9,0,89
Tim Elliott,2017-12-30,Mark De La Rosa,Submission,90,10,0,100
Tim Elliott,2020-07-15,Ryan Benoit,Decision - Unanimous,80,12,0,92
Tim Elliott,2014-04-26,Joseph Benavidez,Submission,0,7,0,7
Tim Elliott,2017-04-15,Louis Smolka,Decision - Unanimous,80,16,0,96
Tim Elliott,2013-08-31,Louis Gaudinot,Decision - Unanimous,80,88,0,168
Tim Elliott,2013-11-16,Ali Bagautinov,Decision - Unanimous,0,5,0,5
Tim Elliott,2017-06-10,Ben Nguyen,Submission,0,0,0,0
Tim Elliott,2021-03-06,Jordan Espinosa,Decision - Unanimous,80,12,0,92
Tim Elliott,2021-10-09,Matheus Nicolau,Decision - Unanimous,0,6,0,6
Tim Elliott,2019-10-12,Deiveson Figueiredo,Submission,0,18,0,18
Tim Elliott,2016-12-03,Demetrious Johnson,Decision - Unanimous,0,0,25,25
Tim Elliott,2020-05-30,Brandon Royval,Submission,0,1,0,1
Luke Rockhold,2015-12-12,Chris Weidman,KO/TKO,100,78,25,203
Luke Rockhold,2012-07-14,Tim Kennedy,Decision - Unanimous,80,14,25,119
Luke Rockhold,2009-11-06,Jesse Taylor,Submission,90,0,0,90
Luke Rockhold,2010-02-26,Paul Bradley,KO/TKO,100,5,0,105
Luke Rockhold,2009-06-19,Cory Devela,Submission,90,19,0,109
Luke Rockhold,2014-04-26,Tim Boetsch,Submission,90,3,0,93
Luke Rockhold,2018-02-10,Yoel Romero,KO/TKO,0,0,25,25
Luke Rockhold,2008-11-21,Nik Theotikos,Submission,90,17,0,107
Luke Rockhold,2016-06-04,Michael Bisping,KO/TKO,0,0,25,25
Luke Rockhold,2015-04-18,Lyoto Machida,Submission,90,10,25,125
Luke Rockhold,2019-07-06,Jan Blachowicz,KO/TKO,0,0,0,0
Luke Rockhold,2011-09-10,Jacare Souza,Decision - Unanimous,80,48,25,153
Luke Rockhold,2014-11-07,Michael Bisping,Submission,90,4,25,119
Luke Rockhold,2022-08-20,Paulo Costa,Decision - Unanimous,0,0,0,0
Luke Rockhold,2012-01-07,Keith Jardine,KO/TKO,100,20,25,145
Luke Rockhold,2017-09-16,David Branch,KO/TKO,100,33,25,158
Luke Rockhold,2013-05-18,Vitor Belfort,KO/TKO,0,0,25,25
Luke Rockhold,2014-01-15,Constantinos Philippou,KO/TKO,100,8,25,133
Chris Weidman,2015-12-12,Luke Rockhold,KO/TKO,0,0,25,25
Chris Weidman,2014-07-05,Lyoto Machida,Decision - Unanimous,80,7,25,112
Chris Weidman,2011-11-19,Tom Lawlor,Submission,90,1,0,91
Chris Weidman,2016-11-12,Yoel Romero,KO/TKO,0,0,0,0
Chris Weidman,2018-11-03,Jacare Souza,KO/TKO,0,0,0,0
Chris Weidman,2012-01-28,Demian Maia,Decision - Unanimous,80,7,0,87
Chris Weidman,2013-07-06,Anderson Silva,KO/TKO,100,2,25,127
Chris Weidman,2012-07-11,Mark Munoz,KO/TKO,100,28,25,153
Chris Weidman,2017-04-08,Gegard Mousasi,KO/TKO,0,0,0,0
Chris Weidman,2024-03-30,Bruno Silva,Decision - Unanimous,80,45,0,125
Chris Weidman,2011-06-11,Jesse Bongfeldt,Submission,90,2,0,92
Chris Weidman,2017-07-22,Kelvin Gastelum,Submission,90,10,25,125
Chris Weidman,2011-03-03,Alessio Sakara,Decision - Unanimous,80,18,0,98
Chris Weidman,2015-05-23,Vitor Belfort,KO/TKO,100,28,25,153
Chris Weidman,2013-12-28,Anderson Silva,KO/TKO,100,12,25,137
Chris Weidman,2020-08-08,Omari Akhmedov,Decision - Unanimous,80,0,0,80
Chris Weidman,2023-08-19,Brad Tavares,Decision - Unanimous,0,0,0,0
Chris Weidman,2021-04-24,Uriah Hall,KO/TKO,0,1,0,1
Chris Weidman,2024-12-07,Eryk Anders,KO/TKO,0,0,0,0
Chris Weidman,2019-10-18,Dominick Reyes,KO/TKO,0,0,25,25
Bogdan Grad,2024-08-27,Michael Aswell,Decision - Split,70,0,0,70
Bogdan Grad,2023-08-08,Tom Nolan,KO/TKO,0,0,0,0
Michael Aswell,2024-08-27,Bogdan Grad,Decision - Split,0,53,0,53
Mark Hunt,2004-10-31,Dan Bobish,KO/TKO,100,0,0,100
Mark Hunt,2016-03-19,Frank Mir,KO/TKO,100,7,25,132
Mark Hunt,2014-09-20,Roy Nelson,KO/TKO,100,12,25,137
Mark Hunt,2018-09-15,Aleksei Oleinik,Submission,0,3,25,28
Mark Hunt,2004-12-31,Wanderlei Silva,Decision - Split,70,45,0,115
Mark Hunt,2017-06-10,Derrick Lewis,KO/TKO,100,8,25,133
Mark Hunt,2018-02-10,Curtis Blaydes,Decision - Unanimous,0,0,0,0
Mark Hunt,2011-09-24,Ben Rothwell,Decision - Unanimous,80,28,0,108
Mark Hunt,2013-03-02,Stefan Struve,KO/TKO,100,23,0,123
Mark Hunt,2017-03-04,Alistair Overeem,KO/TKO,0,0,0,0
Mark Hunt,2010-09-25,Sean McCorkle,Submission,0,2,0,2
Mark Hunt,2005-12-31,Mirko Filipovic,Decision - Split,70,17,0,87
Mark Hunt,2008-07-21,Alistair Overeem,Submission,0,3,0,3
Mark Hunt,2008-12-31,Melvin Manhoef,KO/TKO,0,0,0,0
Mark Hunt,2018-12-01,Justin Willis,Decision - Unanimous,0,0,0,0
Mark Hunt,2011-02-26,Chris Tuchscherer,KO/TKO,100,5,0,105
Mark Hunt,2015-05-09,Stipe Miocic,KO/TKO,0,0,25,25
Mark Hunt,2004-06-20,Hidehiko Yoshida,Submission,0,10,0,10
Mark Hunt,2006-07-01,Josh Barnett,Submission,0,0,0,0
Mark Hunt,2006-05-05,Tsuyoshi Kohsaka,KO/TKO,100,41,0,141
Mark Hunt,2012-02-25,Cheick Kongo,KO/TKO,100,5,0,105
Mark Hunt,2006-02-26,Yosuke Nishijima,KO/TKO,100,70,0,170
Mark Hunt,2015-11-14,Antonio Silva,KO/TKO,100,3,0,103
Mark Hunt,2009-05-26,Gegard Mousasi,Submission,0,0,0,0
Mark Hunt,2013-05-25,Junior Dos Santos,KO/TKO,0,0,0,0
Mark Hunt,2014-11-15,Fabricio Werdum,KO/TKO,0,0,25,25
Mark Hunt,2006-12-31,Fedor Emelianenko,Submission,0,0,0,0
Dan Bobish,2004-10-31,Mark Hunt,KO/TKO,0,12,0,12
Dan Bobish,2003-11-09,Gary Goodridge,KO/TKO,0,0,0,0
Dan Bobish,2004-02-01,Igor Vovchanchyn,KO/TKO,0,2,0,2
Dan Bobish,1997-07-27,Brian Johnston,Submission,90,3,0,93
Dan Bobish,1997-07-27,Mark Kerr,Submission,0,0,0,0
Chad Mendes,2013-08-31,Clay Guida,KO/TKO,100,15,0,115
Chad Mendes,2011-08-06,Rani Yahya,Decision - Unanimous,80,20,0,100
Chad Mendes,2013-04-20,Darren Elkins,KO/TKO,100,5,0,105
Chad Mendes,2012-07-07,Cody McKenzie,KO/TKO,100,7,0,107
Chad Mendes,2010-04-24,Anthony Morrison,Submission,90,0,0,90
Chad Mendes,2018-07-14,Myles Jury,KO/TKO,100,14,0,114
Chad Mendes,2015-04-04,Ricardo Lamas,KO/TKO,100,19,25,144
Chad Mendes,2011-02-05,Michihiro Omigawa,Decision - Unanimous,80,38,0,118
Chad Mendes,2012-12-14,Yaotzin Meza,KO/TKO,100,8,0,108
Chad Mendes,2018-12-29,Alexander Volkanovski,KO/TKO,0,0,0,0
Chad Mendes,2012-01-14,Jose Aldo,KO/TKO,0,2,25,27
Chad Mendes,2014-10-25,Jose Aldo,Decision - Unanimous,0,0,25,25
Chad Mendes,2015-07-11,Conor McGregor,KO/TKO,0,0,25,25
Chad Mendes,2010-11-11,Javier Vazquez,Decision - Unanimous,80,24,0,104
Chad Mendes,2013-12-14,Nik Lentz,Decision - Unanimous,80,0,0,80
Chad Mendes,2010-08-18,Cub Swanson,Decision - Unanimous,80,0,0,80
Chad Mendes,2015-12-11,Frankie Edgar,KO/TKO,0,0,25,25
Chad Mendes,2010-03-06,Erik Koch,Decision - Unanimous,80,10,0,90
Clay Guida,2013-08-31,Chad Mendes,KO/TKO,0,0,0,0
Clay Guida,2007-08-25,Marcus Aurelio,Decision - Split,70,4,0,74
Clay Guida,2021-02-06,Michael Johnson,Decision - Unanimous,80,0,0,80
Clay Guida,2008-04-02,Samy Schiavo,KO/TKO,100,7,0,107
Clay Guida,2011-01-01,Takanori Gomi,Submission,90,0,0,90
Clay Guida,2011-06-04,Anthony Pettis,Decision - Unanimous,80,5,0,85
Clay Guida,2019-08-03,Jim Miller,Submission,0,0,0,0
Clay Guida,2018-06-09,Charles Oliveira,Submission,0,0,0,0
Clay Guida,2016-06-04,Brian Ortega,KO/TKO,0,0,0,0
Clay Guida,2020-06-20,Bobby Green,Decision - Unanimous,0,0,0,0
Clay Guida,2008-09-17,Mac Danzig,Decision - Unanimous,80,7,0,87
Clay Guida,2023-04-15,Rafa Garcia,Decision - Unanimous,0,0,0,0
Clay Guida,2015-11-07,Thiago Tavares,Submission,0,1,0,1
Clay Guida,2014-04-11,Tatsuya Kawajiri,Decision - Unanimous,80,28,0,108
Clay Guida,2006-10-14,Justin James,Submission,90,13,0,103
Clay Guida,2006-03-10,Josh Thomson,Decision - Unanimous,80,36,25,141
Clay Guida,2007-01-25,Din Thomas,Decision - Unanimous,0,0,0,0
Clay Guida,2017-06-25,Erik Koch,Decision - Unanimous,80,25,0,105
Clay Guida,2010-03-21,Shannon Gugerty,Submission,90,13,0,103
Clay Guida,2017-11-11,Joe Lauzon,KO/TKO,100,23,0,123
Clay Guida,2009-01-31,Nate Diaz,Decision - Split,70,0,0,70
Clay Guida,2009-12-12,Kenny Florian,Submission,0,0,0,0
Clay Guida,2022-12-03,Scott Holtzman,Decision - Split,70,1,0,71
Clay Guida,2013-01-26,Hatsu Hioki,Decision - Split,70,0,0,70
Clay Guida,2024-12-07,Chase Hooper,Submission,0,0,0,0
Clay Guida,2007-12-08,Roger Huerta,Submission,0,16,0,16
Clay Guida,2022-04-23,Claudio Puelles,Submission,0,2,0,2
Clay Guida,2021-12-04,Leonardo Santos,Submission,90,0,0,90
Clay Guida,2011-11-12,Benson Henderson,Decision - Unanimous,0,0,0,0
Clay Guida,2009-06-20,Diego Sanchez,Decision - Split,0,0,0,0
Clay Guida,2021-08-21,Mark Madsen,Decision - Split,0,0,0,0
Clay Guida,2010-08-07,Rafael Dos Anjos,Submission,90,2,0,92
Clay Guida,2006-06-09,Gilbert Melendez,Decision - Split,0,0,25,25
Clay Guida,2023-12-02,Joaquim Silva,Decision - Unanimous,0,0,0,0
Clay Guida,2012-06-22,Gray Maynard,Decision - Split,0,0,25,25
Clay Guida,2014-07-26,Dennis Bermudez,Submission,0,0,0,0
Clay Guida,2019-05-11,BJ Penn,Decision - Unanimous,80,16,0,96
Clay Guida,2015-04-04,Robert Peralta,Decision - Unanimous,80,3,0,83
Clay Guida,2006-08-17,Joe Martin,Decision - Unanimous,80,25,0,105
Clay Guida,2007-06-16,Tyson Griffin,Decision - Split,0,0,0,0
Bruno Silva,2021-10-16,Andrew Sanchez,KO/TKO,100,37,0,137
Bruno Silva,2020-10-10,Tagir Ulanbekov,Decision - Unanimous,0,1,0,1
Bruno Silva,2023-04-22,Brad Tavares,KO/TKO,100,8,0,108
Bruno Silva,2023-03-11,Tyson Nam,Submission,90,11,0,101
Bruno Silva,2024-10-26,Ismail Naurdiev,Decision - Unanimous,0,0,0,0
Bruno Silva,2021-06-19,Wellington Turman,KO/TKO,100,18,0,118
Bruno Silva,2021-05-22,Victor Rodriguez,KO/TKO,100,6,0,106
Bruno Silva,2024-07-20,Cody Durden,KO/TKO,100,14,0,114
Bruno Silva,2023-06-24,Brendan Allen,Submission,0,0,0,0
Bruno Silva,2021-12-11,Jordan Wright,KO/TKO,100,0,0,100
Bruno Silva,2024-03-30,Chris Weidman,Decision - Unanimous,0,0,0,0
Bruno Silva,2021-03-20,JP Buys,KO/TKO,100,20,0,120
Bruno Silva,2023-10-21,Shara Magomedov,Decision - Unanimous,0,0,0,0
Bruno Silva,2022-08-13,Gerald Meerschaert,Submission,0,0,0,0
Bruno Silva,2022-03-12,Alex Pereira,Decision - Unanimous,0,0,0,0
Bruno Silva,2024-12-14,Manel Kape,KO/TKO,0,0,0,0
Bruno Silva,2020-03-14,David Dvorak,Decision - Unanimous,0,0,0,0
Andrew Sanchez,2021-10-16,Bruno Silva,KO/TKO,0,0,0,0
Andrew Sanchez,2020-08-08,Wellington Turman,KO/TKO,100,7,0,107
Andrew Sanchez,2019-10-12,Marvin Vettori,Decision - Unanimous,0,0,0,0
Andrew Sanchez,2017-12-01,Ryan Janes,KO/TKO,0,0,0,0
Andrew Sanchez,2019-05-04,Marc-Andre Barriault,Decision - Unanimous,80,3,0,83
Andrew Sanchez,2016-07-08,Khalil Rountree Jr.,Decision - Unanimous,80,17,0,97
Andrew Sanchez,2021-01-23,Makhmud Muradov,KO/TKO,0,0,0,0
Andrew Sanchez,2018-08-25,Markus Perez,Decision - Unanimous,80,19,0,99
Andrew Sanchez,2016-12-09,Trevor Smith,Decision - Unanimous,80,13,0,93
Andrew Sanchez,2017-04-15,Anthony Smith,KO/TKO,0,14,0,14
Sean Sherk,2006-04-15,Nick Diaz,Decision - Unanimous,80,0,0,80
Sean Sherk,2009-05-23,Frankie Edgar,Decision - Unanimous,0,0,0,0
Sean Sherk,2006-10-14,Kenny Florian,Decision - Unanimous,80,37,25,142
Sean Sherk,2008-10-25,Tyson Griffin,Decision - Unanimous,80,18,0,98
Sean Sherk,2008-05-24,BJ Penn,KO/TKO,0,0,25,25
Sean Sherk,2001-02-23,Tiki Ghosn,Submission,90,11,0,101
Sean Sherk,2002-09-27,Benji Radach,TKO - Doctor's Stoppage,0,0,0,0
Sean Sherk,2002-03-22,Jutaro Nakao,Decision - Unanimous,80,17,0,97
Sean Sherk,2010-09-25,Evan Dunham,Decision - Split,70,0,0,70
Sean Sherk,2007-07-07,Hermes Franca,Decision - Unanimous,80,29,25,134
Sean Sherk,2004-02-15,Ryuki Ueyama,Decision - Unanimous,80,21,0,101
Sean Sherk,2005-11-19,Georges St-Pierre,KO/TKO,0,0,0,0
Sean Sherk,2003-04-25,Matt Hughes,Decision - Unanimous,0,0,25,25
Nick Diaz,2006-04-15,Sean Sherk,Decision - Unanimous,0,18,0,18
Nick Diaz,2007-11-10,KJ Noons,TKO - Doctor's Stoppage,0,0,25,25
Nick Diaz,2005-02-05,Drew Fickett,KO/TKO,100,10,0,110
Nick Diaz,2013-03-16,Georges St-Pierre,Decision - Unanimous,0,0,25,25
Nick Diaz,2006-02-04,Joe Riggs,Decision - Unanimous,0,0,0,0
Nick Diaz,2006-08-26,Josh Neer,Submission,90,50,0,140
Nick Diaz,2010-05-29,Hayato Sakurai,Submission,90,1,0,91
Nick Diaz,2009-06-06,Scott Smith,Submission,90,128,0,218
Nick Diaz,2006-11-18,Gleison Tibau,KO/TKO,100,24,0,124
Nick Diaz,2021-09-25,Robbie Lawler,KO/TKO,0,19,25,44
Nick Diaz,2009-04-11,Frank Shamrock,KO/TKO,100,43,0,143
Nick Diaz,2008-06-14,Muhsin Corbbrey,KO/TKO,100,45,0,145
Nick Diaz,2004-08-21,Karo Parisyan,Decision - Split,0,10,0,10
Nick Diaz,2003-09-26,Jeremy Jackson,Submission,90,8,0,98
Nick Diaz,2010-01-30,Marius Zaromskis,KO/TKO,100,68,25,193
Nick Diaz,2007-09-15,Mike Aina,Decision - Split,70,52,0,122
Nick Diaz,2008-05-11,Katsuya Inoue,KO/TKO,100,64,0,164
Nick Diaz,2011-01-29,Evangelista Santos,Submission,90,32,25,147
Nick Diaz,2005-11-05,Diego Sanchez,Decision - Unanimous,0,0,0,0
Nick Diaz,2010-10-09,KJ Noons,Decision - Unanimous,80,20,25,125
Nick Diaz,2012-02-04,Carlos Condit,Decision - Unanimous,0,0,25,25
Nick Diaz,2005-06-04,Koji Oishi,KO/TKO,100,23,0,123
Nick Diaz,2011-10-29,BJ Penn,Decision - Unanimous,80,90,0,170
Nick Diaz,2011-04-09,Paul Daley,KO/TKO,100,24,25,149
Nick Diaz,2008-07-26,Thomas Denny,KO/TKO,100,40,0,140
Nick Diaz,2004-04-02,Robbie Lawler,KO/TKO,100,6,0,106
Nick Diaz,2003-03-27,Joe Hurley,Submission,90,6,25,121
Michael Chandler,2021-05-15,Charles Oliveira,KO/TKO,0,6,25,31
Michael Chandler,2021-01-23,Dan Hooker,KO/TKO,100,9,0,109
Michael Chandler,2022-05-07,Tony Ferguson,KO/TKO,100,7,0,107
Michael Chandler,2021-11-06,Justin Gaethje,Decision - Unanimous,0,0,0,0
Michael Chandler,2024-11-16,Charles Oliveira,Decision - Unanimous,0,0,25,25
Michael Chandler,2022-11-12,Dustin Poirier,Submission,0,5,0,5
Sage Northcutt,2015-10-03,Francisco Trevino,KO/TKO,100,20,0,120
Sage Northcutt,2016-01-30,Bryan Barberena,Submission,0,0,0,0
Sage Northcutt,2016-07-09,Enrique Marin,Decision - Unanimous,80,25,0,105
Sage Northcutt,2015-12-10,Cody Pfister,Submission,90,3,0,93
Sage Northcutt,2018-02-18,Thibault Gouti,Decision - Unanimous,80,35,0,115
Sage Northcutt,2017-11-11,Michel Quinones,Decision - Unanimous,80,24,0,104
Sage Northcutt,2018-07-14,Zak Ottow,KO/TKO,100,18,0,118
Sage Northcutt,2016-12-17,Mickey Gall,Submission,0,4,0,4
Francisco Trevino,2015-10-03,Sage Northcutt,KO/TKO,0,0,0,0
Francisco Trevino,2015-06-13,Johnny Case,Decision - Unanimous,0,0,0,0
Francisco Trevino,2014-03-15,Renee Forte,Decision - Unanimous,80,33,0,113
Nate Marquardt,2006-10-10,Crafton Wallace,Submission,90,9,0,99
Nate Marquardt,2010-11-13,Yushin Okami,Decision - Unanimous,0,0,0,0
Nate Marquardt,2005-08-06,Ivan Salaverry,Decision - Unanimous,80,0,0,80
Nate Marquardt,2007-07-07,Anderson Silva,KO/TKO,0,0,25,25
Nate Marquardt,2016-05-14,Thiago Santos,KO/TKO,0,0,0,0
Nate Marquardt,2015-06-13,Kelvin Gastelum,KO/TKO,0,0,0,0
Nate Marquardt,2009-02-21,Wilson Gouveia,KO/TKO,100,51,0,151
Nate Marquardt,2014-06-28,James Te Huna,Submission,90,11,25,126
Nate Marquardt,2016-10-01,Tamdan McCrory,KO/TKO,100,8,0,108
Nate Marquardt,2008-09-06,Martin Kampmann,KO/TKO,100,21,0,121
Nate Marquardt,2015-01-03,Brad Tavares,Decision - Unanimous,0,0,0,0
Nate Marquardt,2010-02-06,Chael Sonnen,Decision - Unanimous,0,0,0,0
Nate Marquardt,2012-07-14,Tyron Woodley,KO/TKO,100,18,25,143
Nate Marquardt,2013-01-12,Tarec Saffiedine,Decision - Unanimous,0,0,25,25
Nate Marquardt,2008-02-02,Jeremy Horn,Submission,90,17,0,107
Nate Marquardt,2017-06-03,Vitor Belfort,Decision - Unanimous,0,20,0,20
Nate Marquardt,2017-11-11,Cezar Ferreira,Decision - Split,0,0,0,0
Nate Marquardt,2007-01-25,Dean Lister,Decision - Unanimous,80,35,0,115
Nate Marquardt,2013-03-16,Jake Ellenberger,KO/TKO,0,0,0,0
Nate Marquardt,2010-09-15,Rousimar Palhares,KO/TKO,100,12,0,112
Nate Marquardt,2015-12-19,CB Dollaway,KO/TKO,100,1,0,101
Nate Marquardt,2017-01-28,Sam Alvey,Decision - Unanimous,0,0,0,0
Nate Marquardt,2011-03-19,Dan Miller,Decision - Unanimous,80,37,0,117
Nate Marquardt,2009-08-29,Demian Maia,KO/TKO,100,1,0,101
Nate Marquardt,2013-10-19,Hector Lombard,KO/TKO,0,0,0,0
Nate Marquardt,2008-06-07,Thales Leites,Decision - Split,0,22,0,22
Nate Marquardt,2006-03-04,Joe Doerksen,Decision - Unanimous,80,30,0,110
Crafton Wallace,2006-10-10,Nate Marquardt,Submission,0,0,0,0
Crafton Wallace,2006-03-10,Ray Routh,KO/TKO,100,15,0,115
Crafton Wallace,2006-08-17,Martin Kampmann,Submission,0,0,0,0
Frank Camacho,2019-06-01,Nick Hein,KO/TKO,100,63,0,163
Frank Camacho,2018-01-27,Drew Dober,Decision - Unanimous,0,0,0,0
Frank Camacho,2022-05-14,Manuel Torres,KO/TKO,0,0,0,0
Frank Camacho,2019-10-26,Beneil Dariush,Submission,0,0,0,0
Frank Camacho,2017-06-17,Li Jingliang,Decision - Unanimous,0,0,0,0
Frank Camacho,2017-11-18,Damien Brown,Decision - Split,70,50,0,120
Frank Camacho,2020-06-20,Justin Jaynes,KO/TKO,0,0,0,0
Frank Camacho,2018-09-08,Geoff Neal,KO/TKO,0,0,0,0
Nick Hein,2019-06-01,Frank Camacho,KO/TKO,0,0,0,0
Nick Hein,2014-11-22,James Vick,Decision - Unanimous,0,0,0,0
Nick Hein,2015-06-20,Lukasz Sajewski,Decision - Unanimous,80,28,0,108
Nick Hein,2018-05-12,Davi Ramos,Submission,0,0,0,0
Nick Hein,2018-07-22,Damir Hadzovic,Decision - Split,0,0,0,0
Nick Hein,2015-09-26,Yusuke Kasuya,Decision - Unanimous,80,2,0,82
Nick Hein,2016-09-03,Tae Hyun Bang,Decision - Unanimous,80,0,0,80
Nick Hein,2014-05-31,Drew Dober,Decision - Unanimous,80,1,0,81
Yves Jabouin,2011-12-10,Walel Watson,Decision - Split,70,0,0,70
Yves Jabouin,2012-05-15,Jeff Hougland,Decision - Unanimous,80,32,0,112
Yves Jabouin,2014-01-25,Eddie Wineland,KO/TKO,0,0,0,0
Yves Jabouin,2011-04-30,Pablo Garza,Submission,0,0,0,0
Yves Jabouin,2015-04-25,Thomas Almeida,KO/TKO,0,0,0,0
Yves Jabouin,2010-11-11,Brandon Visher,Decision - Unanimous,80,17,0,97
Yves Jabouin,2014-06-14,Mike Easton,Decision - Unanimous,80,18,0,98
Yves Jabouin,2009-10-10,Raphael Assuncao,Decision - Split,0,0,0,0
Yves Jabouin,2012-09-29,Brad Pickett,KO/TKO,0,12,0,12
Yves Jabouin,2011-08-27,Ian Loveland,Decision - Split,70,4,0,74
Yves Jabouin,2015-08-23,Felipe Arantes,Submission,0,1,0,1
Yves Jabouin,2013-06-15,Dustin Pague,Decision - Split,70,5,0,75
Yves Jabouin,2010-06-20,Mark Hominick,KO/TKO,0,0,0,0
Walel Watson,2011-12-10,Yves Jabouin,Decision - Split,0,14,0,14
Walel Watson,2011-10-01,Joseph Sandoval,KO/TKO,100,9,0,109
Walel Watson,2012-02-15,TJ Dillashaw,Decision - Unanimous,0,0,0,0
Walel Watson,2012-09-22,Mitch Gagnon,Submission,0,0,0,0
Josh LaBerge,2011-02-12,Anthony Leone,TKO - Doctor's Stoppage,0,4,0,4
Anthony Leone,2011-02-12,Josh LaBerge,TKO - Doctor's Stoppage,0,0,0,0
Anthony Leone,2010-06-20,Renan Barao,Submission,0,0,0,0
Alexander Gustafsson,2011-02-26,James Te Huna,Submission,90,0,0,90
Alexander Gustafsson,2020-07-25,Fabricio Werdum,Submission,0,7,0,7
Alexander Gustafsson,2015-10-03,Daniel Cormier,Decision - Split,0,0,25,25
Alexander Gustafsson,2015-01-24,Anthony Johnson,KO/TKO,0,0,25,25
Alexander Gustafsson,2010-04-10,Phil Davis,Submission,0,0,0,0
Alexander Gustafsson,2018-12-29,Jon Jones,KO/TKO,0,0,25,25
Alexander Gustafsson,2009-11-14,Jared Hamman,KO/TKO,100,0,0,100
Alexander Gustafsson,2012-04-14,Thiago Silva,Decision - Unanimous,80,38,0,118
Alexander Gustafsson,2017-05-28,Glover Teixeira,KO/TKO,100,55,25,180
Alexander Gustafsson,2014-03-08,Jimi Manuwa,KO/TKO,100,8,25,133
Alexander Gustafsson,2011-12-30,Vladimir Matyushenko,KO/TKO,100,5,0,105
Alexander Gustafsson,2010-10-16,Cyrille Diabate,Submission,90,17,0,107
Alexander Gustafsson,2019-06-01,Anthony Smith,Submission,0,23,25,48
Alexander Gustafsson,2011-08-06,Matt Hamill,KO/TKO,100,24,0,124
Alexander Gustafsson,2012-12-08,Mauricio Rua,Decision - Unanimous,80,31,0,111
Alexander Gustafsson,2022-07-23,Nikita Krylov,KO/TKO,0,0,0,0
Alexander Gustafsson,2013-09-21,Jon Jones,Decision - Unanimous,0,0,25,25
Alexander Gustafsson,2016-09-03,Jan Blachowicz,Decision - Unanimous,80,22,0,102
James Te Huna,2011-02-26,Alexander Gustafsson,Submission,0,2,0,2
James Te Huna,2016-03-19,Steve Bosse,KO/TKO,0,0,0,0
James Te Huna,2014-06-28,Nate Marquardt,Submission,0,0,25,25
James Te Huna,2013-12-06,Mauricio Rua,KO/TKO,0,0,0,0
James Te Huna,2013-02-16,Ryan Jimmo,Decision - Unanimous,80,15,0,95
James Te Huna,2013-05-25,Glover Teixeira,Submission,0,0,0,0
James Te Huna,2010-02-20,Igor Pokrajac,KO/TKO,100,0,0,100
James Te Huna,2011-09-24,Ricardo Romero,KO/TKO,100,5,0,105
James Te Huna,2012-03-02,Aaron Rosa,KO/TKO,100,22,0,122
James Te Huna,2012-07-11,Joey Beltran,Decision - Unanimous,80,49,0,129
Dooho Choi,2016-07-08,Thiago Tavares,KO/TKO,100,2,0,102
Dooho Choi,2024-07-20,Bill Algeo,KO/TKO,100,4,0,104
Dooho Choi,2015-11-28,Sam Sicilia,KO/TKO,100,10,0,110
Dooho Choi,2019-12-21,Charles Jourdain,KO/TKO,0,0,0,0
Dooho Choi,2016-12-10,Cub Swanson,Decision - Unanimous,0,0,0,0
Dooho Choi,2018-01-14,Jeremy Stephens,KO/TKO,0,0,25,25
Dooho Choi,2014-11-22,Juan Manuel Puig,KO/TKO,100,10,0,110
Dooho Choi,2024-12-07,Nate Landwehr,KO/TKO,100,53,0,153
Thiago Tavares,2016-07-08,Dooho Choi,KO/TKO,0,0,0,0
Thiago Tavares,2013-11-09,Justin Salas,Submission,90,3,0,93
Thiago Tavares,2007-04-05,Naoyuki Kotani,Decision - Unanimous,80,9,0,89
Thiago Tavares,2009-01-31,Manvel Gamburyan,Decision - Unanimous,80,1,0,81
Thiago Tavares,2010-09-25,Pat Audinwood,Submission,90,4,0,94
Thiago Tavares,2008-01-23,Michihiro Omigawa,Decision - Unanimous,80,8,0,88
Thiago Tavares,2015-11-07,Clay Guida,Submission,90,0,0,90
Thiago Tavares,2007-06-12,Jason Black,Submission,90,11,0,101
Thiago Tavares,2012-01-14,Sam Stout,Decision - Unanimous,80,5,0,85
Thiago Tavares,2008-09-06,Kurt Pellegrino,Decision - Unanimous,0,0,0,0
Thiago Tavares,2008-06-07,Matt Wiman,KO/TKO,0,0,0,0
Thiago Tavares,2013-01-19,Khabib Nurmagomedov,KO/TKO,0,0,0,0
Thiago Tavares,2014-08-16,Robert Peralta,Submission,90,18,0,108
Thiago Tavares,2007-09-22,Tyson Griffin,Decision - Unanimous,0,0,0,0
Thiago Tavares,2011-08-27,Spencer Fisher,KO/TKO,100,7,0,107
Thiago Tavares,2015-06-06,Brian Ortega,KO/TKO,0,0,0,0
Thiago Tavares,2011-03-03,Shane Roller,KO/TKO,0,0,0,0
Fabio Maldonado,2013-10-09,Joey Beltran,Decision - Split,70,30,0,100
Fabio Maldonado,2014-03-23,Gian Villante,Decision - Unanimous,80,99,0,179
Fabio Maldonado,2010-10-16,James McSweeney,KO/TKO,100,40,0,140
Fabio Maldonado,2012-10-13,Glover Teixeira,TKO - Doctor's Stoppage,0,0,0,0
Fabio Maldonado,2015-04-25,Quinton Jackson,Decision - Unanimous,0,0,0,0
Fabio Maldonado,2011-06-04,Kyle Kingsbury,Decision - Unanimous,0,0,0,0
Fabio Maldonado,2012-05-15,Igor Pokrajac,Decision - Unanimous,0,62,0,62
Fabio Maldonado,2014-10-25,Hans Stringer,KO/TKO,100,0,0,100
Fabio Maldonado,2013-05-18,Roger Hollett,Decision - Unanimous,80,71,0,151
Fabio Maldonado,2014-05-31,Stipe Miocic,KO/TKO,0,0,25,25
Fabio Maldonado,2015-11-07,Corey Anderson,Decision - Unanimous,0,0,0,0
Joey Beltran,2013-10-09,Fabio Maldonado,Decision - Split,0,0,0,0
Joey Beltran,2012-01-28,Lavar Johnson,KO/TKO,0,0,0,0
Joey Beltran,2010-05-08,Tim Hague,Decision - Unanimous,80,37,0,117
Joey Beltran,2010-09-25,Matt Mitrione,Decision - Unanimous,0,0,0,0
Joey Beltran,2011-06-11,Aaron Rosa,KO/TKO,100,15,0,115
Joey Beltran,2011-10-08,Stipe Miocic,Decision - Unanimous,0,0,0,0
Joey Beltran,2011-01-22,Pat Barry,Decision - Unanimous,0,9,0,9
Joey Beltran,2010-02-06,Rolles Gracie,KO/TKO,100,7,0,107
Joey Beltran,2012-07-11,James Te Huna,Decision - Unanimous,0,0,0,0
Wilson Reis,2017-02-11,Yuta Sasaki,Decision - Unanimous,80,0,0,80
Wilson Reis,2017-09-09,Henry Cejudo,KO/TKO,0,0,0,0
Wilson Reis,2018-12-01,Ben Nguyen,Decision - Unanimous,80,0,0,80
Wilson Reis,2016-01-30,Dustin Ortiz,Decision - Unanimous,80,3,0,83
Wilson Reis,2017-04-15,Demetrious Johnson,Submission,0,0,25,25
Wilson Reis,2013-09-21,Ivan Menjivar,Decision - Unanimous,80,4,0,84
Wilson Reis,2015-05-30,Jussier Formiga,Decision - Unanimous,0,7,0,7
Wilson Reis,2019-04-13,Alexandre Pantoja,KO/TKO,0,0,0,0
Wilson Reis,2014-10-25,Scott Jorgensen,Submission,90,7,0,97
Wilson Reis,2016-07-30,Hector Sandoval,Submission,90,0,0,90
Wilson Reis,2018-04-14,John Moraga,Decision - Unanimous,0,0,0,0
Wilson Reis,2014-02-15,Iuri Alcantara,Decision - Split,0,0,0,0
Wilson Reis,2014-08-23,Joby Sanchez,Decision - Unanimous,80,2,0,82
Yuta Sasaki,2017-02-11,Wilson Reis,Decision - Unanimous,0,0,0,0
Yuta Sasaki,2014-12-20,Leandro Issa,Submission,0,0,0,0
Yuta Sasaki,2014-08-23,Roland Delorme,Submission,90,4,0,94
Yuta Sasaki,2017-06-17,Justin Scoggins,Submission,90,0,0,90
Yuta Sasaki,2018-11-17,Alexandre Pantoja,Submission,0,3,0,3
Yuta Sasaki,2016-05-08,Willie Gates,Submission,90,0,0,90
Yuta Sasaki,2017-09-22,Jussier Formiga,Submission,0,7,0,7
Yuta Sasaki,2015-06-20,Taylor Lapilus,KO/TKO,0,0,0,0
Yuta Sasaki,2018-06-23,Jenel Lausa,Submission,90,18,0,108
Michael Chiesa,2019-07-06,Diego Sanchez,Decision - Unanimous,80,40,0,120
Michael Chiesa,2021-08-07,Vicente Luque,Submission,0,0,0,0
Michael Chiesa,2018-07-07,Anthony Pettis,Submission,0,3,0,3
Michael Chiesa,2023-07-29,Kevin Holland,Submission,0,0,0,0
Michael Chiesa,2014-09-05,Joe Lauzon,TKO - Doctor's Stoppage,0,9,0,9
Michael Chiesa,2024-12-07,Max Griffin,Submission,90,3,0,93
Michael Chiesa,2015-04-04,Mitch Clarke,Decision - Unanimous,80,0,0,80
Michael Chiesa,2013-07-27,Jorge Masvidal,Submission,0,0,0,0
Michael Chiesa,2017-06-25,Kevin Lee,Submission,0,0,25,25
Michael Chiesa,2013-02-23,Anton Kuivanen,Submission,90,0,0,90
Michael Chiesa,2021-01-20,Neil Magny,Decision - Unanimous,80,12,25,117
Michael Chiesa,2016-04-16,Beneil Dariush,Submission,90,0,0,90
Michael Chiesa,2021-11-20,Sean Brady,Decision - Unanimous,0,11,0,11
Michael Chiesa,2020-01-25,Rafael Dos Anjos,Decision - Unanimous,80,0,0,80
Michael Chiesa,2024-08-03,Tony Ferguson,Submission,90,0,0,90
Michael Chiesa,2018-12-29,Carlos Condit,Submission,90,5,0,95
Michael Chiesa,2012-06-01,Al Iaquinta,Submission,90,1,0,91
Michael Chiesa,2014-05-24,Francisco Trinaldo,Decision - Unanimous,80,6,0,86
Michael Chiesa,2013-11-06,Colton Smith,Submission,90,3,0,93
Michael Chiesa,2015-12-10,Jim Miller,Submission,90,6,0,96
Diego Sanchez,2019-07-06,Michael Chiesa,Decision - Unanimous,0,0,0,0
Diego Sanchez,2007-04-07,Josh Koscheck,Decision - Unanimous,0,0,0,0
Diego Sanchez,2009-12-12,BJ Penn,TKO - Doctor's Stoppage,0,0,25,25
Diego Sanchez,2019-03-02,Mickey Gall,KO/TKO,100,33,0,133
Diego Sanchez,2014-03-15,Myles Jury,Decision - Unanimous,0,0,0,0
Diego Sanchez,2006-05-27,John Alessio,Decision - Unanimous,80,0,0,80
Diego Sanchez,2005-08-20,Brian Gassaway,KO/TKO,100,32,0,132
Diego Sanchez,2005-04-09,Kenny Florian,KO/TKO,100,12,0,112
Diego Sanchez,2016-11-05,Marcin Held,Decision - Unanimous,80,16,0,96
Diego Sanchez,2008-03-01,David Bielkheden,KO/TKO,100,23,0,123
Diego Sanchez,2006-12-13,Joe Riggs,KO/TKO,100,3,0,103
Diego Sanchez,2017-11-11,Matt Brown,KO/TKO,0,0,0,0
Diego Sanchez,2020-02-15,Michel Pereira,DQ,0,0,0,0
Diego Sanchez,2016-07-09,Joe Lauzon,KO/TKO,0,0,0,0
Diego Sanchez,2014-06-07,Ross Pearson,Decision - Split,70,0,0,70
Diego Sanchez,2006-08-17,Karo Parisyan,Decision - Unanimous,80,30,0,110
Diego Sanchez,2010-05-29,John Hathaway,Decision - Unanimous,0,0,0,0
Diego Sanchez,2020-09-26,Jake Matthews,Decision - Unanimous,0,0,0,0
Diego Sanchez,2004-06-12,Jorge Santiago,Decision - Unanimous,80,32,0,112
Diego Sanchez,2010-10-23,Paulo Thiago,Decision - Unanimous,80,12,0,92
Diego Sanchez,2009-02-21,Joe Stevenson,Decision - Unanimous,80,50,0,130
Diego Sanchez,2009-06-20,Clay Guida,Decision - Split,70,39,0,109
Diego Sanchez,2011-03-03,Martin Kampmann,Decision - Unanimous,80,0,0,80
Diego Sanchez,2016-03-05,Jim Miller,Decision - Unanimous,80,0,0,80
Diego Sanchez,2012-02-15,Jake Ellenberger,Decision - Unanimous,0,0,0,0
Diego Sanchez,2015-11-21,Ricardo Lamas,Decision - Unanimous,0,0,0,0
Diego Sanchez,2007-09-22,Jon Fitch,Decision - Split,0,0,0,0
Diego Sanchez,2013-10-19,Gilbert Melendez,Decision - Unanimous,0,0,0,0
Diego Sanchez,2008-06-21,Luigi Fioravanti,KO/TKO,100,24,0,124
Diego Sanchez,2005-11-05,Nick Diaz,Decision - Unanimous,80,28,0,108
Diego Sanchez,2018-09-08,Craig White,Decision - Unanimous,80,28,0,108
Diego Sanchez,2002-12-15,Shannon Ritch,Submission,90,5,0,95
Diego Sanchez,2017-04-22,Al Iaquinta,KO/TKO,0,0,0,0
Diego Sanchez,2003-06-14,Rene Kronvold,Submission,90,6,0,96
Diego Sanchez,2013-03-02,Takanori Gomi,Decision - Split,70,0,0,70
Brady Hiestand,2024-06-15,Garrett Armfield,Submission,90,0,0,90
Brady Hiestand,2021-08-28,Ricky Turcios,Decision - Split,0,0,0,0
Brady Hiestand,2022-11-19,Fernie Garcia,Decision - Unanimous,80,0,0,80
Brady Hiestand,2023-04-22,Batgerel Danaa,KO/TKO,100,4,0,104
Garrett Armfield,2024-06-15,Brady Hiestand,Submission,0,27,0,27
Garrett Armfield,2024-11-02,Serhiy Sidey,Decision - Split,0,3,0,3
Garrett Armfield,2022-07-09,David Onama,Submission,0,0,0,0
Garrett Armfield,2024-01-20,Brad Katona,Decision - Unanimous,80,41,0,121
Garrett Armfield,2023-08-26,Toshiomi Kazama,KO/TKO,100,30,0,130
Trevin Giles,2020-11-07,Bevon Lewis,KO/TKO,100,12,0,112
Trevin Giles,2017-07-08,James Bochnovic,KO/TKO,100,36,0,136
Trevin Giles,2019-08-03,Gerald Meerschaert,Submission,0,2,0,2
Trevin Giles,2024-11-02,Mike Malott,Decision - Unanimous,0,0,0,0
Trevin Giles,2021-07-10,Dricus Du Plessis,KO/TKO,0,0,0,0
Trevin Giles,2017-12-09,Antonio Braga Neto,KO/TKO,100,52,0,152
Trevin Giles,2021-03-20,Roman Dolidze,Decision - Unanimous,80,0,0,80
Trevin Giles,2022-09-17,Louis Cosce,Decision - Unanimous,80,15,0,95
Trevin Giles,2022-01-22,Michael Morales,KO/TKO,0,0,0,0
Trevin Giles,2023-07-29,Gabriel Bonfim,Submission,0,0,0,0
Trevin Giles,2019-05-18,Zak Cummings,Submission,0,0,0,0
Trevin Giles,2024-02-10,Carlos Prates,KO/TKO,0,31,0,31
Trevin Giles,2020-02-08,James Krause,Decision - Split,70,27,0,97
Trevin Giles,2023-03-25,Preston Parsons,Decision - Split,70,13,0,83
Bevon Lewis,2020-11-07,Trevin Giles,KO/TKO,0,0,0,0
Bevon Lewis,2017-08-29,Elias Urbina,KO/TKO,100,18,0,118
Bevon Lewis,2019-06-08,Darren Stewart,Decision - Unanimous,0,1,0,1
Bevon Lewis,2018-12-29,Uriah Hall,KO/TKO,0,29,0,29
Bevon Lewis,2018-07-10,Alton Cunningham,KO/TKO,100,24,0,124
Bevon Lewis,2020-01-25,Dequan Townsend,Decision - Unanimous,80,8,0,88
Shane Burgos,2019-05-04,Cub Swanson,Decision - Split,70,5,0,75
Shane Burgos,2017-04-08,Charles Rosa,KO/TKO,100,0,0,100
Shane Burgos,2022-07-16,Charles Jourdain,Decision - Majority,75,0,0,75
Shane Burgos,2021-11-06,Billy Quarantillo,Decision - Unanimous,80,29,0,109
Shane Burgos,2017-07-22,Godofredo Pepey,Decision - Unanimous,80,51,0,131
Shane Burgos,2021-05-15,Edson Barboza,KO/TKO,0,0,0,0
Shane Burgos,2018-01-20,Calvin Kattar,KO/TKO,0,4,0,4
Shane Burgos,2020-06-20,Josh Emmett,Decision - Unanimous,0,1,0,1
Shane Burgos,2016-12-09,Tiago dos Santos e Silva,Decision - Unanimous,80,17,0,97
Shane Burgos,2018-11-03,Kurt Holobaugh,Submission,90,0,0,90
Shane Burgos,2019-11-02,Makwan Amirkhani,KO/TKO,100,83,0,183
Cub Swanson,2019-05-04,Shane Burgos,Decision - Split,0,0,0,0
Cub Swanson,2015-04-18,Max Holloway,Submission,0,0,0,0
Cub Swanson,2009-11-18,John Franchi,Submission,90,11,0,101
Cub Swanson,2007-03-24,Tommy Lee,Submission,90,1,0,91
Cub Swanson,2012-01-28,George Roop,KO/TKO,100,8,0,108
Cub Swanson,2013-07-06,Dennis Siver,KO/TKO,100,17,0,117
Cub Swanson,2017-04-22,Artem Lobov,Decision - Unanimous,80,86,25,191
Cub Swanson,2010-11-11,Mackens Semerzier,Decision - Split,70,18,0,88
Cub Swanson,2014-11-22,Frankie Edgar,Submission,0,0,25,25
Cub Swanson,2024-12-14,Billy Quarantillo,KO/TKO,100,2,0,102
Cub Swanson,2019-10-12,Kron Gracie,Decision - Unanimous,80,49,0,129
Cub Swanson,2018-04-21,Frankie Edgar,Decision - Unanimous,0,0,0,0
Cub Swanson,2007-12-12,Jens Pulver,Submission,0,0,0,0
Cub Swanson,2016-12-10,Dooho Choi,Decision - Unanimous,80,34,0,114
Cub Swanson,2009-06-07,Jose Aldo,KO/TKO,0,0,0,0
Cub Swanson,2016-08-06,Tatsuya Kawajiri,Decision - Unanimous,80,44,0,124
Cub Swanson,2018-08-04,Renato Moicano,Submission,0,3,0,3
Cub Swanson,2013-02-16,Dustin Poirier,Decision - Unanimous,80,0,0,80
Cub Swanson,2014-06-28,Jeremy Stephens,Decision - Unanimous,80,22,25,127
Cub Swanson,2010-08-18,Chad Mendes,Decision - Unanimous,0,10,0,10
Cub Swanson,2016-04-16,Hacran Dias,Decision - Unanimous,80,28,0,108
Cub Swanson,2012-06-22,Ross Pearson,KO/TKO,100,7,0,107
Cub Swanson,2008-12-03,Hiroyuki Takaya,Decision - Unanimous,80,3,0,83
Cub Swanson,2012-09-22,Charles Oliveira,KO/TKO,100,3,0,103
Cub Swanson,2021-05-01,Giga Chikadze,KO/TKO,0,0,0,0
Cub Swanson,2021-12-18,Darren Elkins,KO/TKO,100,16,0,116
Cub Swanson,2017-12-09,Brian Ortega,Submission,0,36,25,61
Cub Swanson,2023-08-12,Hakeem Dawodu,Decision - Unanimous,80,0,0,80
Cub Swanson,2022-10-15,Jonathan Martinez,KO/TKO,0,0,0,0
Cub Swanson,2007-06-03,Micah Miller,Decision - Unanimous,80,22,0,102
Cub Swanson,2011-11-12,Ricardo Lamas,Submission,0,8,0,8
Cub Swanson,2024-06-29,Andre Fili,Decision - Split,0,0,0,0
Cub Swanson,2020-12-12,Daniel Pineda,KO/TKO,100,25,0,125
Marcio Cruz,2005-10-07,Keigo Kunihara,Submission,90,11,0,101
Marcio Cruz,2006-04-15,Jeff Monson,Decision - Split,0,8,0,8
Marcio Cruz,2006-12-30,Andrei Arlovski,KO/TKO,0,0,0,0
Marcio Cruz,2006-02-04,Frank Mir,KO/TKO,100,28,0,128
Keigo Kunihara,2005-10-07,Marcio Cruz,Submission,0,0,0,0
Kajan Johnson,2018-03-17,Stevie Ray,Decision - Split,70,9,0,79
Kajan Johnson,2018-07-28,Islam Makhachev,Submission,0,0,0,0
Kajan Johnson,2017-09-09,Adriano Martins,KO/TKO,100,10,0,110
Kajan Johnson,2018-09-15,Rustam Khabilov,Decision - Split,0,27,0,27
Kajan Johnson,2015-09-26,Naoyuki Kotani,Decision - Unanimous,80,36,0,116
Kajan Johnson,2014-06-14,Tae Hyun Bang,KO/TKO,0,0,0,0
Kajan Johnson,2015-05-16,Zhang Lipeng,Decision - Unanimous,80,0,0,80
Stevie Ray,2018-03-17,Kajan Johnson,Decision - Split,0,0,0,0
Stevie Ray,2015-04-11,Marcin Bandel,KO/TKO,100,28,0,128
Stevie Ray,2019-06-01,Leonardo Santos,KO/TKO,0,0,0,0
Stevie Ray,2017-07-16,Paul Felder,KO/TKO,0,0,0,0
Stevie Ray,2015-07-18,Leonardo Mafra,KO/TKO,100,0,0,100
Stevie Ray,2016-11-19,Ross Pearson,Decision - Split,70,11,0,81
Stevie Ray,2015-10-24,Mickael Lebout,Decision - Unanimous,80,21,0,101
Stevie Ray,2018-10-27,Jessin Ayari,Decision - Unanimous,80,12,0,92
Stevie Ray,2017-04-22,Joe Lauzon,Decision - Majority,75,63,0,138
Stevie Ray,2019-10-26,Michael Johnson,Decision - Majority,75,7,0,82
Stevie Ray,2016-09-24,Alan Patrick,Decision - Unanimous,0,0,0,0
Joanne Wood,2016-06-18,Valerie Letourneau,KO/TKO,100,35,0,135
Joanne Wood,2015-04-11,Maryna Moroz,Submission,0,0,0,0
Joanne Wood,2015-07-18,Cortney Casey,Decision - Unanimous,80,33,0,113
Joanne Wood,2021-01-23,Jessica Eye,Decision - Unanimous,80,71,0,151
Joanne Wood,2021-11-20,Taila Santos,Submission,0,0,0,0
Joanne Wood,2017-07-16,Cynthia Calvillo,Decision - Unanimous,0,9,0,9
Joanne Wood,2014-12-12,Seo Hee Ham,Decision - Unanimous,80,51,0,131
Joanne Wood,2018-08-25,Kalindra Faria,Submission,90,0,0,90
Joanne Wood,2023-03-18,Luana Carolina,Decision - Split,70,31,0,101
Joanne Wood,2019-06-08,Katlyn Cerminara,Decision - Unanimous,0,30,0,30
Joanne Wood,2019-09-07,Andrea Lee,Decision - Split,70,40,0,110
Joanne Wood,2019-01-19,Ariane da Silva,Decision - Unanimous,80,32,0,112
Joanne Wood,2020-08-01,Jennifer Maia,Submission,0,6,0,6
Joanne Wood,2016-09-10,Jessica Andrade,Submission,0,0,0,0
Joanne Wood,2024-03-09,Maryna Moroz,Decision - Split,70,34,0,104
Joanne Wood,2021-06-12,Lauren Murphy,Decision - Split,0,43,0,43
Joanne Wood,2022-03-26,Alexa Grasso,Submission,0,18,0,18
Valerie Letourneau,2016-06-18,Joanne Wood,KO/TKO,0,0,0,0
Valerie Letourneau,2016-12-10,Viviane Pereira,Decision - Split,0,22,0,22
Valerie Letourneau,2015-04-25,Jessica Rakoczy,Decision - Unanimous,80,0,0,80
Valerie Letourneau,2014-06-14,Elizabeth Phillips,Decision - Split,70,37,0,107
Valerie Letourneau,2015-11-14,Joanna Jedrzejczyk,Decision - Unanimous,0,0,25,25
Valerie Letourneau,2015-08-23,Maryna Moroz,Decision - Unanimous,80,14,0,94
Abel Trujillo,2014-02-01,Jamie Varner,KO/TKO,100,0,0,100
Abel Trujillo,2016-05-29,Jordan Rinaldi,Decision - Unanimous,80,17,0,97
Abel Trujillo,2012-12-08,Marcus LeVesseur,KO/TKO,100,48,0,148
Abel Trujillo,2013-05-25,Khabib Nurmagomedov,Decision - Unanimous,0,0,0,0
Abel Trujillo,2017-12-16,John Makdessi,Decision - Unanimous,0,0,0,0
Abel Trujillo,2017-02-04,James Vick,Submission,0,0,0,0
Abel Trujillo,2014-12-06,Tony Ferguson,Submission,0,0,0,0
Abel Trujillo,2016-01-02,Tony Sims,Submission,90,0,0,90
Abel Trujillo,2013-12-14,Roger Bowling,KO/TKO,100,34,0,134
Abel Trujillo,2015-11-07,Gleison Tibau,DQ,0,0,0,0
Jamie Varner,2014-02-01,Abel Trujillo,KO/TKO,0,18,0,18
Jamie Varner,2014-12-13,Drew Dober,Submission,0,0,0,0
Jamie Varner,2006-08-26,Hermes Franca,Submission,0,0,0,0
Jamie Varner,2008-08-03,Marcus Hicks,KO/TKO,100,26,25,151
Jamie Varner,2010-09-30,Donald Cerrone,Decision - Unanimous,0,0,0,0
Jamie Varner,2012-05-26,Edson Barboza,KO/TKO,100,9,0,109
Jamie Varner,2007-03-03,Jason Gilliam,Submission,90,7,0,97
Jamie Varner,2013-08-31,Gleison Tibau,Decision - Split,0,11,0,11
Jamie Varner,2010-12-16,Shane Roller,Submission,0,2,0,2
Jamie Varner,2012-08-04,Joe Lauzon,Submission,0,38,0,38
Jamie Varner,2009-01-25,Donald Cerrone,Decision - Split,70,0,25,95
Jamie Varner,2008-02-13,Rob McCullough,KO/TKO,100,23,25,148
Jamie Varner,2007-08-05,Sherron Leggett,KO/TKO,100,17,0,117
Jamie Varner,2014-05-24,James Krause,KO/TKO,0,0,0,0
Jamie Varner,2012-12-29,Melvin Guillard,Decision - Split,70,0,0,70
Jamie Varner,2010-01-10,Benson Henderson,Submission,0,4,25,29
Maryna Moroz,2015-04-11,Joanne Wood,Submission,90,1,0,91
Maryna Moroz,2023-08-19,Karine Silva,Submission,0,0,0,0
Maryna Moroz,2022-03-05,Mariya Agapova,Submission,90,12,0,102
Maryna Moroz,2019-03-30,Sabina Mazo,Decision - Unanimous,80,0,0,80
Maryna Moroz,2016-08-06,Danielle Taylor,Decision - Split,70,0,0,70
Maryna Moroz,2024-03-09,Joanne Wood,Decision - Split,0,0,0,0
Maryna Moroz,2020-03-14,Mayra Bueno Silva,Decision - Unanimous,80,51,0,131
Maryna Moroz,2015-08-23,Valerie Letourneau,Decision - Unanimous,0,0,0,0
Maryna Moroz,2017-06-25,Carla Esparza,Decision - Unanimous,0,0,0,0
Maryna Moroz,2016-04-10,Cristina Stanciu,Decision - Unanimous,80,0,0,80
Maryna Moroz,2022-11-19,Jennifer Maia,Decision - Unanimous,0,0,0,0
Maryna Moroz,2018-02-24,Angela Hill,Decision - Unanimous,0,0,0,0
,2014-07-26,,Overturned,0,0,0,0
,2014-07-26,,Overturned,0,0,0,0
,2002-05-10,,Overturned,0,0,0,0
,2002-05-10,,Overturned,0,0,0,0
,2019-07-09,,Overturned,0,0,0,0
,2019-07-09,,Overturned,0,0,0,0
,2015-01-31,,Overturned,0,0,25,25
,2015-01-31,,Overturned,0,0,25,25
,2015-01-03,,Overturned,0,0,0,0
,2015-01-03,,Overturned,0,0,0,0
,2013-12-28,,Overturned,0,0,0,0
,2013-12-28,,Overturned,0,0,0,0
,2020-06-20,,Overturned,0,0,0,0
,2020-06-20,,Overturned,0,0,0,0
,2018-06-26,,Overturned,0,0,0,0
,2018-06-26,,Overturned,0,0,0,0
,2017-12-30,,Overturned,0,0,0,0
,2017-12-30,,Overturned,0,0,0,0
,2020-09-12,,Overturned,0,0,0,0
,2020-09-12,,Overturned,0,0,0,0
,2021-03-13,,Could Not Continue,0,0,0,0
,2021-03-13,,Could Not Continue,0,0,0,0
,2014-12-12,,Could Not Continue,0,0,0,0
,2014-12-12,,Could Not Continue,0,0,0,0
,2006-06-09,,Could Not Continue,0,0,0,0
,2006-06-09,,Could Not Continue,0,0,0,0
,2014-04-11,,Could Not Continue,0,0,0,0
,2014-04-11,,Could Not Continue,0,0,0,0
,2021-10-02,,Overturned,0,0,0,0
,2021-10-02,,Overturned,0,0,0,0
,2012-07-21,,Overturned,0,0,0,0
,2012-07-21,,Overturned,0,0,0,0
,2013-10-19,,Overturned,0,0,0,0
,2013-10-19,,Overturned,0,0,0,0
,2012-08-11,,Overturned,0,0,0,0
,2012-08-11,,Overturned,0,0,0,0
,2020-09-19,,Overturned,0,0,0,0
,2020-09-19,,Overturned,0,0,0,0
,2013-03-02,,Overturned,0,0,0,0
,2013-03-02,,Overturned,0,0,0,0
,2013-04-27,,Overturned,0,0,0,0
,2013-04-27,,Overturned,0,0,0,0
,2008-05-31,,Could Not Continue,0,0,25,25
,2008-05-31,,Could Not Continue,0,0,25,25
,2023-09-23,,Overturned,0,0,0,0
,2023-09-23,,Overturned,0,0,0,0
,2012-05-19,,Overturned,0,0,0,0
,2012-05-19,,Overturned,0,0,0,0
,2015-12-19,,Could Not Continue,0,0,0,0
,2015-12-19,,Could Not Continue,0,0,0,0
,2013-10-26,,Could Not Continue,0,0,0,0
,2013-10-26,,Could Not Continue,0,0,0,0
,2015-03-21,,Overturned,0,0,0,0
,2015-03-21,,Overturned,0,0,0,0
,2013-11-06,,Overturned,0,0,0,0
,2013-11-06,,Overturned,0,0,0,0
,2019-07-13,,Overturned,0,0,0,0
,2019-07-13,,Overturned,0,0,0,0
,2009-01-31,,Overturned,0,0,0,0
,2009-01-31,,Overturned,0,0,0,0
,2024-03-16,,Could Not Continue,0,0,0,0
,2024-03-16,,Could Not Continue,0,0,0,0
,2017-07-11,,Overturned,0,0,0,0
,2017-07-11,,Overturned,0,0,0,0
,2014-07-06,,Overturned,0,0,0,0
,2014-07-06,,Overturned,0,0,0,0
,2008-03-15,,Could Not Continue,0,0,0,0
,2008-03-15,,Could Not Continue,0,0,0,0
,2009-05-26,,Could Not Continue,0,0,0,0
,2009-05-26,,Could Not Continue,0,0,0,0
,2016-12-30,,Could Not Continue,0,0,0,0
,2016-12-30,,Could Not Continue,0,0,0,0
,2021-06-05,,Could Not Continue,0,0,0,0
,2021-06-05,,Could Not Continue,0,0,0,0
,2023-06-17,,Overturned,0,0,0,0
,2023-06-17,,Overturned,0,0,0,0
,2015-05-30,,Overturned,0,0,0,0
,2015-05-30,,Overturned,0,0,0,0
,2007-09-05,,Overturned,0,0,0,0
,2007-09-05,,Overturned,0,0,0,0
,2023-06-10,,Could Not Continue,0,0,0,0
,2023-06-10,,Could Not Continue,0,0,0,0
,2007-12-31,,Overturned,0,0,0,0
,2007-12-31,,Overturned,0,0,0,0
,2021-05-15,,Overturned,0,0,0,0
,2021-05-15,,Overturned,0,0,0,0
,2012-07-21,,Overturned,0,0,0,0
,2012-07-21,,Overturned,0,0,0,0
,2016-11-19,,Overturned,0,0,0,0
,2016-11-19,,Overturned,0,0,0,0
,2011-06-26,,Overturned,0,0,0,0
,2011-06-26,,Overturned,0,0,0,0
,2019-08-27,,Could Not Continue,0,0,0,0
,2019-08-27,,Could Not Continue,0,0,0,0
,2019-09-14,,Could Not Continue,0,0,0,0
,2019-09-14,,Could Not Continue,0,0,0,0
,2016-07-09,,Overturned,0,0,0,0
,2016-07-09,,Overturned,0,0,0,0
,2023-10-21,,Could Not Continue,0,0,0,0
,2023-10-21,,Could Not Continue,0,0,0,0
,2011-11-12,,Overturned,0,0,0,0
,2011-11-12,,Overturned,0,0,0,0
,2018-12-29,,Overturned,0,0,0,0
,2018-12-29,,Overturned,0,0,0,0
,2014-01-25,,Overturned,0,0,0,0
,2014-01-25,,Overturned,0,0,0,0
,2021-09-07,,KO/TKO,100,0,0,100
,2021-09-07,,KO/TKO,0,0,0,0
,2012-08-04,,Could Not Continue,0,0,0,0
,2012-08-04,,Could Not Continue,0,0,0,0
,2021-07-17,,Overturned,0,0,0,0
,2021-07-17,,Overturned,0,0,0,0
,1999-09-12,,Could Not Continue,0,0,0,0
,1999-09-12,,Could Not Continue,0,0,0,0
,2020-08-22,,Overturned,0,0,0,0
,2020-08-22,,Overturned,0,0,0,0
,2013-01-19,,Could Not Continue,0,0,0,0
,2013-01-19,,Could Not Continue,0,0,0,0
,2017-02-04,,Overturned,0,0,0,0
,2017-02-04,,Overturned,0,0,0,0
,2023-07-15,,Overturned,0,0,25,25
,2023-07-15,,Overturned,0,0,25,25
,2017-05-13,,Could Not Continue,0,0,0,0
,2017-05-13,,Could Not Continue,0,0,0,0
,2023-11-18,,Overturned,0,0,0,0
,2023-11-18,,Overturned,0,0,0,0
,2008-09-23,,Could Not Continue,0,0,0,0
,2008-09-23,,Could Not Continue,0,0,0,0
,2024-02-10,,Could Not Continue,0,0,0,0
,2024-02-10,,Could Not Continue,0,0,0,0
,2013-08-28,,Could Not Continue,0,0,0,0
,2013-08-28,,Could Not Continue,0,0,0,0
,2012-01-07,,Overturned,0,0,0,0
,2012-01-07,,Overturned,0,0,0,0
,2010-11-19,,Could Not Continue,0,0,0,0
,2010-11-19,,Could Not Continue,0,0,0,0
,2011-01-01,,Overturned,0,0,0,0
,2011-01-01,,Overturned,0,0,0,0
,2001-02-23,,Overturned,0,0,0,0
,2001-02-23,,Overturned,0,0,0,0
,2018-06-09,,Overturned,0,0,0,0
,2018-06-09,,Overturned,0,0,0,0
,2023-04-22,,Could Not Continue,0,0,0,0
,2023-04-22,,Could Not Continue,0,0,0,0
,2015-12-10,,Could Not Continue,0,0,0,0
,2015-12-10,,Could Not Continue,0,0,0,0
,2019-09-21,,Could Not Continue,0,0,25,25
,2019-09-21,,Could Not Continue,0,0,25,25
,2014-07-05,,Overturned,0,0,0,0
,2014-07-05,,Overturned,0,0,0,0
,2011-06-18,,Could Not Continue,0,0,0,0
,2011-06-18,,Could Not Continue,0,0,0,0
,2012-12-14,,Overturned,0,0,0,0
,2012-12-14,,Overturned,0,0,0,0
,2023-09-16,,Overturned,0,0,0,0
,2023-09-16,,Overturned,0,0,0,0
,2017-07-29,,Overturned,0,0,25,25
,2017-07-29,,Overturned,0,0,25,25
,2020-02-08,,Overturned,0,0,0,0
,2020-02-08,,Overturned,0,0,0,0
,2022-07-30,,Overturned,0,0,0,0
,2022-07-30,,Overturned,0,0,0,0
,2017-03-11,,Overturned,0,0,25,25
,2017-03-11,,Overturned,0,0,25,25
,2019-10-05,,Overturned,0,0,0,0
,2019-10-05,,Overturned,0,0,0,0
,2018-06-19,,Overturned,0,0,0,0
,2018-06-19,,Overturned,0,0,0,0
,2007-06-23,,Could Not Continue,0,0,0,0
,2007-06-23,,Could Not Continue,0,0,0,0
,2017-02-04,,Overturned,0,0,0,0
,2017-02-04,,Overturned,0,0,0,0
,2011-12-17,,Overturned,0,0,25,25
,2011-12-17,,Overturned,0,0,25,25
,2024-07-13,,Could Not Continue,0,0,0,0
,2024-07-13,,Could Not Continue,0,0,0,0
,2021-06-26,,Could Not Continue,0,0,0,0
,2021-06-26,,Could Not Continue,0,0,0,0
,2014-03-08,,Overturned,0,0,0,0
,2014-03-08,,Overturned,0,0,0,0
,2024-02-03,,Could Not Continue,0,0,0,0
,2024-02-03,,Could Not Continue,0,0,0,0
,2020-07-25,,Overturned,0,0,0,0
,2020-07-25,,Overturned,0,0,0,0
,2022-07-02,,Could Not Continue,0,0,0,0
,2022-07-02,,Could Not Continue,0,0,0,0
,2012-11-10,,Overturned,0,0,0,0
,2012-11-10,,Overturned,0,0,0,0
,2000-10-31,,Could Not Continue,0,0,0,0
,2000-10-31,,Could Not Continue,0,0,0,0
,2021-03-13,,Could Not Continue,0,0,25,25
,2021-03-13,,Could Not Continue,0,0,25,25
,2005-10-07,,Could Not Continue,0,0,0,0
,2005-10-07,,Could Not Continue,0,0,0,0
,2013-02-16,,Overturned,0,0,0,0
,2013-02-16,,Overturned,0,0,0,0
,2023-06-24,,Could Not Continue,0,0,0,0
,2023-06-24,,Could Not Continue,0,0,0,0
,2015-02-28,,Could Not Continue,0,0,0,0
,2015-02-28,,Could Not Continue,0,0,0,0
,1997-12-21,,Overturned,0,0,0,0
,1997-12-21,,Overturned,0,0,0,0
,2004-08-15,,Could Not Continue,0,0,0,0
,2004-08-15,,Could Not Continue,0,0,0,0
,2001-01-13,,Could Not Continue,0,0,0,0
,2001-01-13,,Could Not Continue,0,0,0,0
,2014-10-04,,Overturned,0,0,0,0
,2014-10-04,,Overturned,0,0,0,0
,2006-12-31,,Overturned,0,0,0,0
,2006-12-31,,Overturned,0,0,0,0
,2020-05-30,,Overturned,0,0,0,0
,2020-05-30,,Overturned,0,0,0,0
,2023-10-21,,Could Not Continue,0,0,0,0
,2023-10-21,,Could Not Continue,0,0,0,0
,2007-02-24,,Overturned,0,0,0,0
,2007-02-24,,Overturned,0,0,0,0
,2018-11-10,,Overturned,0,0,0,0
,2018-11-10,,Overturned,0,0,0,0
,2019-10-18,,Overturned,0,0,0,0
,2019-10-18,,Overturned,0,0,0,0
Ralph Gracie,2004-05-23,Takanori Gomi,KO/TKO,0,0,0,0
Ralph Gracie,2003-10-05,Dokonjonosuke Mishima,Decision - Unanimous,80,0,0,80
Cody Durden,2024-09-07,Matt Schnell,Submission,90,0,0,90
Cody Durden,2024-12-07,Joshua Van,Decision - Unanimous,0,0,0,0
Cody Durden,2023-04-29,Charles Johnson,Decision - Unanimous,80,4,0,84
Cody Durden,2024-07-20,Bruno Silva,KO/TKO,0,0,0,0
Cody Durden,2022-06-25,JP Buys,KO/TKO,100,16,0,116
Cody Durden,2021-11-20,Aoriqileng,Decision - Unanimous,80,0,0,80
Cody Durden,2020-12-19,Jimmy Flick,Submission,0,15,0,15
Cody Durden,2023-12-16,Tagir Ulanbekov,Submission,0,8,0,8
Cody Durden,2022-03-19,Muhammad Mokaev,Submission,0,0,0,0
Cody Durden,2022-10-29,Carlos Mota,Decision - Unanimous,80,5,0,85
Cody Durden,2023-08-05,Jake Hadley,Decision - Unanimous,80,12,0,92
Matt Schnell,2024-09-07,Cody Durden,Submission,0,6,0,6
Matt Schnell,2017-10-07,Marco Beltran,Decision - Unanimous,80,4,0,84
Matt Schnell,2018-06-23,Naoki Inoue,Decision - Split,70,23,0,93
Matt Schnell,2022-07-16,Sumudaerji,Submission,90,0,0,90
Matt Schnell,2019-03-09,Louis Smolka,Submission,90,1,0,91
Matt Schnell,2022-05-07,Brandon Royval,Submission,0,0,0,0
Matt Schnell,2017-04-22,Hector Sandoval,KO/TKO,0,0,0,0
Matt Schnell,2016-12-03,Rob Font,KO/TKO,0,0,0,0
Matt Schnell,2019-08-03,Jordan Espinosa,Submission,90,0,0,90
Matt Schnell,2022-12-03,Matheus Nicolau,KO/TKO,0,0,0,0
Matt Schnell,2019-12-21,Alexandre Pantoja,KO/TKO,0,0,0,0
Matt Schnell,2021-01-20,Tyson Nam,Decision - Split,70,27,0,97
Matt Schnell,2024-03-02,Steve Erceg,KO/TKO,0,0,0,0
Amanda Nunes,2015-03-21,Shayna Baszler,KO/TKO,100,14,0,114
Amanda Nunes,2021-03-06,Megan Anderson,Submission,90,16,25,131
Amanda Nunes,2020-06-06,Felicia Spencer,Decision - Unanimous,80,82,25,187
Amanda Nunes,2011-09-10,Alexis Davis,KO/TKO,0,0,0,0
Amanda Nunes,2017-09-09,Valentina Shevchenko,Decision - Split,70,14,25,109
Amanda Nunes,2015-08-08,Sara McMann,Submission,90,25,0,115
Amanda Nunes,2016-03-05,Valentina Shevchenko,Decision - Unanimous,80,11,0,91
Amanda Nunes,2014-09-27,Cat Zingano,KO/TKO,0,0,0,0
Amanda Nunes,2013-11-06,Germaine de Randamie,KO/TKO,100,13,0,113
Amanda Nunes,2011-01-07,Julia Budd,KO/TKO,100,8,0,108
Amanda Nunes,2022-07-30,Julianna Pena,Decision - Unanimous,80,25,25,130
Amanda Nunes,2019-07-06,Holly Holm,KO/TKO,100,6,25,131
Amanda Nunes,2023-06-10,Irene Aldana,Decision - Unanimous,80,101,25,206
Amanda Nunes,2019-12-14,Germaine de Randamie,Decision - Unanimous,80,39,25,144
Amanda Nunes,2018-05-12,Raquel Pennington,KO/TKO,100,60,25,185
Amanda Nunes,2018-12-29,Cristiane Justino,KO/TKO,100,10,25,135
Amanda Nunes,2013-08-03,Sheila Gaff,KO/TKO,100,7,0,107
Amanda Nunes,2016-07-09,Miesha Tate,Submission,90,37,25,152
Amanda Nunes,2021-12-11,Julianna Pena,Submission,0,0,25,25
Amanda Nunes,2016-12-30,Ronda Rousey,KO/TKO,100,20,25,145
Shayna Baszler,2015-03-21,Amanda Nunes,KO/TKO,0,0,0,0
Shayna Baszler,2012-07-28,Sara McMann,Decision - Unanimous,0,0,0,0
Shayna Baszler,2014-08-30,Bethe Correia,KO/TKO,0,0,0,0
Shayna Baszler,2009-06-19,Sarah Kaufman,Decision - Unanimous,0,0,0,0
Shayna Baszler,2008-07-26,Cristiane Justino,KO/TKO,0,0,0,0
Roan Carneiro,2015-02-28,Mark Munoz,Submission,90,1,0,91
Roan Carneiro,2008-06-07,Kevin Burns,Submission,0,4,0,4
Roan Carneiro,2016-02-21,Derek Brunson,KO/TKO,0,0,0,0
Roan Carneiro,2007-12-29,Tony DeSouza,KO/TKO,100,15,0,115
Roan Carneiro,2008-09-06,Ryo Chonan,Decision - Split,0,0,0,0
Roan Carneiro,2007-06-12,Jon Fitch,Submission,0,0,0,0
Roan Carneiro,2007-04-05,Rich Clementi,Decision - Unanimous,80,13,0,93
Roan Carneiro,2002-01-31,Anderson Silva,KO/TKO,0,0,0,0
Roan Carneiro,2017-02-11,Ryan LaFlare,Decision - Unanimous,0,0,0,0
Roan Carneiro,2016-09-17,Kenny Robertson,Decision - Split,70,5,0,75
Mark Munoz,2015-02-28,Roan Carneiro,Submission,0,0,0,0
Mark Munoz,2009-08-29,Nick Catone,Decision - Split,70,15,0,85
Mark Munoz,2010-11-20,Aaron Simpson,Decision - Unanimous,80,33,0,113
Mark Munoz,2012-07-11,Chris Weidman,KO/TKO,0,0,25,25
Mark Munoz,2013-07-06,Tim Boetsch,Decision - Unanimous,80,46,0,126
Mark Munoz,2008-06-01,Chuck Grigsby,KO/TKO,100,11,0,111
Mark Munoz,2009-03-07,Matt Hamill,KO/TKO,0,0,0,0
Mark Munoz,2010-08-01,Yushin Okami,Decision - Split,0,0,0,0
Mark Munoz,2011-06-11,Demian Maia,Decision - Unanimous,80,12,0,92
Mark Munoz,2014-05-31,Gegard Mousasi,Submission,0,0,25,25
Mark Munoz,2013-10-26,Lyoto Machida,KO/TKO,0,0,25,25
Mark Munoz,2011-11-05,Chris Leben,KO/TKO,100,27,25,152
Mark Munoz,2015-05-16,Luke Barnatt,Decision - Unanimous,80,0,0,80
Mark Munoz,2010-04-10,Kendall Grove,KO/TKO,100,16,0,116
Mark Munoz,2008-12-03,Ricardo Barros,KO/TKO,100,20,0,120
Mark Munoz,2010-01-02,Ryan Jensen,KO/TKO,100,7,0,107
Mark Munoz,2011-03-03,CB Dollaway,KO/TKO,100,2,0,102
Ciryl Gane,2020-12-12,Junior Dos Santos,KO/TKO,100,49,0,149
Ciryl Gane,2024-12-07,Alexander Volkov,Decision - Split,70,4,0,74
Ciryl Gane,2023-09-02,Serghei Spivac,KO/TKO,100,98,25,223
Ciryl Gane,2022-01-22,Francis Ngannou,Decision - Unanimous,0,20,25,45
Ciryl Gane,2021-08-07,Derrick Lewis,KO/TKO,100,82,25,207
Ciryl Gane,2022-09-03,Tai Tuivasa,KO/TKO,100,81,25,206
Ciryl Gane,2021-06-26,Alexander Volkov,Decision - Unanimous,80,20,25,125
Ciryl Gane,2023-03-04,Jon Jones,Submission,0,1,25,26
Ciryl Gane,2021-02-27,Jairzinho Rozenstruik,Decision - Unanimous,80,60,25,165
Ciryl Gane,2019-10-26,Don'Tale Mayes,Submission,90,62,0,152
Ciryl Gane,2019-12-21,Tanner Boser,Decision - Unanimous,80,33,0,113
Ciryl Gane,2019-08-10,Raphael Pessoa,Submission,90,8,0,98
Junior Dos Santos,2020-12-12,Ciryl Gane,KO/TKO,0,0,0,0
Junior Dos Santos,2020-08-15,Jairzinho Rozenstruik,KO/TKO,0,0,0,0
Junior Dos Santos,2018-12-01,Tai Tuivasa,KO/TKO,100,10,25,135
Junior Dos Santos,2008-10-25,Fabricio Werdum,KO/TKO,100,1,0,101
Junior Dos Santos,2009-02-21,Stefan Struve,KO/TKO,100,12,0,112
Junior Dos Santos,2010-03-21,Gabriel Gonzaga,KO/TKO,100,11,0,111
Junior Dos Santos,2011-11-12,Cain Velasquez,KO/TKO,100,1,25,126
Junior Dos Santos,2011-06-11,Shane Carwin,Decision - Unanimous,80,68,0,148
Junior Dos Santos,2016-04-10,Ben Rothwell,Decision - Unanimous,80,80,25,185
Junior Dos Santos,2019-06-29,Francis Ngannou,KO/TKO,0,0,25,25
Junior Dos Santos,2012-05-26,Frank Mir,KO/TKO,100,42,25,167
Junior Dos Santos,2010-01-02,Gilbert Yvel,KO/TKO,100,11,0,111
Junior Dos Santos,2018-07-14,Blagoy Ivanov,Decision - Unanimous,80,59,25,164
Junior Dos Santos,2009-09-19,Mirko Filipovic,KO/TKO,100,48,0,148
Junior Dos Santos,2014-12-13,Stipe Miocic,Decision - Unanimous,80,34,25,139
Junior Dos Santos,2010-08-07,Roy Nelson,Decision - Unanimous,80,90,0,170
Junior Dos Santos,2015-12-19,Alistair Overeem,KO/TKO,0,0,0,0
Junior Dos Santos,2019-03-09,Derrick Lewis,KO/TKO,100,22,25,147
Junior Dos Santos,2013-05-25,Mark Hunt,KO/TKO,100,45,0,145
Junior Dos Santos,2017-05-13,Stipe Miocic,KO/TKO,0,0,25,25
Junior Dos Santos,2013-10-19,Cain Velasquez,KO/TKO,0,0,25,25
Junior Dos Santos,2020-01-25,Curtis Blaydes,KO/TKO,0,0,25,25
Junior Dos Santos,2012-12-29,Cain Velasquez,Decision - Unanimous,0,0,25,25
Mike Brown,2008-11-05,Urijah Faber,KO/TKO,100,15,25,140
Mike Brown,2012-05-26,Daniel Pineda,Decision - Unanimous,80,10,0,90
Mike Brown,2010-01-10,Anthony Morrison,Submission,90,0,0,90
Mike Brown,2011-01-22,Rani Yahya,Decision - Unanimous,0,0,0,0
Mike Brown,2011-01-01,Diego Nunes,Decision - Split,0,3,0,3
Mike Brown,2011-08-06,Nam Phan,Decision - Unanimous,80,22,0,102
Mike Brown,2009-06-07,Urijah Faber,Decision - Unanimous,80,24,25,129
Mike Brown,2009-03-01,Leonard Garcia,Submission,90,17,25,132
Mike Brown,2009-11-18,Jose Aldo,KO/TKO,0,0,25,25
Mike Brown,2008-06-01,Jeff Curran,Decision - Unanimous,80,15,0,95
Mike Brown,2010-04-24,Manvel Gamburyan,KO/TKO,0,0,0,0
Mike Brown,2010-09-30,Cole Province,KO/TKO,100,7,0,107
Mike Brown,2004-04-02,Genki Sudo,Submission,0,7,0,7
Mike Brown,2013-08-17,Steven Siler,KO/TKO,0,0,0,0
Urijah Faber,2008-11-05,Mike Brown,KO/TKO,0,0,25,25
Urijah Faber,2011-03-19,Eddie Wineland,Decision - Unanimous,80,38,0,118
Urijah Faber,2010-11-11,Takeya Mizugaki,Submission,90,4,0,94
Urijah Faber,2008-06-01,Jens Pulver,Decision - Unanimous,80,50,25,155
Urijah Faber,2014-12-06,Francisco Rivera,Submission,90,4,0,94
Urijah Faber,2007-03-24,Dominick Cruz,Submission,90,0,25,115
Urijah Faber,2015-12-12,Frankie Saenz,Decision - Unanimous,80,9,0,89
Urijah Faber,2006-03-17,Cole Escovedo,KO/TKO,100,28,25,153
Urijah Faber,2013-04-13,Scott Jorgensen,Submission,90,20,25,135
Urijah Faber,2019-12-14,Petr Yan,KO/TKO,0,0,0,0
Urijah Faber,2016-06-04,Dominick Cruz,Decision - Unanimous,0,0,25,25
Urijah Faber,2016-09-10,Jimmie Rivera,Decision - Unanimous,0,0,0,0
Urijah Faber,2011-07-02,Dominick Cruz,Decision - Unanimous,0,0,25,25
Urijah Faber,2015-05-16,Frankie Edgar,Decision - Unanimous,0,0,25,25
Urijah Faber,2009-06-07,Mike Brown,Decision - Unanimous,0,0,25,25
Urijah Faber,2013-02-23,Ivan Menjivar,Submission,90,14,0,104
Urijah Faber,2019-07-13,Ricky Simon,KO/TKO,100,7,0,107
Urijah Faber,2013-08-17,Iuri Alcantara,Decision - Unanimous,80,46,0,126
Urijah Faber,2011-11-19,Brian Bowles,Submission,90,23,0,113
Urijah Faber,2009-01-25,Jens Pulver,Submission,90,3,0,93
Urijah Faber,2007-06-03,Chance Farrar,Submission,90,1,25,116
Urijah Faber,2012-07-21,Renan Barao,Decision - Unanimous,0,0,25,25
Urijah Faber,2010-01-10,Raphael Assuncao,Submission,90,14,0,104
Urijah Faber,2014-02-01,Renan Barao,KO/TKO,0,0,25,25
Urijah Faber,2007-12-12,Jeff Curran,Submission,90,4,25,119
Urijah Faber,2007-01-20,Joe Pearson,KO/TKO,100,11,25,136
Urijah Faber,2016-12-17,Brad Pickett,Decision - Unanimous,80,52,0,132
Urijah Faber,2014-07-05,Alex Caceres,Submission,90,0,0,90
Urijah Faber,2010-04-24,Jose Aldo,Decision - Unanimous,0,0,25,25
Urijah Faber,2013-12-14,Michael McDonald,Submission,90,20,0,110
Max Holloway,2012-06-01,Pat Schilling,Decision - Unanimous,80,91,0,171
Max Holloway,2015-04-18,Cub Swanson,Submission,90,26,0,116
Max Holloway,2019-12-14,Alexander Volkanovski,Decision - Unanimous,0,0,25,25
Max Holloway,2024-10-26,Ilia Topuria,KO/TKO,0,4,25,29
Max Holloway,2024-04-13,Justin Gaethje,KO/TKO,100,78,25,203
Max Holloway,2014-10-04,Akira Corassani,KO/TKO,100,20,0,120
Max Holloway,2019-07-27,Frankie Edgar,Decision - Unanimous,80,33,25,138
Max Holloway,2012-12-29,Leonard Garcia,Decision - Split,70,31,0,101
Max Holloway,2021-01-16,Calvin Kattar,Decision - Unanimous,80,312,25,417
Max Holloway,2017-06-03,Jose Aldo,KO/TKO,100,49,25,174
Max Holloway,2016-12-10,Anthony Pettis,KO/TKO,100,41,25,166
Max Holloway,2023-08-26,Chan Sung Jung,KO/TKO,100,41,25,166
Max Holloway,2020-07-11,Alexander Volkanovski,Decision - Split,0,0,25,25
Max Holloway,2019-04-13,Dustin Poirier,Decision - Unanimous,0,3,25,28
Max Holloway,2023-04-15,Arnold Allen,Decision - Unanimous,80,71,25,176
Max Holloway,2013-08-17,Conor McGregor,Decision - Unanimous,0,0,0,0
Max Holloway,2014-04-26,Andre Fili,Submission,90,3,0,93
Max Holloway,2014-08-23,Clay Collard,KO/TKO,100,54,0,154
Max Holloway,2015-02-14,Cole Miller,Decision - Unanimous,80,26,0,106
Max Holloway,2018-12-08,Brian Ortega,TKO - Doctor's Stoppage,0,180,25,205
Max Holloway,2014-01-04,Will Chope,KO/TKO,100,41,0,141
Max Holloway,2012-08-11,Justin Lawrence,KO/TKO,100,0,0,100
Max Holloway,2022-07-02,Alexander Volkanovski,Decision - Unanimous,0,0,25,25
Max Holloway,2015-12-12,Jeremy Stephens,Decision - Unanimous,80,10,0,90
Max Holloway,2016-06-04,Ricardo Lamas,Decision - Unanimous,80,39,0,119
Max Holloway,2017-12-02,Jose Aldo,KO/TKO,100,87,25,212
Max Holloway,2013-05-25,Dennis Bermudez,Decision - Split,0,2,0,2
Max Holloway,2021-11-13,Yair Rodriguez,Decision - Unanimous,80,71,25,176
Max Holloway,2012-02-04,Dustin Poirier,Submission,0,0,0,0
Max Holloway,2015-08-23,Charles Oliveira,KO/TKO,100,9,25,134
Pat Schilling,2012-06-01,Max Holloway,Decision - Unanimous,0,0,0,0
Pat Schilling,2012-01-20,Daniel Pineda,Submission,0,0,0,0
Israel Adesanya,2023-04-08,Alex Pereira,KO/TKO,100,0,25,125
Israel Adesanya,2020-09-26,Paulo Costa,KO/TKO,100,43,25,168
Israel Adesanya,2018-11-03,Derek Brunson,KO/TKO,100,10,0,110
Israel Adesanya,2022-02-12,Robert Whittaker,Decision - Unanimous,80,20,25,125
Israel Adesanya,2018-04-14,Marvin Vettori,Decision - Split,70,11,0,81
Israel Adesanya,2020-03-07,Yoel Romero,Decision - Unanimous,80,8,25,113
Israel Adesanya,2022-07-02,Jared Cannonier,Decision - Unanimous,80,26,25,131
Israel Adesanya,2019-04-13,Kelvin Gastelum,Decision - Unanimous,80,18,25,123
Israel Adesanya,2023-09-09,Sean Strickland,Decision - Unanimous,0,0,25,25
Israel Adesanya,2021-03-06,Jan Blachowicz,Decision - Unanimous,0,0,25,25
Israel Adesanya,2021-06-12,Marvin Vettori,Decision - Unanimous,80,38,25,143
Israel Adesanya,2024-08-17,Dricus Du Plessis,Submission,0,7,25,32
Israel Adesanya,2019-02-09,Anderson Silva,Decision - Unanimous,80,34,0,114
Israel Adesanya,2019-10-05,Robert Whittaker,KO/TKO,100,8,25,133
Israel Adesanya,2018-07-06,Brad Tavares,Decision - Unanimous,80,79,25,184
Israel Adesanya,2018-02-10,Rob Wilkinson,KO/TKO,100,30,0,130
Israel Adesanya,2022-11-12,Alex Pereira,KO/TKO,0,0,25,25
Alex Pereira,2023-04-08,Israel Adesanya,KO/TKO,0,8,25,33
Alex Pereira,2024-04-13,Jamahal Hill,KO/TKO,100,12,25,137
Alex Pereira,2024-06-29,Jiri Prochazka,KO/TKO,100,31,25,156
Alex Pereira,2023-11-11,Jiri Prochazka,KO/TKO,100,8,25,133
Alex Pereira,2024-10-05,Khalil Rountree Jr.,KO/TKO,100,66,25,191
Alex Pereira,2023-07-29,Jan Blachowicz,Decision - Split,70,18,0,88
Alex Pereira,2021-11-06,Andreas Michailidis,KO/TKO,100,8,0,108
Alex Pereira,2022-03-12,Bruno Silva,Decision - Unanimous,80,49,0,129
Alex Pereira,2022-11-12,Israel Adesanya,KO/TKO,100,5,25,130
Alex Pereira,2022-07-02,Sean Strickland,KO/TKO,100,10,0,110
Karol Rosa,2023-07-01,Yana Santos,Decision - Split,70,0,0,70
Karol Rosa,2022-03-26,Sara McMann,Decision - Unanimous,0,2,0,2
Karol Rosa,2024-08-10,Pannie Kianzad,Decision - Unanimous,80,25,0,105
Karol Rosa,2019-08-31,Lara Procopio,Decision - Split,70,6,0,76
Karol Rosa,2021-02-06,Joselyne Edwards,Decision - Unanimous,80,19,0,99
Karol Rosa,2023-12-16,Irene Aldana,Decision - Unanimous,0,59,0,59
Karol Rosa,2022-10-22,Lina Lansberg,Decision - Majority,75,18,0,93
Karol Rosa,2021-10-02,Bethe Correia,Decision - Unanimous,80,63,0,143
Karol Rosa,2020-07-11,Vanessa Melo,Decision - Unanimous,80,75,0,155
Karol Rosa,2023-04-22,Norma Dumont,Decision - Unanimous,0,0,0,0
Yana Santos,2023-07-01,Karol Rosa,Decision - Split,0,29,0,29
Yana Santos,2019-03-09,Marion Reneau,Decision - Unanimous,80,40,0,120
Yana Santos,2024-08-10,Chelsea Chandler,Decision - Unanimous,80,38,0,118
Yana Santos,2019-12-07,Aspen Ladd,KO/TKO,0,0,0,0
Yana Santos,2020-08-08,Julija Stoliarenko,Decision - Unanimous,80,37,0,117
Yana Santos,2021-02-20,Ketlen Vieira,Decision - Unanimous,80,40,0,120
Yana Santos,2018-03-03,Cristiane Justino,KO/TKO,0,0,25,25
Yana Santos,2021-07-10,Irene Aldana,KO/TKO,0,0,0,0
Yana Santos,2018-10-06,Lina Lansberg,Decision - Unanimous,80,29,0,109
Yana Santos,2023-03-25,Holly Holm,Decision - Unanimous,0,0,0,0
Devin Clark,2016-12-03,Josh Stansbury,Decision - Unanimous,80,11,0,91
Devin Clark,2024-02-10,Marcin Prachnio,Decision - Unanimous,0,0,0,0
Devin Clark,2022-08-13,Azamat Murzakanov,KO/TKO,0,0,0,0
Devin Clark,2023-05-06,Kennedy Nzechukwu,Submission,0,0,0,0
Devin Clark,2022-04-16,William Knight,KO/TKO,100,13,0,113
Devin Clark,2019-06-01,Darko Stosic,Decision - Unanimous,80,14,0,94
Devin Clark,2020-02-15,Dequan Townsend,Decision - Unanimous,80,33,0,113
Devin Clark,2023-02-04,Da Woon Jung,Decision - Unanimous,80,21,0,101
Devin Clark,2017-10-21,Jan Blachowicz,Submission,0,0,0,0
Devin Clark,2020-06-06,Alonzo Menifield,Decision - Unanimous,80,40,0,120
Devin Clark,2021-09-18,Ion Cutelaba,Decision - Unanimous,0,0,0,0
Devin Clark,2017-04-15,Jake Collier,Decision - Unanimous,80,32,0,112
Devin Clark,2019-10-12,Ryan Spann,Submission,0,0,0,0
Devin Clark,2018-12-08,Aleksandar Rakic,KO/TKO,0,0,0,0
Devin Clark,2018-04-07,Mike Rodriguez,Decision - Unanimous,80,10,0,90
Devin Clark,2020-11-28,Anthony Smith,Submission,0,0,25,25
Devin Clark,2016-07-13,Alex Nicholson,KO/TKO,0,0,0,0
Josh Stansbury,2016-12-03,Devin Clark,Decision - Unanimous,0,0,0,0
Josh Stansbury,2016-07-08,Cory Hendricks,Decision - Majority,75,14,0,89
Josh Stansbury,2017-06-25,Jeremy Kimball,KO/TKO,0,0,0,0
Royston Wee,2014-08-23,Yao Zhikui,Decision - Split,70,0,0,70
Royston Wee,2014-01-04,Dave Galera,Decision - Unanimous,80,0,0,80
Royston Wee,2015-05-16,Guangyou Ning,KO/TKO,0,0,0,0
Yao Zhikui,2014-08-23,Royston Wee,Decision - Split,0,9,0,9
Yao Zhikui,2015-05-16,Nolan Ticman,Decision - Split,70,0,0,70
Yao Zhikui,2015-11-28,Fredy Serrano,KO/TKO,0,0,0,0
Yao Zhikui,2016-11-26,Jenel Lausa,Decision - Unanimous,0,0,0,0
Alessandro Costa,2024-05-04,Kevin Borjas,KO/TKO,100,28,0,128
Alessandro Costa,2022-07-26,Juan Andres Luna,Decision - Split,70,0,0,70
Alessandro Costa,2022-12-17,Amir Albazi,KO/TKO,0,0,0,0
Alessandro Costa,2023-06-17,Jimmy Flick,KO/TKO,100,51,0,151
Alessandro Costa,2023-11-11,Steve Erceg,Decision - Unanimous,0,0,0,0
Kevin Borjas,2024-05-04,Alessandro Costa,KO/TKO,0,0,0,0
Kevin Borjas,2023-11-11,Joshua Van,Decision - Unanimous,0,0,0,0
Kevin Borjas,2023-08-08,Victor Dias,Decision - Unanimous,80,44,0,124
Petr Yan,2019-06-08,Jimmie Rivera,Decision - Unanimous,80,0,0,80
Petr Yan,2024-11-23,Deiveson Figueiredo,Decision - Unanimous,80,68,25,173
Petr Yan,2018-09-15,Jin Soo Son,Decision - Unanimous,80,42,0,122
Petr Yan,2019-12-14,Urijah Faber,KO/TKO,100,36,0,136
Petr Yan,2022-04-09,Aljamain Sterling,Decision - Split,0,1,25,26
Petr Yan,2024-03-09,Song Yadong,Decision - Unanimous,80,13,0,93
Petr Yan,2018-06-23,Teruto Ishihara,KO/TKO,100,14,0,114
Petr Yan,2022-10-22,Sean O'Malley,Decision - Split,0,0,0,0
Petr Yan,2018-12-29,Douglas Silva de Andrade,KO/TKO,100,48,0,148
Petr Yan,2019-02-23,John Dodson,Decision - Unanimous,80,50,0,130
Petr Yan,2021-10-30,Cory Sandhagen,Decision - Unanimous,80,0,25,105
Petr Yan,2021-03-06,Aljamain Sterling,DQ,0,0,25,25
Petr Yan,2020-07-11,Jose Aldo,KO/TKO,100,111,25,236
Petr Yan,2023-03-11,Merab Dvalishvili,Decision - Unanimous,0,0,25,25
Jimmie Rivera,2019-06-08,Petr Yan,Decision - Unanimous,0,17,0,17
Jimmie Rivera,2020-07-15,Cody Stamann,Decision - Unanimous,80,22,0,102
Jimmie Rivera,2015-11-07,Pedro Munhoz,Decision - Split,70,30,0,100
Jimmie Rivera,2021-02-27,Pedro Munhoz,Decision - Unanimous,0,0,0,0
Jimmie Rivera,2015-07-18,Marcus Brimage,KO/TKO,100,6,0,106
Jimmie Rivera,2016-09-10,Urijah Faber,Decision - Unanimous,80,32,0,112
Jimmie Rivera,2018-09-08,John Dodson,Decision - Unanimous,80,21,0,101
Jimmie Rivera,2017-07-22,Thomas Almeida,Decision - Unanimous,80,0,0,80
Jimmie Rivera,2018-06-01,Marlon Moraes,KO/TKO,0,0,25,25
Jimmie Rivera,2019-02-17,Aljamain Sterling,Decision - Unanimous,0,0,0,0
Jimmie Rivera,2016-01-30,Iuri Alcantara,Decision - Unanimous,80,4,0,84
Alexandr Romanov,2021-04-17,Juan Espino,Decision - Split,70,20,0,90
Alexandr Romanov,2022-08-20,Marcin Tybura,Decision - Majority,0,0,0,0
Alexandr Romanov,2024-11-02,Rodrigo Nascimento,Decision - Unanimous,80,14,0,94
Alexandr Romanov,2022-04-30,Chase Sherman,Submission,90,8,0,98
Alexandr Romanov,2024-06-01,Jailton Almeida,Submission,0,0,0,0
Alexandr Romanov,2023-07-01,Blagoy Ivanov,Decision - Unanimous,80,41,0,121
Alexandr Romanov,2021-10-09,Jared Vanderaa,KO/TKO,100,43,0,143
Alexandr Romanov,2023-03-11,Alexander Volkov,KO/TKO,0,0,0,0
Alexandr Romanov,2020-09-12,Roque Martinez,Submission,90,48,0,138
Alexandr Romanov,2020-11-07,Marcos Rogerio de Lima,Submission,90,0,0,90
Juan Espino,2021-04-17,Alexandr Romanov,Decision - Split,0,0,0,0
Juan Espino,2018-11-30,Justin Frazier,Submission,90,18,0,108
Juan Espino,2020-09-26,Jeff Hughes,Submission,90,10,0,100
Oskar Piechota,2017-10-21,Jonathan Wilson,Decision - Unanimous,80,39,0,119
Oskar Piechota,2018-02-18,Tim Williams,KO/TKO,100,9,0,109
Oskar Piechota,2019-08-10,Rodolfo Vieira,Submission,0,4,0,4
Oskar Piechota,2018-07-06,Gerald Meerschaert,Submission,0,0,0,0
Oskar Piechota,2019-12-14,Punahele Soriano,KO/TKO,0,0,0,0
Jonathan Wilson,2017-10-21,Oskar Piechota,Decision - Unanimous,0,0,0,0
Jonathan Wilson,2015-08-08,Chris Dempsey,KO/TKO,100,4,0,104
Jonathan Wilson,2016-06-04,Henrique da Silva,KO/TKO,0,0,0,0
Jonathan Wilson,2016-10-01,Ion Cutelaba,Decision - Unanimous,0,0,0,0
Henry Cejudo,2017-09-09,Wilson Reis,KO/TKO,100,29,0,129
Henry Cejudo,2018-08-04,Demetrious Johnson,Decision - Split,70,0,25,95
Henry Cejudo,2015-11-21,Jussier Formiga,Decision - Split,70,18,0,88
Henry Cejudo,2023-05-06,Aljamain Sterling,Decision - Split,0,0,25,25
Henry Cejudo,2019-06-08,Marlon Moraes,KO/TKO,100,33,25,158
Henry Cejudo,2017-12-02,Sergio Pettis,Decision - Unanimous,80,11,0,91
Henry Cejudo,2024-02-17,Merab Dvalishvili,Decision - Unanimous,0,0,0,0
Henry Cejudo,2019-01-19,TJ Dillashaw,KO/TKO,100,17,25,142
Henry Cejudo,2015-03-14,Chris Cariaso,Decision - Unanimous,80,28,0,108
Henry Cejudo,2016-12-03,Joseph Benavidez,Decision - Split,0,0,0,0
Henry Cejudo,2020-05-09,Dominick Cruz,KO/TKO,100,20,25,145
Henry Cejudo,2014-12-13,Dustin Kimura,Decision - Unanimous,80,47,0,127
Henry Cejudo,2015-06-13,Chico Camus,Decision - Unanimous,80,14,0,94
Henry Cejudo,2016-04-23,Demetrious Johnson,KO/TKO,0,0,25,25
Nate Diaz,2011-09-24,Takanori Gomi,Submission,90,32,0,122
Nate Diaz,2019-08-17,Anthony Pettis,Decision - Unanimous,80,45,0,125
Nate Diaz,2013-11-30,Gray Maynard,KO/TKO,100,28,0,128
Nate Diaz,2011-01-01,Dong Hyun Kim,Decision - Unanimous,0,17,0,17
Nate Diaz,2012-05-05,Jim Miller,Submission,90,21,25,136
Nate Diaz,2008-01-23,Alvin Robinson,Submission,90,1,0,91
Nate Diaz,2011-12-30,Donald Cerrone,Decision - Unanimous,80,142,0,222
Nate Diaz,2014-12-13,Rafael Dos Anjos,Decision - Unanimous,0,0,0,0
Nate Diaz,2004-10-21,Alejandro Garcia,Submission,90,0,0,90
Nate Diaz,2012-12-08,Benson Henderson,Decision - Unanimous,0,0,25,25
Nate Diaz,2021-06-12,Leon Edwards,Decision - Unanimous,0,0,25,25
Nate Diaz,2019-11-02,Jorge Masvidal,TKO - Doctor's Stoppage,0,0,25,25
Nate Diaz,2007-09-19,Junior Assuncao,Submission,90,3,0,93
Nate Diaz,2008-09-17,Josh Neer,Decision - Split,70,14,0,84
Nate Diaz,2009-01-31,Clay Guida,Decision - Split,0,0,0,0
Nate Diaz,2022-09-10,Tony Ferguson,Submission,90,21,25,136
Nate Diaz,2011-04-30,Rory MacDonald,Decision - Unanimous,0,0,0,0
Nate Diaz,2016-08-20,Conor McGregor,Decision - Majority,0,2,25,27
Nate Diaz,2006-03-10,Tony Juarez,KO/TKO,100,32,0,132
Nate Diaz,2013-04-20,Josh Thomson,KO/TKO,0,0,0,0
Nate Diaz,2010-01-11,Gray Maynard,Decision - Split,0,29,0,29
Nate Diaz,2016-03-05,Conor McGregor,Submission,90,16,25,131
Nate Diaz,2015-12-19,Michael Johnson,Decision - Unanimous,80,50,0,130
Nate Diaz,2006-05-05,Gilbert Rael,KO/TKO,100,23,0,123
Nate Diaz,2007-06-23,Manvel Gamburyan,Submission,90,0,0,90
Nate Diaz,2006-06-15,Joe Hurley,Submission,90,14,0,104
Nate Diaz,2010-08-28,Marcus Davis,Submission,90,42,0,132
Nate Diaz,2009-09-16,Melvin Guillard,Submission,90,10,0,100
Nate Diaz,2009-06-20,Joe Stevenson,Decision - Unanimous,0,0,0,0
Nate Diaz,2010-03-27,Rory Markham,KO/TKO,100,31,0,131
Nate Diaz,2008-04-02,Kurt Pellegrino,Submission,90,0,0,90
Nate Diaz,2006-10-12,Hermes Franca,Submission,0,32,25,57
Mirko Filipovic,2003-08-10,Igor Vovchanchyn,KO/TKO,100,0,0,100
Mirko Filipovic,2007-04-21,Gabriel Gonzaga,KO/TKO,0,0,0,0
Mirko Filipovic,2010-02-20,Anthony Perosh,TKO - Doctor's Stoppage,0,20,0,20
Mirko Filipovic,2002-12-31,Kazuyuki Fujita,Decision - Unanimous,80,31,0,111
Mirko Filipovic,2005-10-23,Josh Barnett,Decision - Unanimous,80,0,0,80
Mirko Filipovic,2006-09-10,Josh Barnett,KO/TKO,100,16,0,116
Mirko Filipovic,2001-12-31,Yuji Nagata,KO/TKO,100,5,0,105
Mirko Filipovic,2007-02-03,Eddie Sanchez,KO/TKO,100,15,0,115
Mirko Filipovic,2006-07-01,Hidehiko Yoshida,KO/TKO,100,19,0,119
Mirko Filipovic,2004-04-25,Kevin Randleman,KO/TKO,0,0,0,0
Mirko Filipovic,2005-12-31,Mark Hunt,Decision - Split,0,0,0,0
Mirko Filipovic,2004-02-15,Yoshihisa Yamamoto,KO/TKO,100,18,0,118
Mirko Filipovic,2008-12-31,Hong Man Choi,KO/TKO,100,10,0,110
Mirko Filipovic,2004-12-31,Kevin Randleman,Submission,90,1,0,91
Mirko Filipovic,2008-03-15,Tatsuya Mizuno,KO/TKO,100,12,0,112
Mirko Filipovic,2010-06-12,Pat Barry,Submission,90,17,0,107
Mirko Filipovic,2011-10-29,Roy Nelson,KO/TKO,0,0,0,0
Mirko Filipovic,2003-06-08,Heath Herring,KO/TKO,100,14,0,114
Mirko Filipovic,2004-05-23,Hiromitsu Kanehara,Decision - Unanimous,80,46,0,126
Mirko Filipovic,2007-09-08,Cheick Kongo,Decision - Unanimous,0,0,0,0
Mirko Filipovic,2006-05-05,Ikuhisa Minowa,KO/TKO,100,9,0,109
Mirko Filipovic,2003-11-09,Antonio Rodrigo Nogueira,Submission,0,15,0,15
Mirko Filipovic,2004-07-19,Shungo Oyama,KO/TKO,100,8,0,108
Mirko Filipovic,2015-04-11,Gabriel Gonzaga,KO/TKO,100,2,25,127
Mirko Filipovic,2002-08-28,Kazushi Sakuraba,TKO - Doctor's Stoppage,0,16,0,16
Mirko Filipovic,2001-08-19,Kazuyuki Fujita,TKO - Doctor's Stoppage,0,1,0,1
Mirko Filipovic,2005-02-20,Mark Coleman,KO/TKO,100,9,0,109
Mirko Filipovic,2005-08-28,Fedor Emelianenko,Decision - Unanimous,0,0,0,0
Mirko Filipovic,2009-06-13,Mostapha Al-Turk,KO/TKO,100,9,0,109
Mirko Filipovic,2005-06-26,Ibragim Magomedov,KO/TKO,100,14,0,114
Mirko Filipovic,2010-09-25,Frank Mir,KO/TKO,0,0,0,0
Mirko Filipovic,2009-09-19,Junior Dos Santos,KO/TKO,0,0,0,0
Mirko Filipovic,2003-10-05,Dos Caras Jr.,KO/TKO,100,3,0,103
Mirko Filipovic,2004-02-01,Ron Waterman,KO/TKO,100,3,0,103
Mirko Filipovic,2004-08-15,Aleksander Emelianenko,KO/TKO,100,11,0,111
Mirko Filipovic,2004-10-31,Josh Barnett,Submission,90,0,0,90
Mirko Filipovic,2006-09-10,Wanderlei Silva,KO/TKO,100,16,0,116
Mirko Filipovic,2011-03-19,Brendan Schaub,KO/TKO,0,0,0,0
Igor Vovchanchyn,2003-08-10,Mirko Filipovic,KO/TKO,0,1,0,1
Igor Vovchanchyn,2000-12-09,Mark Kerr,Decision - Unanimous,80,7,0,87
Igor Vovchanchyn,2000-08-27,Enson Inoue,TKO - Doctor's Stoppage,0,61,0,61
Igor Vovchanchyn,2005-06-26,Alistair Overeem,Submission,0,0,0,0
Igor Vovchanchyn,2004-10-14,Katsuhisa Fujii,KO/TKO,100,13,0,113
Igor Vovchanchyn,2001-05-27,Gilbert Yvel,Submission,90,3,0,93
Igor Vovchanchyn,2001-03-25,Tra Telligman,Decision - Unanimous,0,17,0,17
Igor Vovchanchyn,2002-02-24,Heath Herring,Decision - Unanimous,0,0,0,0
Igor Vovchanchyn,2005-04-23,Yuki Kondo,Decision - Unanimous,80,56,0,136
Igor Vovchanchyn,1998-10-11,Gary Goodridge,KO/TKO,100,2,0,102
Igor Vovchanchyn,2000-06-04,Daijiro Matsui,TKO - Doctor's Stoppage,0,18,0,18
Igor Vovchanchyn,2000-01-30,Alexander Otsuka,Decision - Unanimous,80,22,0,102
Igor Vovchanchyn,2005-08-28,Kazuhiro Nakamura,Decision - Unanimous,0,5,0,5
Igor Vovchanchyn,2000-05-01,Kazushi Sakuraba,KO/TKO,100,12,0,112
Igor Vovchanchyn,1999-11-21,Francisco Bueno,KO/TKO,100,2,0,102
Igor Vovchanchyn,2001-11-03,Mario Sperry,Submission,0,0,0,0
Igor Vovchanchyn,2005-02-20,Yoshiki Takahashi,KO/TKO,100,4,0,104
Igor Vovchanchyn,2000-05-01,Mark Coleman,KO/TKO,0,0,0,0
Igor Vovchanchyn,2002-09-29,Quinton Jackson,KO/TKO,0,0,0,0
Igor Vovchanchyn,2001-12-23,Valentijn Overeem,Submission,90,2,0,92
Igor Vovchanchyn,2004-02-01,Dan Bobish,KO/TKO,100,0,0,100
Igor Vovchanchyn,1999-07-04,Carlos Barreto,Decision - Unanimous,80,28,0,108
Igor Vovchanchyn,2001-07-29,Masaaki Satake,Decision - Unanimous,80,27,0,107
Igor Vovchanchyn,2000-10-31,Nobuhiko Takada,KO/TKO,100,7,0,107
Igor Vovchanchyn,2000-05-01,Gary Goodridge,KO/TKO,100,33,0,133
Igor Vovchanchyn,1999-04-29,Akira Shoji,Decision - Unanimous,80,17,0,97
Diego Ferreira,2018-12-08,Kyle Nelson,KO/TKO,100,34,0,134
Diego Ferreira,2014-06-28,Colton Smith,Submission,90,5,0,95
Diego Ferreira,2021-02-06,Beneil Dariush,Decision - Split,0,0,0,0
Diego Ferreira,2016-01-30,Olivier Aubin-Mercier,Decision - Unanimous,80,16,0,96
Diego Ferreira,2019-02-23,Rustam Khabilov,Decision - Unanimous,80,40,0,120
Diego Ferreira,2019-09-07,Mairbek Taisumov,Decision - Unanimous,80,58,0,138
Diego Ferreira,2014-10-25,Beneil Dariush,Decision - Unanimous,0,0,0,0
Diego Ferreira,2021-12-18,Mateusz Gamrot,KO/TKO,0,11,0,11
Diego Ferreira,2024-05-11,Mateusz Rebecki,KO/TKO,100,71,0,171
Diego Ferreira,2020-01-18,Anthony Pettis,Submission,90,3,0,93
Diego Ferreira,2021-05-08,Gregor Gillespie,KO/TKO,0,0,0,0
Diego Ferreira,2014-08-30,Ramsey Nijem,KO/TKO,100,7,0,107
Diego Ferreira,2015-04-04,Dustin Poirier,KO/TKO,0,0,0,0
Diego Ferreira,2023-05-20,Michael Johnson,KO/TKO,100,0,0,100
Diego Ferreira,2018-02-18,Jared Gordon,KO/TKO,100,21,0,121
Kyle Nelson,2018-12-08,Diego Ferreira,KO/TKO,0,0,0,0
Kyle Nelson,2020-09-12,Billy Quarantillo,KO/TKO,0,0,0,0
Kyle Nelson,2019-09-21,Marco Polo Reyes,KO/TKO,100,6,0,106
Kyle Nelson,2023-09-16,Fernando Padilla,Decision - Unanimous,80,10,0,90
Kyle Nelson,2019-05-04,Matt Sayles,Submission,0,0,0,0
Kyle Nelson,2022-07-23,Jai Herbert,Decision - Unanimous,0,5,0,5
Kyle Nelson,2024-03-30,Bill Algeo,KO/TKO,100,2,0,102
Kyle Nelson,2023-06-10,Blake Bilder,Decision - Unanimous,80,14,0,94
Kyle Nelson,2024-09-07,Steve Garcia,KO/TKO,0,0,0,0
Evan Dunham,2011-09-17,Shamar Bailey,Decision - Unanimous,80,57,0,137
Evan Dunham,2012-01-28,Nik Lentz,TKO - Doctor's Stoppage,0,29,0,29
Evan Dunham,2009-02-21,Per Eklund,KO/TKO,100,4,0,104
Evan Dunham,2015-01-03,Rodrigo Damm,Decision - Unanimous,80,105,0,185
Evan Dunham,2009-08-29,Marcus Aurelio,Decision - Split,70,31,0,101
Evan Dunham,2015-12-11,Joe Lauzon,Decision - Unanimous,80,85,0,165
Evan Dunham,2018-04-07,Olivier Aubin-Mercier,KO/TKO,0,0,0,0
Evan Dunham,2010-09-25,Sean Sherk,Decision - Split,0,37,0,37
Evan Dunham,2010-06-12,Tyson Griffin,Decision - Split,70,2,0,72
Evan Dunham,2011-01-22,Melvin Guillard,KO/TKO,0,0,0,0
Evan Dunham,2013-11-16,Donald Cerrone,Submission,0,0,0,0
Evan Dunham,2012-09-22,TJ Grant,Decision - Unanimous,0,0,0,0
Evan Dunham,2010-01-11,Efrain Escudero,Submission,90,0,0,90
Evan Dunham,2014-07-16,Edson Barboza,KO/TKO,0,0,0,0
Evan Dunham,2018-09-22,Francisco Trinaldo,KO/TKO,0,0,0,0
Evan Dunham,2020-06-06,Herbert Burns,Submission,0,0,0,0
Evan Dunham,2013-02-02,Gleison Tibau,Decision - Split,70,54,0,124
Evan Dunham,2015-07-18,Ross Pearson,Decision - Unanimous,80,10,0,90
Evan Dunham,2013-05-18,Rafael Dos Anjos,Decision - Unanimous,0,2,0,2
Evan Dunham,2016-09-17,Ricky Glenn,Decision - Unanimous,80,86,0,166
Shamar Bailey,2011-09-17,Evan Dunham,Decision - Unanimous,0,0,0,0
Shamar Bailey,2011-06-04,Ryan McGillivray,Decision - Unanimous,80,14,0,94
Shamar Bailey,2011-11-19,Danny Castillo,KO/TKO,0,0,0,0
Shamar Bailey,2010-03-26,Justin Wilcox,Decision - Unanimous,0,0,0,0
Yushin Okami,2010-11-13,Nate Marquardt,Decision - Unanimous,80,4,0,84
Yushin Okami,2012-08-11,Buddy Roberts,KO/TKO,100,11,0,111
Yushin Okami,2012-02-25,Tim Boetsch,KO/TKO,0,0,0,0
Yushin Okami,2013-03-02,Hector Lombard,Decision - Split,70,0,0,70
Yushin Okami,2006-04-21,Jake Shields,Decision - Majority,0,0,0,0
Yushin Okami,2007-06-16,Rich Franklin,Decision - Unanimous,0,0,0,0
Yushin Okami,2017-09-22,Ovince Saint Preux,Submission,0,0,25,25
Yushin Okami,2007-04-07,Mike Swick,Decision - Unanimous,80,0,0,80
Yushin Okami,2007-10-20,Jason MacDonald,Decision - Unanimous,80,16,0,96
Yushin Okami,2006-10-14,Kalib Starnes,KO/TKO,100,20,0,120
Yushin Okami,2004-02-15,Ryuta Sakurai,Decision - Unanimous,80,20,0,100
Yushin Okami,2006-01-20,Anderson Silva,DQ,0,0,0,0
Yushin Okami,2013-09-04,Jacare Souza,KO/TKO,0,0,0,0
Yushin Okami,2011-08-27,Anderson Silva,KO/TKO,0,0,25,25
Yushin Okami,2010-08-01,Mark Munoz,Decision - Split,70,6,0,76
Yushin Okami,2018-12-01,Aleksei Kunchenko,Decision - Unanimous,0,0,0,0
Yushin Okami,2010-03-31,Lucio Linhares,TKO - Doctor's Stoppage,0,42,0,42
Yushin Okami,2006-08-26,Alan Belcher,Decision - Unanimous,80,4,0,84
Yushin Okami,2008-12-27,Dean Lister,Decision - Unanimous,80,33,0,113
Yushin Okami,2018-04-14,Dhiego Lima,Decision - Unanimous,80,4,0,84
Yushin Okami,2006-12-30,Rory Singer,KO/TKO,100,7,0,107
Yushin Okami,2009-10-24,Chael Sonnen,Decision - Unanimous,0,0,0,0
Yushin Okami,2012-12-29,Alan Belcher,Decision - Unanimous,80,14,0,94
Yushin Okami,2008-03-01,Evan Tanner,KO/TKO,100,7,0,107
Ryan Couture,2012-03-03,Conor Heun,KO/TKO,100,38,0,138
Ryan Couture,2013-04-06,Ross Pearson,KO/TKO,0,1,0,1
Ryan Couture,2013-01-12,KJ Noons,Decision - Split,70,0,0,70
Ryan Couture,2011-06-24,Matt Ricehouse,Decision - Unanimous,0,4,0,4
Ryan Couture,2013-08-31,Al Iaquinta,Decision - Unanimous,0,0,0,0
Ryan Couture,2011-02-18,Lee Higgins,Submission,90,39,0,129
Ryan Couture,2011-09-23,Maka Watson,Decision - Majority,75,10,0,85
Ryan Couture,2010-08-13,Lucas Stark,Submission,90,2,0,92
Ryan Couture,2012-07-14,Joe Duarte,Decision - Split,70,26,0,96
Conor Heun,2012-03-03,Ryan Couture,KO/TKO,0,0,0,0
Conor Heun,2010-06-16,KJ Noons,Decision - Split,0,0,0,0
Conor Heun,2011-06-18,Magno Almeida,Decision - Unanimous,80,14,0,94
Christian Rodriguez,2022-10-29,Joshua Weems,Submission,90,0,0,90
Christian Rodriguez,2024-03-16,Isaac Dulgarian,Decision - Split,70,26,0,96
Christian Rodriguez,2024-07-13,Julian Erosa,Submission,0,0,0,0
Christian Rodriguez,2022-02-19,Jonathan Pearce,Decision - Unanimous,0,8,0,8
Christian Rodriguez,2021-10-12,Reyes Cortez Jr.,Decision - Unanimous,80,31,0,111
Christian Rodriguez,2023-04-08,Raul Rosas Jr.,Decision - Unanimous,80,27,0,107
Christian Rodriguez,2023-10-14,Cameron Saaiman,Decision - Unanimous,80,10,0,90
Joshua Weems,2022-10-29,Christian Rodriguez,Submission,0,9,0,9
Joshua Weems,2021-10-05,Fernie Garcia,KO/TKO,0,3,0,3
Andrei Arlovski,2003-09-26,Vladimir Matyushenko,KO/TKO,100,4,0,104
Andrei Arlovski,2014-06-14,Brendan Schaub,Decision - Split,70,0,0,70
Andrei Arlovski,2021-04-17,Chase Sherman,Decision - Unanimous,80,17,0,97
Andrei Arlovski,2016-01-02,Stipe Miocic,KO/TKO,0,0,0,0
Andrei Arlovski,2020-11-07,Tanner Boser,Decision - Unanimous,80,0,0,80
Andrei Arlovski,2019-07-20,Ben Rothwell,Decision - Unanimous,80,82,0,162
Andrei Arlovski,2002-03-22,Pedro Rizzo,KO/TKO,0,11,0,11
Andrei Arlovski,2022-04-30,Jake Collier,Decision - Split,70,0,0,70
Andrei Arlovski,2005-02-05,Tim Sylvia,Submission,90,3,25,118
Andrei Arlovski,2001-06-29,Ricco Rodriguez,KO/TKO,0,0,0,0
Andrei Arlovski,2009-01-24,Fedor Emelianenko,KO/TKO,0,10,25,35
Andrei Arlovski,2018-03-03,Stefan Struve,Decision - Unanimous,80,12,0,92
Andrei Arlovski,2018-09-15,Shamil Abdurakhimov,Decision - Unanimous,0,0,0,0
Andrei Arlovski,2005-06-04,Justin Eilers,KO/TKO,100,28,25,153
Andrei Arlovski,2017-01-28,Francis Ngannou,KO/TKO,0,0,0,0
Andrei Arlovski,2016-09-03,Josh Barnett,Submission,0,0,25,25
Andrei Arlovski,2002-11-22,Ian Freeman,KO/TKO,100,13,0,113
Andrei Arlovski,2000-11-17,Aaron Brink,Submission,90,2,0,92
Andrei Arlovski,2008-03-01,Jake O'Brien,KO/TKO,100,10,0,110
Andrei Arlovski,2019-11-02,Jairzinho Rozenstruik,KO/TKO,0,0,0,0
Andrei Arlovski,2022-02-12,Jared Vanderaa,Decision - Split,70,0,0,70
Andrei Arlovski,2009-06-06,Brett Rogers,KO/TKO,0,0,0,0
Andrei Arlovski,2015-09-05,Frank Mir,Decision - Unanimous,80,15,0,95
Andrei Arlovski,2024-01-13,Waldo Cortes-Acosta,Decision - Unanimous,0,9,0,9
Andrei Arlovski,2015-05-23,Travis Browne,KO/TKO,100,36,0,136
Andrei Arlovski,2014-09-13,Antonio Silva,KO/TKO,100,7,25,132
Andrei Arlovski,2017-11-11,Junior Albini,Decision - Unanimous,80,44,0,124
Andrei Arlovski,2022-10-29,Marcos Rogerio de Lima,Submission,0,0,0,0
Andrei Arlovski,2016-05-08,Alistair Overeem,KO/TKO,0,0,25,25
Andrei Arlovski,2006-04-15,Tim Sylvia,KO/TKO,0,0,25,25
Andrei Arlovski,2007-04-21,Fabricio Werdum,Decision - Unanimous,80,5,0,85
Andrei Arlovski,2023-06-03,Don'Tale Mayes,KO/TKO,0,0,0,0
Andrei Arlovski,2010-05-15,Antonio Silva,Decision - Unanimous,0,0,0,0
Andrei Arlovski,2006-12-30,Marcio Cruz,KO/TKO,100,7,0,107
Andrei Arlovski,2011-02-12,Sergei Kharitonov,KO/TKO,0,0,0,0
Andrei Arlovski,2006-07-08,Tim Sylvia,Decision - Unanimous,0,0,25,25
Andrei Arlovski,2024-06-29,Martin Buday,Decision - Split,0,20,0,20
Andrei Arlovski,2019-04-27,Augusto Sakai,Decision - Split,0,33,0,33
Andrei Arlovski,2018-06-09,Tai Tuivasa,Decision - Unanimous,0,0,0,0
Andrei Arlovski,2020-05-13,Philipe Lins,Decision - Unanimous,80,9,0,89
Andrei Arlovski,2017-06-17,Marcin Tybura,Decision - Unanimous,0,0,0,0
Andrei Arlovski,2005-10-07,Paul Buentello,KO/TKO,100,1,25,126
Andrei Arlovski,2008-10-04,Roy Nelson,KO/TKO,100,14,0,114
Andrei Arlovski,2021-10-16,Carlos Felipe,Decision - Unanimous,80,10,0,90
Andrei Arlovski,2021-02-20,Tom Aspinall,Submission,0,0,0,0
Andrei Arlovski,2004-04-02,Wesley Correira,KO/TKO,100,47,0,147
Andrei Arlovski,2008-07-19,Ben Rothwell,KO/TKO,100,34,0,134
Vladimir Matyushenko,2003-09-26,Andrei Arlovski,KO/TKO,0,0,0,0
Vladimir Matyushenko,2001-09-28,Tito Ortiz,Decision - Unanimous,0,0,25,25
Vladimir Matyushenko,2009-09-19,Igor Pokrajac,Decision - Unanimous,80,27,0,107
Vladimir Matyushenko,2013-01-26,Ryan Bader,Submission,0,0,0,0
Vladimir Matyushenko,2010-08-01,Jon Jones,KO/TKO,0,0,0,0
Vladimir Matyushenko,2002-11-22,Travis Wiuff,KO/TKO,100,24,0,124
Vladimir Matyushenko,2007-11-03,Alex Schoenauer,Decision - Unanimous,80,7,0,87
Vladimir Matyushenko,2001-06-29,Yuki Kondo,Decision - Unanimous,80,16,0,96
Vladimir Matyushenko,2011-12-30,Alexander Gustafsson,KO/TKO,0,0,0,0
Vladimir Matyushenko,2009-01-24,Rogerio Nogueira,KO/TKO,0,0,0,0
Vladimir Matyushenko,2003-02-28,Pedro Rizzo,Decision - Unanimous,80,12,0,92
Vladimir Matyushenko,2011-04-30,Jason Brilz,KO/TKO,100,7,0,107
Vladimir Matyushenko,2010-11-13,Alexandre Ferreira,KO/TKO,100,13,0,113
Vladimir Matyushenko,2010-03-21,Eliot Marshall,Decision - Split,70,9,0,79
David Terrell,2006-04-15,Scott Smith,Submission,90,7,0,97
David Terrell,2005-02-05,Evan Tanner,KO/TKO,0,0,25,25
David Terrell,2004-08-21,Matt Lindland,KO/TKO,100,5,0,105
Scott Smith,2006-04-15,David Terrell,Submission,0,0,0,0
Scott Smith,2007-02-03,Patrick Cote,Decision - Unanimous,0,0,0,0
Scott Smith,2008-07-26,Robbie Lawler,KO/TKO,0,0,25,25
Scott Smith,2010-12-04,Paul Daley,KO/TKO,0,0,0,0
Scott Smith,2011-07-30,Tarec Saffiedine,Decision - Unanimous,0,0,0,0
Scott Smith,2009-06-06,Nick Diaz,Submission,0,0,0,0
Scott Smith,2012-03-03,Lumumba Sayers,Submission,0,0,0,0
Scott Smith,2007-06-16,Ed Herman,Submission,0,0,0,0
Scott Smith,2006-01-13,Justin Levens,KO/TKO,100,5,0,105
Scott Smith,2009-12-19,Cung Le,KO/TKO,100,0,0,100
Scott Smith,2010-06-26,Cung Le,KO/TKO,0,0,0,0
Scott Smith,2009-04-11,Benji Radach,KO/TKO,100,0,0,100
Scott Smith,2006-11-11,Pete Sell,KO/TKO,100,0,0,100
Scott Smith,2008-11-21,Terry Martin,KO/TKO,100,0,0,100
Heath Herring,2001-07-29,Mark Kerr,KO/TKO,100,4,0,104
Heath Herring,2001-11-03,Antonio Rodrigo Nogueira,Decision - Unanimous,0,0,0,0
Heath Herring,2002-02-24,Igor Vovchanchyn,Decision - Unanimous,80,12,0,92
Heath Herring,2004-04-25,Yoshiki Takahashi,KO/TKO,100,26,0,126
Heath Herring,2008-08-09,Brock Lesnar,Decision - Unanimous,0,0,0,0
Heath Herring,2000-10-31,Tom Erikson,Submission,90,0,0,90
Heath Herring,2007-01-25,Jake O'Brien,Decision - Unanimous,0,0,0,0
Heath Herring,2003-06-08,Mirko Filipovic,KO/TKO,0,0,0,0
Heath Herring,2004-02-01,Gan McGee,Decision - Split,70,9,0,79
Heath Herring,2008-03-01,Cheick Kongo,Decision - Split,70,12,0,82
Heath Herring,2004-10-31,Hirotaka Yokoi,KO/TKO,100,24,0,124
Heath Herring,2000-12-09,Enson Inoue,KO/TKO,100,15,0,115
Heath Herring,2002-09-29,Iouri Kotchkine,KO/TKO,100,32,0,132
Heath Herring,2004-06-20,Antonio Rodrigo Nogueira,Submission,0,12,0,12
Heath Herring,2002-11-24,Fedor Emelianenko,TKO - Doctor's Stoppage,0,0,0,0
Heath Herring,2001-05-27,Vitor Belfort,Decision - Unanimous,0,25,0,25
Heath Herring,2007-04-07,Brad Imes,Decision - Unanimous,80,45,0,125
Heath Herring,2007-07-07,Antonio Rodrigo Nogueira,Decision - Unanimous,0,0,0,0
Heath Herring,2001-03-25,Denis Sobolev,Submission,90,2,0,92
Heath Herring,2000-06-04,Willie Peeters,Submission,90,3,0,93
Heath Herring,2003-11-09,Yoshihisa Yamamoto,Submission,90,34,0,124
Heath Herring,2003-12-31,Paulo Cesar Silva,Submission,90,32,0,122
Mark Kerr,2001-07-29,Heath Herring,KO/TKO,0,0,0,0
Mark Kerr,2000-05-01,Kazuyuki Fujita,Decision - Unanimous,0,0,0,0
Mark Kerr,1997-07-27,Moti Horenstein,KO/TKO,100,13,0,113
Mark Kerr,2000-12-09,Igor Vovchanchyn,Decision - Unanimous,0,0,0,0
Mark Kerr,1998-03-05,Branko Cikatic,DQ,0,0,0,0
Mark Kerr,2004-02-01,Yoshihisa Yamamoto,KO/TKO,0,0,0,0
Mark Kerr,2000-01-30,Enson Inoue,Decision - Unanimous,80,21,0,101
Mark Kerr,2000-08-27,Igor Borisov,Submission,90,2,0,92
Mark Kerr,1999-07-04,Nobuhiko Takada,Submission,90,0,0,90
Mark Kerr,2009-08-28,Muhammed Lawal,KO/TKO,0,0,0,0
Mark Kerr,1997-10-17,Greg Stott,KO/TKO,100,1,0,101
Mark Kerr,1998-06-24,Pedro Otavio,Submission,90,7,0,97
Mark Kerr,1997-07-27,Dan Bobish,Submission,90,3,0,93
Mark Kerr,1997-10-17,Dwayne Cason,Submission,90,5,0,95
Mark Kerr,1998-10-11,Hugo Duarte,DQ,0,38,0,38
Leonard Garcia,2007-06-23,Allen Berube,Submission,90,0,0,90
Leonard Garcia,2007-04-07,Roger Huerta,Decision - Unanimous,0,0,0,0
Leonard Garcia,2009-08-09,Jameel Massouh,Decision - Split,70,0,0,70
Leonard Garcia,2008-11-05,Jens Pulver,KO/TKO,100,6,0,106
Leonard Garcia,2008-02-13,Hiroyuki Takaya,KO/TKO,100,10,0,110
Leonard Garcia,2007-09-19,Cole Miller,Decision - Unanimous,0,0,0,0
Leonard Garcia,2011-03-26,Chan Sung Jung,Submission,0,0,0,0
Leonard Garcia,2010-04-24,Chan Sung Jung,Decision - Split,70,0,0,70
Leonard Garcia,2012-06-08,Matt Grice,Decision - Unanimous,0,0,0,0
Leonard Garcia,2012-12-29,Max Holloway,Decision - Split,0,0,0,0
Leonard Garcia,2011-10-08,Nam Phan,Decision - Unanimous,0,0,0,0
Leonard Garcia,2010-12-04,Nam Phan,Decision - Split,70,0,0,70
Leonard Garcia,2009-11-18,Manvel Gamburyan,Decision - Unanimous,0,0,0,0
Leonard Garcia,2009-03-01,Mike Brown,Submission,0,0,25,25
Leonard Garcia,2013-04-27,Cody McKenzie,Decision - Unanimous,0,0,0,0
Leonard Garcia,2010-09-30,Mark Hominick,Decision - Split,0,0,0,0
Allen Berube,2007-06-23,Leonard Garcia,Submission,0,0,0,0
Andre Galvao,2010-08-21,Jorge Patino,KO/TKO,100,39,0,139
Andre Galvao,2009-07-20,Jason High,Decision - Split,0,0,0,0
Andre Galvao,2009-04-05,John Alessio,Submission,90,10,0,100
Andre Galvao,2010-10-09,Tyron Woodley,KO/TKO,0,0,0,0
Jorge Patino,2010-08-21,Andre Galvao,KO/TKO,0,0,0,0
Jorge Patino,2004-05-23,Kazuo Misaki,Decision - Unanimous,0,0,0,0
Jorge Patino,1999-01-08,Pat Miletich,Decision - Unanimous,0,0,0,0
Holly Holm,2015-07-15,Marion Reneau,Decision - Unanimous,80,39,0,119
Holly Holm,2024-04-13,Kayla Harrison,Submission,0,0,0,0
Holly Holm,2016-07-23,Valentina Shevchenko,Decision - Unanimous,0,0,25,25
Holly Holm,2016-03-05,Miesha Tate,Submission,0,19,25,44
Holly Holm,2022-05-21,Ketlen Vieira,Decision - Split,0,11,25,36
Holly Holm,2019-07-06,Amanda Nunes,KO/TKO,0,0,25,25
Holly Holm,2020-01-18,Raquel Pennington,Decision - Unanimous,80,0,0,80
Holly Holm,2015-02-28,Raquel Pennington,Decision - Split,70,4,0,74
Holly Holm,2017-12-30,Cristiane Justino,Decision - Unanimous,0,0,25,25
Holly Holm,2017-02-11,Germaine de Randamie,Decision - Unanimous,0,0,25,25
Holly Holm,2023-03-25,Yana Santos,Decision - Unanimous,80,11,0,91
Holly Holm,2015-11-14,Ronda Rousey,KO/TKO,100,21,25,146
Holly Holm,2018-06-09,Megan Anderson,Decision - Unanimous,80,21,0,101
Holly Holm,2017-06-17,Bethe Correia,KO/TKO,100,10,25,135
Holly Holm,2020-10-03,Irene Aldana,Decision - Unanimous,80,85,25,190
Marion Reneau,2015-07-15,Holly Holm,Decision - Unanimous,0,0,0,0
Marion Reneau,2019-03-09,Yana Santos,Decision - Unanimous,0,0,0,0
Marion Reneau,2021-07-17,Miesha Tate,KO/TKO,0,0,0,0
Marion Reneau,2015-01-03,Alexis Dufresne,Decision - Unanimous,80,57,0,137
Marion Reneau,2021-03-20,Macy Chiasson,Decision - Unanimous,0,0,0,0
Marion Reneau,2020-06-20,Raquel Pennington,Decision - Unanimous,0,0,0,0
Marion Reneau,2016-11-19,Milana Dudieva,KO/TKO,100,31,0,131
Marion Reneau,2015-02-22,Jessica Andrade,Submission,90,0,0,90
Marion Reneau,2018-07-14,Cat Zingano,Decision - Unanimous,0,0,0,0
Marion Reneau,2016-02-21,Ashlee Evans-Smith,Decision - Split,0,0,0,0
Marion Reneau,2018-02-24,Sara McMann,Submission,90,14,0,104
Marion Reneau,2017-09-02,Talita Bernardo,KO/TKO,100,35,0,135
Megan Anderson,2021-03-06,Amanda Nunes,Submission,0,0,25,25
Megan Anderson,2019-10-05,Zarah Fairn,Submission,90,8,0,98
Megan Anderson,2018-12-29,Cat Zingano,KO/TKO,100,0,0,100
Megan Anderson,2020-02-29,Norma Dumont,KO/TKO,100,2,0,102
Megan Anderson,2019-05-18,Felicia Spencer,Submission,0,0,0,0
Megan Anderson,2018-06-09,Holly Holm,Decision - Unanimous,0,0,0,0
Alex Oliveira,2015-06-27,Joe Merritt,Decision - Unanimous,80,0,0,80
Alex Oliveira,2018-04-14,Carlos Condit,Submission,90,0,0,90
Alex Oliveira,2017-07-22,Ryan LaFlare,KO/TKO,100,3,0,103
Alex Oliveira,2015-05-30,KJ Noons,Submission,90,0,0,90
Alex Oliveira,2015-11-07,Piotr Hallmann,KO/TKO,100,6,0,106
Alex Oliveira,2018-09-22,Carlo Pedersoli Jr.,KO/TKO,100,5,0,105
Alex Oliveira,2019-09-28,Nicolas Dalby,Decision - Unanimous,0,0,0,0
Alex Oliveira,2021-10-02,Niko Price,Decision - Unanimous,0,1,0,1
Alex Oliveira,2020-10-24,Shavkat Rakhmonov,Submission,0,0,0,0
Alex Oliveira,2020-07-25,Peter Sobotta,Decision - Unanimous,80,16,0,96
Alex Oliveira,2015-03-21,Gilbert Burns,Submission,0,12,0,12
Alex Oliveira,2017-12-02,Yancy Medeiros,KO/TKO,0,18,0,18
Alex Oliveira,2021-04-24,Randy Brown,Submission,0,0,0,0
Alex Oliveira,2020-03-07,Max Griffin,Decision - Split,70,17,0,87
Alex Oliveira,2022-03-05,Kevin Holland,KO/TKO,0,0,0,0
Alex Oliveira,2016-07-23,James Moontasri,Decision - Unanimous,80,46,0,126
Alex Oliveira,2016-10-01,Will Brooks,KO/TKO,100,32,0,132
Alex Oliveira,2018-12-08,Gunnar Nelson,Submission,0,25,0,25
Alex Oliveira,2019-04-27,Mike Perry,Decision - Unanimous,0,0,0,0
Alex Oliveira,2017-03-11,Tim Means,Submission,90,3,0,93
Alex Oliveira,2016-02-21,Donald Cerrone,Submission,0,10,25,35
Joe Merritt,2015-06-27,Alex Oliveira,Decision - Unanimous,0,12,0,12
Fedor Emelianenko,2011-12-31,Satoshi Ishii,KO/TKO,100,13,0,113
Fedor Emelianenko,2012-06-21,Pedro Rizzo,KO/TKO,100,11,0,111
Fedor Emelianenko,2003-08-10,Gary Goodridge,KO/TKO,100,29,0,129
Fedor Emelianenko,2003-03-16,Antonio Rodrigo Nogueira,Decision - Unanimous,80,76,0,156
Fedor Emelianenko,2011-02-12,Antonio Silva,TKO - Doctor's Stoppage,0,0,0,0
Fedor Emelianenko,2009-01-24,Andrei Arlovski,KO/TKO,100,0,25,125
Fedor Emelianenko,2004-08-15,Naoya Ogawa,Submission,90,7,0,97
Fedor Emelianenko,2011-07-30,Dan Henderson,KO/TKO,0,0,0,0
Fedor Emelianenko,2004-04-25,Mark Coleman,Submission,90,0,0,90
Fedor Emelianenko,2005-04-03,Tsuyoshi Kohsaka,TKO - Doctor's Stoppage,0,28,0,28
Fedor Emelianenko,2007-12-31,Hong Man Choi,Submission,90,0,0,90
Fedor Emelianenko,2009-11-07,Brett Rogers,KO/TKO,100,0,0,100
Fedor Emelianenko,2007-04-14,Matt Lindland,Submission,90,0,0,90
Fedor Emelianenko,2003-12-31,Yuji Nagata,KO/TKO,100,13,0,113
Fedor Emelianenko,2002-11-24,Heath Herring,TKO - Doctor's Stoppage,0,29,0,29
Fedor Emelianenko,2005-08-28,Mirko Filipovic,Decision - Unanimous,80,40,0,120
Fedor Emelianenko,2002-06-23,Semmy Schilt,Decision - Unanimous,80,27,0,107
Fedor Emelianenko,2008-07-19,Tim Sylvia,Submission,90,15,25,130
Fedor Emelianenko,2010-06-26,Fabricio Werdum,Submission,0,2,0,2
Fedor Emelianenko,2011-11-20,Jeff Monson,Decision - Unanimous,80,45,0,125
Fedor Emelianenko,2004-12-31,Antonio Rodrigo Nogueira,Decision - Unanimous,80,45,0,125
Fedor Emelianenko,2006-10-21,Mark Coleman,Submission,90,12,0,102
Fedor Emelianenko,2005-12-31,Wagner da Conceicao Martins,KO/TKO,100,13,0,113
Fedor Emelianenko,2003-06-08,Kazuyuki Fujita,Submission,90,10,0,100
Fedor Emelianenko,2006-12-31,Mark Hunt,Submission,90,1,0,91
Fedor Emelianenko,2004-06-20,Kevin Randleman,Submission,90,11,0,101
Satoshi Ishii,2011-12-31,Fedor Emelianenko,KO/TKO,0,0,0,0
Satoshi Ishii,2010-09-25,Ikuhisa Minowa,Decision - Unanimous,80,0,0,80
Satoshi Ishii,2010-12-31,Jerome LeBanner,Decision - Unanimous,80,7,0,87
Satoshi Ishii,2009-12-31,Hidehiko Yoshida,Decision - Unanimous,0,1,0,1
Mauricio Rua,2005-08-28,Alistair Overeem,KO/TKO,100,8,0,108
Mauricio Rua,2005-04-23,Quinton Jackson,KO/TKO,100,40,0,140
Mauricio Rua,2014-11-08,Ovince Saint Preux,KO/TKO,0,0,25,25
Mauricio Rua,2011-08-27,Forrest Griffin,KO/TKO,100,13,0,113
Mauricio Rua,2009-10-24,Lyoto Machida,Decision - Unanimous,0,45,25,70
Mauricio Rua,2011-03-19,Jon Jones,KO/TKO,0,0,25,25
Mauricio Rua,2005-06-26,Rogerio Nogueira,Decision - Unanimous,80,39,0,119
Mauricio Rua,2009-04-18,Chuck Liddell,KO/TKO,100,16,0,116
Mauricio Rua,2003-08-01,Evangelista Santos,KO/TKO,100,13,0,113
Mauricio Rua,2003-09-06,Renato Sobral,Submission,0,7,0,7
Mauricio Rua,2003-10-05,Akira Shoji,KO/TKO,100,18,0,118
Mauricio Rua,2022-05-07,Ovince Saint Preux,Decision - Split,0,0,0,0
Mauricio Rua,2013-12-06,James Te Huna,KO/TKO,100,8,0,108
Mauricio Rua,2006-02-26,Mark Coleman,KO/TKO,0,0,0,0
Mauricio Rua,2015-08-01,Rogerio Nogueira,Decision - Unanimous,80,0,0,80
Mauricio Rua,2023-01-21,Ihor Potieria,KO/TKO,0,0,0,0
Mauricio Rua,2020-07-25,Rogerio Nogueira,Decision - Split,70,8,0,78
Mauricio Rua,2014-03-23,Dan Henderson,KO/TKO,0,25,25,50
Mauricio Rua,2003-05-16,Angelo Antonio,KO/TKO,100,6,0,106
Mauricio Rua,2016-05-14,Corey Anderson,Decision - Split,70,0,0,70
Mauricio Rua,2002-11-08,Rafael Freitas,KO/TKO,100,24,0,124
Mauricio Rua,2004-10-14,Yasuhito Namekawa,KO/TKO,100,25,0,125
Mauricio Rua,2007-09-22,Forrest Griffin,Submission,0,0,0,0
Mauricio Rua,2018-07-22,Anthony Smith,KO/TKO,0,0,25,25
Mauricio Rua,2007-02-24,Alistair Overeem,KO/TKO,100,0,0,100
Mauricio Rua,2005-08-28,Ricardo Arona,KO/TKO,100,10,0,110
Mauricio Rua,2006-12-31,Kazuhiro Nakamura,Decision - Unanimous,80,43,0,123
Mauricio Rua,2004-02-15,Akihiro Gono,KO/TKO,100,52,0,152
Mauricio Rua,2012-12-08,Alexander Gustafsson,Decision - Unanimous,0,0,0,0
Mauricio Rua,2009-01-17,Mark Coleman,KO/TKO,100,31,0,131
Mauricio Rua,2017-03-11,Gian Villante,KO/TKO,100,39,0,139
Mauricio Rua,2011-11-19,Dan Henderson,Decision - Unanimous,0,19,25,44
Mauricio Rua,2018-12-01,Tyson Pedro,KO/TKO,100,0,0,100
Mauricio Rua,2012-08-04,Brandon Vera,KO/TKO,100,1,25,126
Mauricio Rua,2005-02-20,Hiromitsu Kanehara,KO/TKO,100,15,0,115
Mauricio Rua,2006-10-21,Kevin Randleman,Submission,90,0,0,90
Mauricio Rua,2020-11-21,Paul Craig,KO/TKO,0,0,0,0
Mauricio Rua,2010-05-08,Lyoto Machida,KO/TKO,100,8,25,133
Mauricio Rua,2013-08-17,Chael Sonnen,Submission,0,0,25,25
Mauricio Rua,2003-09-06,Erick Wanderlei,KO/TKO,100,16,0,116
Mauricio Rua,2006-09-10,Cyrille Diabate,KO/TKO,100,10,0,110
Alistair Overeem,2005-08-28,Mauricio Rua,KO/TKO,0,0,0,0
Alistair Overeem,2013-08-17,Travis Browne,KO/TKO,0,27,0,27
Alistair Overeem,2005-06-26,Igor Vovchanchyn,Submission,90,4,0,94
Alistair Overeem,2019-12-07,Jairzinho Rozenstruik,KO/TKO,0,0,25,25
Alistair Overeem,2002-12-23,Bazigit Atajev,KO/TKO,100,34,0,134
Alistair Overeem,2008-11-09,Gary Goodridge,Submission,90,17,0,107
Alistair Overeem,2005-02-20,Rogerio Nogueira,Decision - Unanimous,0,0,0,0
Alistair Overeem,2020-05-16,Walt Harris,KO/TKO,100,43,25,168
Alistair Overeem,2017-03-04,Mark Hunt,KO/TKO,100,34,0,134
Alistair Overeem,2017-07-08,Fabricio Werdum,Decision - Majority,75,0,0,75
Alistair Overeem,2009-10-25,James Thompson,Submission,90,1,0,91
Alistair Overeem,2003-06-08,Mike Bencic,KO/TKO,100,9,0,109
Alistair Overeem,2010-05-15,Brett Rogers,KO/TKO,100,38,25,163
Alistair Overeem,2009-10-17,Tony Sylvester,Submission,90,14,0,104
Alistair Overeem,2008-06-15,Tae Hyun Lee,KO/TKO,100,10,0,110
Alistair Overeem,2005-04-23,Vitor Belfort,Submission,90,15,0,105
Alistair Overeem,2021-02-06,Alexander Volkov,KO/TKO,0,0,25,25
Alistair Overeem,2009-12-31,Kazuyuki Fujita,KO/TKO,100,5,0,105
Alistair Overeem,2008-07-21,Mark Hunt,Submission,90,0,0,90
Alistair Overeem,2006-06-09,Vitor Belfort,Decision - Unanimous,80,14,0,94
Alistair Overeem,2018-06-09,Curtis Blaydes,KO/TKO,0,0,0,0
Alistair Overeem,2011-06-18,Fabricio Werdum,Decision - Unanimous,80,0,0,80
Alistair Overeem,2015-03-14,Roy Nelson,Decision - Unanimous,80,39,0,119
Alistair Overeem,2007-11-16,Paul Buentello,KO/TKO,100,29,25,154
Alistair Overeem,2014-02-01,Frank Mir,Decision - Unanimous,80,59,0,139
Alistair Overeem,2007-02-24,Mauricio Rua,KO/TKO,0,0,0,0
Alistair Overeem,2011-12-30,Brock Lesnar,KO/TKO,100,13,25,138
Alistair Overeem,2002-07-20,Yusuke Imamura,KO/TKO,100,7,0,107
Alistair Overeem,2016-05-08,Andrei Arlovski,KO/TKO,100,7,25,132
Alistair Overeem,2006-09-10,Ricardo Arona,KO/TKO,0,0,0,0
Alistair Overeem,2003-08-10,Chuck Liddell,KO/TKO,0,0,0,0
Alistair Overeem,2007-09-17,Sergei Kharitonov,KO/TKO,0,2,0,2
Alistair Overeem,2017-12-02,Francis Ngannou,KO/TKO,0,0,0,0
Alistair Overeem,2019-04-20,Aleksei Oleinik,KO/TKO,100,0,25,125
Alistair Overeem,2004-10-31,Hiromitsu Kanehara,TKO - Doctor's Stoppage,0,40,0,40
Alistair Overeem,2006-07-01,Rogerio Nogueira,KO/TKO,0,19,0,19
Alistair Overeem,2006-02-26,Sergei Kharitonov,KO/TKO,100,36,0,136
Alistair Overeem,2010-12-31,Todd Duffee,KO/TKO,100,3,0,103
Alistair Overeem,2020-09-05,Augusto Sakai,KO/TKO,100,0,25,125
Alistair Overeem,2013-02-02,Antonio Silva,KO/TKO,0,30,0,30
Alistair Overeem,2015-12-19,Junior Dos Santos,KO/TKO,100,10,0,110
Alistair Overeem,2006-03-18,Nikolajus Cilkinas,Submission,90,10,0,100
Alistair Overeem,2018-11-24,Sergei Pavlovich,KO/TKO,100,9,0,109
Alistair Overeem,2016-09-10,Stipe Miocic,KO/TKO,0,0,25,25
Alistair Overeem,2003-12-31,Tomohiko Hashimoto,KO/TKO,100,7,0,107
Alistair Overeem,2006-05-05,Fabricio Werdum,Submission,0,14,0,14
Alistair Overeem,2014-09-05,Ben Rothwell,KO/TKO,0,3,0,3
Alistair Overeem,2014-12-13,Stefan Struve,KO/TKO,100,15,0,115
Paulo Costa,2020-09-26,Israel Adesanya,KO/TKO,0,0,25,25
Paulo Costa,2018-07-07,Uriah Hall,KO/TKO,100,17,0,117
Paulo Costa,2024-06-01,Sean Strickland,Decision - Split,0,0,25,25
Paulo Costa,2021-10-23,Marvin Vettori,Decision - Unanimous,0,0,25,25
Paulo Costa,2017-06-03,Oluwale Bamgbose,KO/TKO,100,10,0,110
Paulo Costa,2019-08-17,Yoel Romero,Decision - Unanimous,80,0,0,80
Paulo Costa,2022-08-20,Luke Rockhold,Decision - Unanimous,80,22,0,102
Paulo Costa,2017-03-11,Garreth McLellan,KO/TKO,100,16,0,116
Paulo Costa,2017-11-04,Johny Hendricks,KO/TKO,100,22,0,122
Paulo Costa,2024-02-17,Robert Whittaker,Decision - Unanimous,0,0,0,0
Eddie Alvarez,2015-06-13,Gilbert Melendez,Decision - Split,70,0,0,70
Eddie Alvarez,2018-07-28,Dustin Poirier,KO/TKO,0,0,25,25
Eddie Alvarez,2016-07-07,Rafael Dos Anjos,KO/TKO,100,33,25,158
Eddie Alvarez,2008-03-15,Andre Amado,KO/TKO,100,32,0,132
Eddie Alvarez,2008-05-11,Joachim Hansen,Decision - Unanimous,80,8,0,88
Eddie Alvarez,2014-09-27,Donald Cerrone,Decision - Unanimous,0,0,0,0
Eddie Alvarez,2009-10-25,Katsunori Kikuno,Submission,90,6,0,96
Eddie Alvarez,2008-07-21,Tatsuya Kawajiri,KO/TKO,100,18,0,118
Eddie Alvarez,2016-01-17,Anthony Pettis,Decision - Split,70,0,0,70
Eddie Alvarez,2017-12-02,Justin Gaethje,KO/TKO,100,33,0,133
Eddie Alvarez,2016-11-12,Conor McGregor,KO/TKO,0,0,25,25
Eddie Alvarez,2008-12-31,Shinya Aoki,Submission,0,1,0,1
Gilbert Melendez,2015-06-13,Eddie Alvarez,Decision - Split,0,6,0,6
Gilbert Melendez,2009-08-15,Mitsuhiro Ishida,KO/TKO,100,45,25,170
Gilbert Melendez,2010-04-17,Shinya Aoki,Decision - Unanimous,80,58,25,163
Gilbert Melendez,2006-03-10,Harris Sarmiento,KO/TKO,100,28,0,128
Gilbert Melendez,2008-06-27,Josh Thomson,Decision - Unanimous,0,0,25,25
Gilbert Melendez,2019-07-06,Arnold Allen,Decision - Unanimous,0,0,0,0
Gilbert Melendez,2006-08-27,Nobuhiro Obiya,Decision - Unanimous,80,45,0,125
Gilbert Melendez,2006-12-31,Tatsuya Kawajiri,Decision - Unanimous,80,21,0,101
Gilbert Melendez,2016-07-23,Edson Barboza,Decision - Unanimous,0,0,0,0
Gilbert Melendez,2007-12-31,Mitsuhiro Ishida,Decision - Unanimous,0,6,0,6
Gilbert Melendez,2003-03-27,Jeff Hougland,KO/TKO,100,32,0,132
Gilbert Melendez,2017-09-09,Jeremy Stephens,Decision - Unanimous,0,0,0,0
Gilbert Melendez,2014-12-06,Anthony Pettis,Submission,0,0,25,25
Gilbert Melendez,2009-04-11,Rodrigo Damm,KO/TKO,100,17,25,142
Gilbert Melendez,2008-03-29,Gabe Lemley,KO/TKO,100,38,25,163
Gilbert Melendez,2011-04-09,Tatsuya Kawajiri,KO/TKO,100,27,25,152
Gilbert Melendez,2011-12-17,Jorge Masvidal,Decision - Unanimous,80,18,25,123
Gilbert Melendez,2013-04-20,Benson Henderson,Decision - Split,0,0,25,25
Gilbert Melendez,2004-05-21,Olaf Alfonso,KO/TKO,100,73,0,173
Gilbert Melendez,2012-05-19,Josh Thomson,Decision - Split,70,13,25,108
Gilbert Melendez,2009-12-19,Josh Thomson,Decision - Unanimous,80,29,25,134
Gilbert Melendez,2013-10-19,Diego Sanchez,Decision - Unanimous,80,54,0,134
Gilbert Melendez,2006-06-09,Clay Guida,Decision - Split,70,53,25,148
Gilbert Melendez,2007-09-29,Tetsuji Kato,Decision - Unanimous,80,24,0,104
Raul Rosas Jr.,2022-12-10,Jay Perrin,Submission,90,0,0,90
Raul Rosas Jr.,2023-09-16,Terrence Mitchell,KO/TKO,100,12,0,112
Raul Rosas Jr.,2024-06-08,Ricky Turcios,Submission,90,0,0,90
Raul Rosas Jr.,2022-09-20,Mando Gutierrez,Decision - Unanimous,80,8,0,88
Raul Rosas Jr.,2024-09-14,Aoriqileng,Decision - Unanimous,80,19,0,99
Raul Rosas Jr.,2023-04-08,Christian Rodriguez,Decision - Unanimous,0,0,0,0
Jay Perrin,2022-12-10,Raul Rosas Jr.,Submission,0,1,0,1
Jay Perrin,2022-08-20,Aoriqileng,Decision - Unanimous,0,16,0,16
Jay Perrin,2022-02-19,Mario Bautista,Decision - Unanimous,0,0,0,0
Jay Perrin,2019-08-06,Dwight Joseph,Decision - Unanimous,0,4,0,4
Josh Koscheck,2009-09-19,Frank Trigg,KO/TKO,100,8,0,108
Josh Koscheck,2009-02-21,Paulo Thiago,KO/TKO,0,1,0,1
Josh Koscheck,2007-04-07,Diego Sanchez,Decision - Unanimous,80,18,0,98
Josh Koscheck,2005-10-03,Drew Fickett,Submission,0,3,0,3
Josh Koscheck,2010-12-11,Georges St-Pierre,Decision - Unanimous,0,0,25,25
Josh Koscheck,2012-02-04,Mike Pierce,Decision - Split,70,0,0,70
Josh Koscheck,2010-05-08,Paul Daley,Decision - Unanimous,80,8,0,88
Josh Koscheck,2013-02-23,Robbie Lawler,KO/TKO,0,0,0,0
Josh Koscheck,2008-07-05,Chris Lytle,Decision - Unanimous,80,22,0,102
Josh Koscheck,2012-05-05,Johny Hendricks,Decision - Split,0,0,0,0
Josh Koscheck,2006-08-17,Jonathan Goulet,KO/TKO,100,22,0,122
Josh Koscheck,2008-03-01,Dustin Hazelett,KO/TKO,100,4,0,104
Josh Koscheck,2011-09-24,Matt Hughes,KO/TKO,100,12,0,112
Josh Koscheck,2007-08-25,Georges St-Pierre,Decision - Unanimous,0,0,0,0
Josh Koscheck,2008-10-25,Thiago Alves,Decision - Unanimous,0,0,0,0
Josh Koscheck,2006-04-06,Ansar Chalangov,Submission,90,0,0,90
Josh Koscheck,2015-02-28,Jake Ellenberger,Submission,0,0,0,0
Josh Koscheck,2005-04-09,Chris Sanford,KO/TKO,100,13,0,113
Josh Koscheck,2006-06-28,Dave Menne,Decision - Unanimous,80,32,0,112
Josh Koscheck,2005-08-06,Pete Spratt,Submission,90,0,0,90
Josh Koscheck,2009-11-21,Anthony Johnson,Submission,90,3,0,93
Josh Koscheck,2013-11-16,Tyron Woodley,KO/TKO,0,0,0,0
Josh Koscheck,2015-03-21,Erick Silva,Submission,0,0,0,0
Josh Koscheck,2008-12-10,Yoshiyuki Yoshida,KO/TKO,100,0,0,100
Josh Koscheck,2006-12-13,Jeff Joslin,Decision - Unanimous,80,0,0,80
Frank Trigg,2009-09-19,Josh Koscheck,KO/TKO,0,0,0,0
Frank Trigg,2005-08-20,Georges St-Pierre,Submission,0,0,0,0
Frank Trigg,2005-04-16,Matt Hughes,Submission,0,0,25,25
Frank Trigg,1999-11-21,Fabiano Iha,KO/TKO,100,28,0,128
Frank Trigg,2007-02-24,Kazuo Misaki,Decision - Unanimous,80,8,0,88
Frank Trigg,2003-11-21,Matt Hughes,Submission,0,0,25,25
Frank Trigg,2010-02-06,Matt Serra,KO/TKO,0,0,0,0
Frank Trigg,2008-10-03,Falaniko Vitale,Decision - Unanimous,80,33,0,113
Frank Trigg,2004-10-22,Renato Verissimo,KO/TKO,100,29,0,129
Frank Trigg,2004-06-19,Dennis Hallman,KO/TKO,100,19,0,119
Tatiana Suarez,2018-09-08,Carla Esparza,KO/TKO,100,76,0,176
Tatiana Suarez,2016-07-08,Amanda Cooper,Submission,90,15,0,105
Tatiana Suarez,2023-08-05,Jessica Andrade,Submission,90,12,0,102
Tatiana Suarez,2017-11-11,Viviane Pereira,Decision - Unanimous,80,58,0,138
Tatiana Suarez,2023-02-25,Montana De La Rosa,Submission,90,5,0,95
Tatiana Suarez,2019-06-08,Nina Nunes,Decision - Unanimous,80,27,0,107
Tatiana Suarez,2018-05-19,Alexa Grasso,Submission,90,0,0,90
Carla Esparza,2018-09-08,Tatiana Suarez,KO/TKO,0,0,0,0
Carla Esparza,2017-12-30,Cynthia Calvillo,Decision - Unanimous,80,10,0,90
Carla Esparza,2020-05-09,Michelle Waterson-Gomez,Decision - Split,70,1,0,71
Carla Esparza,2019-04-27,Virna Jandiroba,Decision - Unanimous,80,8,0,88
Carla Esparza,2017-02-19,Randa Markos,Decision - Split,0,0,0,0
Carla Esparza,2018-06-09,Claudia Gadelha,Decision - Split,0,17,0,17
Carla Esparza,2015-03-14,Joanna Jedrzejczyk,KO/TKO,0,0,25,25
Carla Esparza,2019-09-21,Alexa Grasso,Decision - Majority,75,0,0,75
Carla Esparza,2022-05-07,Rose Namajunas,Decision - Split,70,0,25,95
Carla Esparza,2022-11-12,Zhang Weili,Submission,0,0,25,25
Carla Esparza,2014-12-12,Rose Namajunas,Submission,90,14,25,129
Carla Esparza,2024-10-05,Tecia Pennington,Decision - Unanimous,0,0,0,0
Carla Esparza,2020-07-25,Marina Rodriguez,Decision - Split,70,0,0,70
Carla Esparza,2016-04-23,Juliana Lima,Decision - Unanimous,80,2,0,82
Carla Esparza,2017-06-25,Maryna Moroz,Decision - Unanimous,80,2,0,82
Carla Esparza,2021-05-22,Yan Xiaonan,KO/TKO,100,22,0,122
Rafa Garcia,2021-11-20,Natan Levy,Decision - Unanimous,80,0,0,80
Rafa Garcia,2022-12-17,Maheshate,Decision - Unanimous,80,24,0,104
Rafa Garcia,2023-04-15,Clay Guida,Decision - Unanimous,80,78,0,158
Rafa Garcia,2021-03-13,Nasrat Haqparast,Decision - Unanimous,0,0,0,0
Rafa Garcia,2024-10-12,Grant Dawson,KO/TKO,0,0,0,0
Rafa Garcia,2022-07-30,Drakkar Klose,Decision - Unanimous,0,0,0,0
Rafa Garcia,2021-07-31,Chris Gruetzemacher,Decision - Unanimous,0,0,0,0
Rafa Garcia,2022-04-16,Jesse Ronson,Submission,90,10,0,100
Natan Levy,2021-11-20,Rafa Garcia,Decision - Unanimous,0,12,0,12
Natan Levy,2020-11-10,Shaheen Santana,Submission,90,9,0,99
Natan Levy,2022-04-30,Mike Breeden,Decision - Unanimous,80,0,0,80
Natan Levy,2024-03-16,Mike Davis,Submission,0,5,0,5
Natan Levy,2022-12-03,Genaro Valdez,Decision - Unanimous,80,18,0,98
Shinya Aoki,2006-12-31,Joachim Hansen,Submission,90,4,0,94
Shinya Aoki,2008-09-23,Todd Moore,Submission,90,1,0,91
Shinya Aoki,2007-02-17,Akira Kikuchi,Decision - Split,70,0,0,70
Shinya Aoki,2004-10-30,Jutaro Nakao,KO/TKO,0,0,0,0
Shinya Aoki,2005-11-06,Kuniyoshi Hironaka,TKO - Doctor's Stoppage,0,11,0,11
Shinya Aoki,2010-04-17,Gilbert Melendez,Decision - Unanimous,0,0,25,25
Shinya Aoki,2008-04-29,Gesias Cavalcante,Decision - Unanimous,80,0,0,80
Shinya Aoki,2008-07-21,Caol Uno,Decision - Unanimous,80,0,0,80
Shinya Aoki,2011-09-24,Rob McCullough,Submission,90,4,0,94
Shinya Aoki,2005-01-29,Keith Wisniewski,Submission,90,0,0,90
Shinya Aoki,2009-12-31,Mizuto Hirota,Submission,90,5,0,95
Shinya Aoki,2008-07-21,Joachim Hansen,KO/TKO,0,0,0,0
Shinya Aoki,2008-06-15,Katsuhiko Nagata,Submission,90,8,0,98
Shinya Aoki,2010-10-24,Yokthai Sithoar,Submission,90,0,0,90
Shinya Aoki,2011-05-29,Rich Clementi,Submission,90,21,0,111
Shinya Aoki,2010-09-25,Marcus Aurelio,Decision - Unanimous,80,14,0,94
Shinya Aoki,2007-12-31,Bu-Kyung Jung,Decision - Unanimous,80,21,0,101
Shinya Aoki,2006-11-05,Clay French,Submission,90,0,0,90
Shinya Aoki,2011-12-31,Satoru Kitaoka,Decision - Unanimous,80,9,25,114
Shinya Aoki,2009-04-05,Hayato Sakurai,KO/TKO,0,0,0,0
Shinya Aoki,2009-10-06,Joachim Hansen,Submission,90,0,0,90
Shinya Aoki,2010-07-10,Tatsuya Kawajiri,Submission,90,0,0,90
Shinya Aoki,2012-12-31,Antonio McKee,KO/TKO,100,2,0,102
Shinya Aoki,2007-04-08,Brian Lo-A-Njoe,Submission,90,0,0,90
Shinya Aoki,2009-03-08,David Gardner,Submission,90,1,0,91
Shinya Aoki,2011-04-09,Lyle Beerbohm,Submission,90,1,0,91
Shinya Aoki,2009-07-20,Vitor Ribeiro,Decision - Unanimous,80,20,0,100
Shinya Aoki,2006-10-14,George Sotiropoulos,DQ,0,0,0,0
Shinya Aoki,2006-08-27,Jason Black,Submission,90,2,0,92
Shinya Aoki,2008-12-31,Eddie Alvarez,Submission,90,0,0,90
Matt Mitrione,2014-09-05,Derrick Lewis,KO/TKO,100,6,0,106
Matt Mitrione,2009-12-05,Marcus Jones,KO/TKO,100,4,0,104
Matt Mitrione,2011-10-29,Cheick Kongo,Decision - Unanimous,0,0,0,0
Matt Mitrione,2013-09-21,Brendan Schaub,Submission,0,0,0,0
Matt Mitrione,2010-09-25,Joey Beltran,Decision - Unanimous,80,24,0,104
Matt Mitrione,2013-04-06,Philip De Fries,KO/TKO,100,7,0,107
Matt Mitrione,2011-01-22,Tim Hague,KO/TKO,100,13,0,113
Matt Mitrione,2014-03-01,Shawn Jordan,KO/TKO,100,9,0,109
Matt Mitrione,2016-01-17,Travis Browne,KO/TKO,0,0,0,0
Matt Mitrione,2012-12-15,Roy Nelson,KO/TKO,0,0,25,25
Matt Mitrione,2014-12-13,Gabriel Gonzaga,KO/TKO,100,6,0,106
Matt Mitrione,2011-06-26,Christian Morecraft,KO/TKO,100,20,0,120
Matt Mitrione,2010-05-08,Kevin Ferguson,KO/TKO,100,39,0,139
Matt Mitrione,2015-06-06,Ben Rothwell,Submission,0,3,0,3
Derrick Lewis,2014-09-05,Matt Mitrione,KO/TKO,0,0,0,0
Derrick Lewis,2019-11-02,Blagoy Ivanov,Decision - Split,70,11,0,81
Derrick Lewis,2018-02-18,Marcin Tybura,KO/TKO,100,0,0,100
Derrick Lewis,2016-04-10,Gabriel Gonzaga,KO/TKO,100,12,0,112
Derrick Lewis,2015-02-28,Ruan Potts,KO/TKO,100,46,0,146
Derrick Lewis,2023-07-29,Marcos Rogerio de Lima,KO/TKO,100,16,0,116
Derrick Lewis,2018-11-03,Daniel Cormier,Submission,0,0,25,25
Derrick Lewis,2014-07-06,Guto Inocente,KO/TKO,100,0,0,100
Derrick Lewis,2020-02-08,Ilir Latifi,Decision - Unanimous,80,15,0,95
Derrick Lewis,2017-06-10,Mark Hunt,KO/TKO,0,0,25,25
Derrick Lewis,2016-12-09,Shamil Abdurakhimov,KO/TKO,100,24,25,149
Derrick Lewis,2023-02-04,Serghei Spivac,Submission,0,0,25,25
Derrick Lewis,2021-08-07,Ciryl Gane,KO/TKO,0,0,25,25
Derrick Lewis,2022-02-12,Tai Tuivasa,KO/TKO,0,3,0,3
Derrick Lewis,2021-02-20,Curtis Blaydes,KO/TKO,100,0,25,125
Derrick Lewis,2023-11-04,Jailton Almeida,Decision - Unanimous,0,0,25,25
Derrick Lewis,2017-02-19,Travis Browne,KO/TKO,100,18,25,143
Derrick Lewis,2020-08-08,Aleksei Oleinik,KO/TKO,100,33,25,158
Derrick Lewis,2014-04-19,Jack May,KO/TKO,100,17,0,117
Derrick Lewis,2018-07-07,Francis Ngannou,Decision - Unanimous,80,9,0,89
Derrick Lewis,2016-07-07,Roy Nelson,Decision - Split,70,33,0,103
Derrick Lewis,2024-05-11,Rodrigo Nascimento,KO/TKO,100,14,25,139
Derrick Lewis,2016-02-06,Damian Grabowski,KO/TKO,100,13,0,113
Derrick Lewis,2015-06-06,Shawn Jordan,KO/TKO,0,0,0,0
Derrick Lewis,2022-07-30,Sergei Pavlovich,KO/TKO,0,0,0,0
Derrick Lewis,2021-12-18,Chris Daukaus,KO/TKO,100,4,25,129
Derrick Lewis,2018-10-06,Alexander Volkov,KO/TKO,100,0,0,100
Derrick Lewis,2015-10-03,Viktor Pesta,KO/TKO,100,33,0,133
Derrick Lewis,2019-03-09,Junior Dos Santos,KO/TKO,0,0,25,25
Mario Bautista,2023-08-19,Da'Mon Blackshear,Decision - Unanimous,80,0,0,80
Mario Bautista,2019-01-19,Cory Sandhagen,Submission,0,0,0,0
Mario Bautista,2020-02-08,Miles Johns,KO/TKO,100,5,0,105
Mario Bautista,2021-03-06,Trevin Jones,KO/TKO,0,0,0,0
Mario Bautista,2024-01-13,Ricky Simon,Decision - Unanimous,80,67,0,147
Mario Bautista,2022-02-19,Jay Perrin,Decision - Unanimous,80,30,0,110
Mario Bautista,2024-10-05,Jose Aldo,Decision - Split,70,0,0,70
Mario Bautista,2023-03-11,Guido Cannetti,Submission,90,1,0,91
Mario Bautista,2022-11-05,Benito Lopez,Submission,90,27,0,117
Mario Bautista,2019-07-20,Jin Soo Son,Decision - Unanimous,80,34,0,114
Mario Bautista,2022-06-25,Brian Kelleher,Submission,90,4,0,94
Da'Mon Blackshear,2023-08-19,Mario Bautista,Decision - Unanimous,0,11,0,11
Da'Mon Blackshear,2023-03-04,Farid Basharat,Decision - Unanimous,0,0,0,0
Da'Mon Blackshear,2023-08-12,Jose Johnson,Submission,90,10,0,100
Da'Mon Blackshear,2023-06-03,Luan Lacerda,KO/TKO,100,38,0,138
Da'Mon Blackshear,2024-11-09,Cody Stamann,Submission,90,7,0,97
Da'Mon Blackshear,2024-07-13,Montel Jackson,KO/TKO,0,0,0,0
Dwight Grant,2019-02-23,Carlo Pedersoli Jr.,KO/TKO,100,3,0,103
Dwight Grant,2018-06-19,Tyler Hill,KO/TKO,100,12,0,112
Dwight Grant,2020-08-22,Daniel Rodriguez,KO/TKO,0,15,0,15
Dwight Grant,2021-04-24,Stefan Sekulic,Decision - Split,70,16,0,86
Dwight Grant,2018-12-15,Zak Ottow,Decision - Split,0,11,0,11
Dwight Grant,2022-07-16,Dustin Stoltzfus,Decision - Unanimous,0,3,0,3
Dwight Grant,2022-04-23,Sergey Khandozhko,KO/TKO,0,0,0,0
Dwight Grant,2019-04-13,Alan Jouban,Decision - Split,70,14,0,84
Dwight Grant,2021-10-23,Francisco Trinaldo,Decision - Split,0,0,0,0
Carlo Pedersoli Jr.,2019-02-23,Dwight Grant,KO/TKO,0,0,0,0
Carlo Pedersoli Jr.,2018-09-22,Alex Oliveira,KO/TKO,0,0,0,0
Carlo Pedersoli Jr.,2018-05-27,Brad Scott,Decision - Split,70,9,0,79
Jiri Prochazka,2022-06-11,Glover Teixeira,Submission,90,9,25,124
Jiri Prochazka,2024-04-13,Aleksandar Rakic,KO/TKO,100,11,0,111
Jiri Prochazka,2020-07-11,Volkan Oezdemir,KO/TKO,100,0,0,100
Jiri Prochazka,2024-06-29,Alex Pereira,KO/TKO,0,0,25,25
Jiri Prochazka,2023-11-11,Alex Pereira,KO/TKO,0,0,25,25
Jiri Prochazka,2021-05-01,Dominick Reyes,KO/TKO,100,14,25,139
Glover Teixeira,2022-06-11,Jiri Prochazka,Submission,0,0,25,25
Glover Teixeira,2017-12-16,Misha Cirkunov,KO/TKO,100,0,0,100
Glover Teixeira,2016-04-16,Rashad Evans,KO/TKO,100,0,25,125
Glover Teixeira,2014-04-26,Jon Jones,Decision - Unanimous,0,0,25,25
Glover Teixeira,2018-07-22,Corey Anderson,Decision - Unanimous,0,0,0,0
Glover Teixeira,2023-01-21,Jamahal Hill,Decision - Unanimous,0,0,25,25
Glover Teixeira,2016-08-20,Anthony Johnson,KO/TKO,0,0,0,0
Glover Teixeira,2019-04-27,Ion Cutelaba,Submission,90,0,0,90
Glover Teixeira,2012-05-26,Kyle Kingsbury,Submission,90,10,0,100
Glover Teixeira,2017-05-28,Alexander Gustafsson,KO/TKO,0,0,25,25
Glover Teixeira,2020-11-07,Thiago Santos,Submission,90,6,25,121
Glover Teixeira,2021-10-30,Jan Blachowicz,Submission,90,0,25,115
Glover Teixeira,2006-07-28,Jack Morrison,Submission,90,28,0,118
Glover Teixeira,2020-05-13,Anthony Smith,KO/TKO,100,52,25,177
Glover Teixeira,2013-09-04,Ryan Bader,KO/TKO,100,3,25,128
Glover Teixeira,2012-10-13,Fabio Maldonado,TKO - Doctor's Stoppage,0,75,0,75
Glover Teixeira,2013-01-26,Quinton Jackson,Decision - Unanimous,80,27,0,107
Glover Teixeira,2013-05-25,James Te Huna,Submission,90,4,0,94
Glover Teixeira,2019-01-19,Karl Roberson,Submission,90,0,0,90
Glover Teixeira,2006-05-05,Carlton Jones,KO/TKO,100,13,0,113
Glover Teixeira,2019-09-14,Nikita Krylov,Decision - Split,70,0,0,70
Glover Teixeira,2015-08-08,Ovince Saint Preux,Submission,90,23,25,138
Glover Teixeira,2015-11-07,Patrick Cummins,KO/TKO,100,21,0,121
Glover Teixeira,2017-02-11,Jared Cannonier,Decision - Unanimous,80,3,0,83
Glover Teixeira,2006-10-12,Rameau Thierry Sokoudjou,KO/TKO,100,2,0,102
Glover Teixeira,2014-10-25,Phil Davis,Decision - Unanimous,0,0,0,0
Fares Ziam,2022-09-03,Michal Figlak,Decision - Unanimous,80,32,0,112
Fares Ziam,2021-06-12,Luigi Vendramini,Decision - Majority,75,5,0,80
Fares Ziam,2024-09-28,Matt Frevola,KO/TKO,100,42,0,142
Fares Ziam,2022-02-26,Terrance McKinney,Submission,0,0,0,0
Fares Ziam,2023-07-22,Jai Herbert,Decision - Unanimous,80,12,0,92
Fares Ziam,2024-02-24,Claudio Puelles,Decision - Split,70,27,0,97
Fares Ziam,2019-09-07,Don Madge,Decision - Unanimous,0,0,0,0
Fares Ziam,2020-10-17,Jamie Mullarkey,Decision - Unanimous,80,27,0,107
Michal Figlak,2022-09-03,Fares Ziam,Decision - Unanimous,0,0,0,0
Michal Figlak,2024-04-27,Austin Hubbard,Decision - Unanimous,0,4,0,4
Ivan Salaverry,2005-08-06,Nate Marquardt,Decision - Unanimous,0,2,0,2
Ivan Salaverry,2002-09-27,Matt Lindland,Decision - Unanimous,0,16,0,16
Ivan Salaverry,2002-05-10,Andrei Semenov,KO/TKO,100,38,0,138
Ivan Salaverry,2006-07-22,Art Santore,KO/TKO,100,55,0,155
Ivan Salaverry,2005-04-16,Joe Riggs,Submission,90,0,0,90
Ivan Salaverry,2007-05-26,Terry Martin,KO/TKO,0,0,0,0
Ivan Salaverry,2004-10-22,Tony Fryklund,Submission,90,5,0,95
Ivan Salaverry,2008-05-24,Rousimar Palhares,Submission,0,1,0,1
Will Brooks,2017-11-18,Nik Lentz,Submission,0,15,0,15
Will Brooks,2012-12-31,Satoru Kitaoka,KO/TKO,100,53,0,153
Will Brooks,2017-04-08,Charles Oliveira,Submission,0,1,0,1
Will Brooks,2016-10-01,Alex Oliveira,KO/TKO,0,0,0,0
Will Brooks,2016-07-08,Ross Pearson,Decision - Unanimous,80,26,0,106
Randy Brown,2024-06-01,Elizeu Zaleski dos Santos,Decision - Unanimous,80,41,0,121
Randy Brown,2017-02-11,Belal Muhammad,Decision - Unanimous,0,0,0,0
Randy Brown,2019-11-16,Warlley Alves,Submission,90,13,0,103
Randy Brown,2017-11-04,Mickey Gall,Decision - Unanimous,80,34,0,114
Randy Brown,2021-10-09,Jared Gooden,Decision - Unanimous,80,34,0,114
Randy Brown,2024-02-03,Muslim Salikhov,KO/TKO,100,3,0,103
Randy Brown,2018-07-14,Niko Price,KO/TKO,0,1,0,1
Randy Brown,2016-04-16,Michael Graves,Submission,0,0,0,0
Randy Brown,2022-05-07,Khaos Williams,Decision - Split,70,18,0,88
Randy Brown,2022-10-01,Francisco Trinaldo,Decision - Unanimous,80,20,0,100
Randy Brown,2024-12-07,Bryan Battle,Decision - Split,0,3,0,3
Randy Brown,2021-04-24,Alex Oliveira,Submission,90,9,0,99
Randy Brown,2023-02-11,Jack Della Maddalena,Submission,0,0,0,0
Randy Brown,2023-06-24,Wellington Turman,Decision - Unanimous,80,9,0,89
Randy Brown,2019-06-22,Bryan Barberena,KO/TKO,100,42,0,142
Randy Brown,2016-09-17,Erick Montano,Submission,90,0,0,90
Randy Brown,2020-08-01,Vicente Luque,KO/TKO,0,0,0,0
Randy Brown,2016-01-30,Matt Dwyer,Decision - Unanimous,80,2,0,82
Randy Brown,2016-12-09,Brian Camozzi,KO/TKO,100,31,0,131
Elizeu Zaleski dos Santos,2024-06-01,Randy Brown,Decision - Unanimous,0,0,0,0
Elizeu Zaleski dos Santos,2021-10-30,Benoit Saint Denis,Decision - Unanimous,80,82,0,162
Elizeu Zaleski dos Santos,2020-07-11,Muslim Salikhov,Decision - Split,0,6,0,6
Elizeu Zaleski dos Santos,2024-11-09,Zachary Scroggin,KO/TKO,100,8,0,108
Elizeu Zaleski dos Santos,2023-06-03,Abubakar Nurmagomedov,Decision - Split,70,13,0,83
Elizeu Zaleski dos Santos,2020-03-14,Aleksei Kunchenko,Decision - Unanimous,80,5,0,85
Elizeu Zaleski dos Santos,2017-10-28,Max Griffin,Decision - Unanimous,80,33,0,113
Elizeu Zaleski dos Santos,2016-10-01,Keita Nakamura,Decision - Unanimous,80,10,0,90
Elizeu Zaleski dos Santos,2016-04-16,Omari Akhmedov,KO/TKO,100,36,0,136
Elizeu Zaleski dos Santos,2015-05-30,Nicolas Dalby,Decision - Split,0,16,0,16
Elizeu Zaleski dos Santos,2019-03-09,Curtis Millender,Submission,90,6,0,96
Elizeu Zaleski dos Santos,2018-05-12,Sean Strickland,KO/TKO,100,1,0,101
Elizeu Zaleski dos Santos,2017-07-22,Lyman Good,Decision - Split,70,8,0,78
Elizeu Zaleski dos Santos,2019-08-31,Li Jingliang,KO/TKO,0,0,0,0
Elizeu Zaleski dos Santos,2018-09-22,Luigi Vendramini,KO/TKO,100,11,0,111
Nick Catone,2009-08-29,Mark Munoz,Decision - Split,0,0,0,0
Nick Catone,2012-06-22,Chris Camozzi,TKO - Doctor's Stoppage,0,0,0,0
Nick Catone,2010-01-11,Jesse Forbes,Decision - Split,70,0,0,70
Nick Catone,2009-04-01,Tim Credeur,Submission,0,10,0,10
Nick Catone,2014-02-01,Tom Watson,Decision - Split,70,0,0,70
Nick Catone,2012-12-15,TJ Waldburger,Submission,0,0,0,0
Nick Catone,2011-03-19,Constantinos Philippou,Decision - Unanimous,80,8,0,88
Nick Catone,2009-02-07,Derek Downey,Submission,90,19,0,109
Montana De La Rosa,2019-02-09,Nadia Kassem,Submission,90,16,0,106
Montana De La Rosa,2017-12-01,Christina Marks,Submission,90,0,0,90
Montana De La Rosa,2023-10-07,JJ Aldrich,Decision - Unanimous,0,2,0,2
Montana De La Rosa,2018-07-06,Rachael Ostovich,Submission,90,16,0,106
Montana De La Rosa,2024-06-08,Andrea Lee,Decision - Split,70,0,0,70
Montana De La Rosa,2022-04-23,Maycee Barber,Decision - Unanimous,0,0,0,0
Montana De La Rosa,2020-02-15,Mara Romero Borella,Decision - Unanimous,80,4,0,84
Montana De La Rosa,2020-09-05,Viviane Araujo,Decision - Unanimous,0,3,0,3
Montana De La Rosa,2023-02-25,Tatiana Suarez,Submission,0,0,0,0
Montana De La Rosa,2021-06-05,Ariane da Silva,KO/TKO,100,18,0,118
Montana De La Rosa,2019-06-22,Andrea Lee,Decision - Unanimous,0,0,0,0
Nadia Kassem,2019-02-09,Montana De La Rosa,Submission,0,0,0,0
Nadia Kassem,2019-10-05,Ji Yeon Kim,KO/TKO,0,0,0,0
Nadia Kassem,2017-11-18,Alex Chambers,Decision - Unanimous,80,7,0,87
Joshua Van,2024-01-13,Felipe Bunes,KO/TKO,100,33,0,133
Joshua Van,2024-09-14,Edgar Chairez,Decision - Unanimous,80,39,0,119
Joshua Van,2024-12-07,Cody Durden,Decision - Unanimous,80,95,0,175
Joshua Van,2023-06-24,Zhalgas Zhumagulov,Decision - Split,70,17,0,87
Joshua Van,2023-11-11,Kevin Borjas,Decision - Unanimous,80,81,0,161
Joshua Van,2024-07-13,Charles Johnson,KO/TKO,0,0,0,0
Felipe Bunes,2024-01-13,Joshua Van,KO/TKO,0,0,0,0
Lavar Johnson,2012-01-28,Joey Beltran,KO/TKO,100,43,0,143
Lavar Johnson,2009-05-15,Carl Seumanutafa,KO/TKO,100,1,0,101
Lavar Johnson,2012-05-05,Pat Barry,KO/TKO,100,24,0,124
Lavar Johnson,2012-05-26,Stefan Struve,Submission,0,4,0,4
Lavar Johnson,2010-03-26,Lolohea Mahe,KO/TKO,100,43,0,143
Lavar Johnson,2011-02-12,Shane del Rosario,Submission,0,0,0,0
Lavar Johnson,2013-02-23,Brendan Schaub,Decision - Unanimous,0,18,0,18
Lavar Johnson,2010-10-22,Virgil Zwicker,KO/TKO,100,7,0,107
Lavar Johnson,2011-09-23,Shawn Jordan,Submission,0,13,0,13
Paulo Filho,2006-11-05,Kazuo Misaki,Submission,90,22,0,112
Paulo Filho,2004-07-19,Akira Shoji,Decision - Split,70,23,0,93
Paulo Filho,2006-08-27,Ryo Chonan,Submission,90,3,0,93
Paulo Filho,2006-04-02,Murilo Rua,Decision - Unanimous,80,26,0,106
Paulo Filho,2007-12-12,Chael Sonnen,Submission,90,0,25,115
Paulo Filho,2007-08-05,Joe Doerksen,KO/TKO,100,10,25,135
Paulo Filho,2009-07-20,Melvin Manhoef,Submission,90,0,0,90
Paulo Filho,2002-09-29,Akira Shoji,Submission,90,9,0,99
Paulo Filho,2005-09-25,Ryuta Sakurai,Submission,90,2,0,92
Paulo Filho,2008-11-05,Chael Sonnen,Decision - Unanimous,0,0,0,0
Paulo Filho,2005-04-03,Amar Suloev,Submission,90,4,0,94
Paulo Filho,2006-06-04,Gregory Bouchelaghem,Decision - Unanimous,80,19,0,99
Kazuo Misaki,2006-11-05,Paulo Filho,Submission,0,0,0,0
Kazuo Misaki,2005-07-17,Daniel Acacio,Decision - Unanimous,0,0,0,0
Kazuo Misaki,2006-11-05,Denis Kang,Decision - Split,70,0,0,70
Kazuo Misaki,2009-12-31,Melvin Manhoef,KO/TKO,0,0,0,0
Kazuo Misaki,2012-03-03,Paul Daley,Decision - Split,70,0,0,70
Kazuo Misaki,2006-06-04,Phil Baroni,Decision - Unanimous,80,19,0,99
Kazuo Misaki,2004-05-23,Jorge Patino,Decision - Unanimous,80,11,0,91
Kazuo Misaki,2008-09-20,Joe Riggs,KO/TKO,100,11,0,111
Kazuo Misaki,2007-02-24,Frank Trigg,Decision - Unanimous,0,0,0,0
Kazuo Misaki,2006-04-02,Dan Henderson,Decision - Unanimous,0,0,0,0
Kazuo Misaki,2006-08-27,Dan Henderson,Decision - Unanimous,80,34,0,114
Paulo Thiago,2009-02-21,Josh Koscheck,KO/TKO,100,0,0,100
Paulo Thiago,2012-11-10,Dong Hyun Kim,Decision - Unanimous,0,0,0,0
Paulo Thiago,2014-05-31,Gasan Umalatov,Decision - Unanimous,0,18,0,18
Paulo Thiago,2014-09-13,Sean Spencer,Decision - Unanimous,0,0,0,0
Paulo Thiago,2013-11-09,Brandon Thatch,KO/TKO,0,0,0,0
Paulo Thiago,2011-08-27,David Mitchell,Decision - Unanimous,80,0,0,80
Paulo Thiago,2012-04-14,Siyar Bahadurzada,KO/TKO,0,0,0,0
Paulo Thiago,2009-11-21,Jacob Volkmann,Decision - Unanimous,80,18,0,98
Paulo Thiago,2010-10-23,Diego Sanchez,Decision - Unanimous,0,0,0,0
Paulo Thiago,2010-02-06,Mike Swick,Submission,90,2,0,92
Paulo Thiago,2009-07-11,Jon Fitch,Decision - Unanimous,0,0,0,0
Paulo Thiago,2013-05-18,Michel Prazeres,Decision - Unanimous,80,16,0,96
Paulo Thiago,2010-06-12,Martin Kampmann,Decision - Unanimous,0,0,0,0
Dennis Hallman,2011-12-10,John Makdessi,Submission,90,20,0,110
Dennis Hallman,2001-09-28,Jens Pulver,Decision - Unanimous,0,0,25,25
Dennis Hallman,2010-08-07,Ben Saunders,Decision - Unanimous,80,0,0,80
Dennis Hallman,2000-12-16,Matt Hughes,Submission,90,0,0,90
Dennis Hallman,2011-08-06,Brian Ebersole,KO/TKO,0,0,0,0
Dennis Hallman,2004-06-19,Frank Trigg,KO/TKO,0,0,0,0
Dennis Hallman,2010-11-20,Karo Parisyan,KO/TKO,100,8,0,108
Dennis Hallman,2009-12-05,John Howard,KO/TKO,0,0,0,0
Dennis Hallman,2005-10-07,Jorge Rivera,Decision - Unanimous,0,0,0,0
John Makdessi,2011-12-10,Dennis Hallman,Submission,0,0,0,0
John Makdessi,2020-03-14,Francisco Trinaldo,Decision - Unanimous,0,12,0,12
John Makdessi,2013-09-21,Renee Forte,KO/TKO,100,13,0,113
John Makdessi,2019-03-23,Jesus Pinedo,Decision - Unanimous,80,36,0,116
John Makdessi,2010-12-11,Pat Audinwood,Decision - Unanimous,80,55,0,135
John Makdessi,2015-05-23,Donald Cerrone,KO/TKO,0,1,0,1
John Makdessi,2014-02-01,Alan Patrick,Decision - Unanimous,0,21,0,21
John Makdessi,2017-12-16,Abel Trujillo,Decision - Unanimous,80,18,0,98
John Makdessi,2022-09-03,Nasrat Haqparast,Decision - Unanimous,0,9,0,9
John Makdessi,2021-04-10,Ignacio Bahamondes,Decision - Split,70,12,0,82
John Makdessi,2011-04-30,Kyle Watson,KO/TKO,100,25,0,125
John Makdessi,2016-07-07,Mehdi Baghdad,Decision - Split,70,24,0,94
John Makdessi,2012-11-17,Sam Stout,Decision - Unanimous,80,21,0,101
John Makdessi,2018-07-28,Ross Pearson,Decision - Unanimous,80,52,0,132
John Makdessi,2012-04-21,Anthony Njokuani,Decision - Unanimous,0,0,0,0
John Makdessi,2015-04-25,Shane Campbell,KO/TKO,100,22,0,122
John Makdessi,2013-03-16,Daron Cruickshank,Decision - Unanimous,80,35,0,115
John Makdessi,2023-09-09,Jamie Mullarkey,Decision - Unanimous,0,0,0,0
John Makdessi,2016-12-10,Lando Vannata,KO/TKO,0,1,0,1
John Makdessi,2015-12-12,Yancy Medeiros,Decision - Split,0,34,0,34
Dhiego Lima,2019-10-05,Luke Jumeau,Decision - Split,70,8,0,78
Dhiego Lima,2014-11-08,Jorge de Oliveira,Decision - Unanimous,80,47,0,127
Dhiego Lima,2018-12-08,Chad Laprise,KO/TKO,100,0,0,100
Dhiego Lima,2021-02-13,Belal Muhammad,Decision - Unanimous,0,0,0,0
Dhiego Lima,2019-04-27,Court McGee,Decision - Split,70,0,0,70
Dhiego Lima,2017-07-07,Jesse Taylor,Submission,0,0,0,0
Dhiego Lima,2018-04-14,Yushin Okami,Decision - Unanimous,0,0,0,0
Dhiego Lima,2021-06-19,Matt Brown,KO/TKO,0,0,0,0
Dhiego Lima,2015-02-28,Tim Means,KO/TKO,0,0,0,0
Dhiego Lima,2014-07-06,Eddie Gordon,KO/TKO,0,0,0,0
Dhiego Lima,2015-05-16,Li Jingliang,KO/TKO,0,0,0,0
Luke Jumeau,2019-10-05,Dhiego Lima,Decision - Split,0,0,0,0
Luke Jumeau,2017-09-22,Shinsho Anzai,Decision - Unanimous,0,0,0,0
Luke Jumeau,2017-06-10,Dominique Steele,Decision - Unanimous,80,0,0,80
Luke Jumeau,2018-02-10,Daichi Abe,Decision - Unanimous,80,0,0,80
Jack Hermansson,2020-07-18,Kelvin Gastelum,Submission,90,2,0,92
Jack Hermansson,2019-04-27,Jacare Souza,Decision - Unanimous,80,58,25,163
Jack Hermansson,2016-09-03,Scott Askham,Decision - Unanimous,80,51,0,131
Jack Hermansson,2022-12-03,Roman Dolidze,KO/TKO,0,22,0,22
Jack Hermansson,2017-08-05,Brad Scott,KO/TKO,100,38,0,138
Jack Hermansson,2019-03-30,David Branch,Submission,90,2,0,92
Jack Hermansson,2018-12-15,Gerald Meerschaert,Submission,90,40,0,130
Jack Hermansson,2022-07-23,Chris Curtis,Decision - Unanimous,80,57,0,137
Jack Hermansson,2021-05-22,Edmen Shahbazyan,Decision - Unanimous,80,15,0,95
Jack Hermansson,2022-02-05,Sean Strickland,Decision - Split,0,0,25,25
Jack Hermansson,2019-09-28,Jared Cannonier,KO/TKO,0,0,25,25
Jack Hermansson,2024-02-10,Joe Pyfer,Decision - Unanimous,80,29,25,134
Jack Hermansson,2020-12-05,Marvin Vettori,Decision - Unanimous,0,0,25,25
Jack Hermansson,2017-10-28,Thiago Santos,KO/TKO,0,0,0,0
Jack Hermansson,2017-05-28,Alex Nicholson,KO/TKO,100,22,0,122
Jack Hermansson,2016-11-19,Cezar Ferreira,Submission,0,4,0,4
Jack Hermansson,2018-05-12,Thales Leites,KO/TKO,100,24,0,124
Kelvin Gastelum,2020-07-18,Jack Hermansson,Submission,0,0,0,0
Kelvin Gastelum,2021-04-17,Robert Whittaker,Decision - Unanimous,0,0,25,25
Kelvin Gastelum,2021-08-21,Jared Cannonier,Decision - Unanimous,0,8,25,33
Kelvin Gastelum,2013-04-13,Uriah Hall,Decision - Split,70,0,0,70
Kelvin Gastelum,2013-08-28,Brian Melancon,Submission,90,7,0,97
Kelvin Gastelum,2015-06-13,Nate Marquardt,KO/TKO,100,41,0,141
Kelvin Gastelum,2018-05-12,Jacare Souza,Decision - Split,70,0,0,70
Kelvin Gastelum,2015-01-31,Tyron Woodley,Decision - Split,0,5,0,5
Kelvin Gastelum,2015-11-21,Neil Magny,Decision - Split,0,0,25,25
Kelvin Gastelum,2023-04-08,Chris Curtis,Decision - Unanimous,80,13,0,93
Kelvin Gastelum,2019-04-13,Israel Adesanya,Decision - Unanimous,0,0,25,25
Kelvin Gastelum,2024-06-22,Daniel Rodriguez,Decision - Unanimous,80,0,0,80
Kelvin Gastelum,2016-07-09,Johny Hendricks,Decision - Unanimous,80,54,0,134
Kelvin Gastelum,2019-11-02,Darren Till,Decision - Split,0,4,0,4
Kelvin Gastelum,2017-07-22,Chris Weidman,Submission,0,0,25,25
Kelvin Gastelum,2014-03-15,Rick Story,Decision - Split,70,14,0,84
Kelvin Gastelum,2023-12-02,Sean Brady,Submission,0,4,0,4
Kelvin Gastelum,2017-11-25,Michael Bisping,KO/TKO,100,7,25,132
Kelvin Gastelum,2021-02-13,Ian Heinisch,Decision - Unanimous,80,11,0,91
Kelvin Gastelum,2014-11-15,Jake Ellenberger,Submission,90,6,0,96
Kelvin Gastelum,2014-06-28,Nicholas Musoke,Decision - Unanimous,80,31,0,111
Kelvin Gastelum,2016-12-10,Tim Kennedy,KO/TKO,100,17,0,117
Francis Ngannou,2020-05-09,Jairzinho Rozenstruik,KO/TKO,100,1,0,101
Francis Ngannou,2015-12-19,Luis Henrique,KO/TKO,100,20,0,120
Francis Ngannou,2022-01-22,Ciryl Gane,Decision - Unanimous,80,0,25,105
Francis Ngannou,2021-03-27,Stipe Miocic,KO/TKO,100,24,25,149
Francis Ngannou,2017-01-28,Andrei Arlovski,KO/TKO,100,5,0,105
Francis Ngannou,2016-07-23,Bojan Mihajlovic,KO/TKO,100,5,0,105
Francis Ngannou,2018-07-07,Derrick Lewis,Decision - Unanimous,0,0,0,0
Francis Ngannou,2016-04-10,Curtis Blaydes,TKO - Doctor's Stoppage,0,12,0,12
Francis Ngannou,2018-01-20,Stipe Miocic,Decision - Unanimous,0,0,25,25
Francis Ngannou,2019-06-29,Junior Dos Santos,KO/TKO,100,5,25,130
Francis Ngannou,2017-12-02,Alistair Overeem,KO/TKO,100,5,0,105
Francis Ngannou,2018-11-24,Curtis Blaydes,KO/TKO,100,12,25,137
Francis Ngannou,2016-12-09,Anthony Hamilton,Submission,90,1,0,91
Francis Ngannou,2019-02-17,Cain Velasquez,KO/TKO,100,5,25,130
Jairzinho Rozenstruik,2020-05-09,Francis Ngannou,KO/TKO,0,0,0,0
Jairzinho Rozenstruik,2021-09-25,Curtis Blaydes,Decision - Unanimous,0,0,0,0
Jairzinho Rozenstruik,2019-12-07,Alistair Overeem,KO/TKO,100,15,25,140
Jairzinho Rozenstruik,2019-06-22,Allen Crowder,KO/TKO,100,4,0,104
Jairzinho Rozenstruik,2024-08-17,Tai Tuivasa,Decision - Split,70,54,0,124
Jairzinho Rozenstruik,2020-08-15,Junior Dos Santos,KO/TKO,100,18,0,118
Jairzinho Rozenstruik,2019-11-02,Andrei Arlovski,KO/TKO,100,1,0,101
Jairzinho Rozenstruik,2024-03-02,Shamil Gaziev,KO/TKO,100,105,25,230
Jairzinho Rozenstruik,2022-06-04,Alexander Volkov,KO/TKO,0,0,25,25
Jairzinho Rozenstruik,2023-05-13,Jailton Almeida,Submission,0,0,25,25
Jairzinho Rozenstruik,2021-02-27,Ciryl Gane,Decision - Unanimous,0,0,25,25
Jairzinho Rozenstruik,2019-02-02,Junior Albini,KO/TKO,100,1,0,101
Jairzinho Rozenstruik,2021-06-05,Augusto Sakai,KO/TKO,100,13,25,138
Jairzinho Rozenstruik,2022-12-10,Chris Daukaus,KO/TKO,100,11,0,111
Josiane Nunes,2023-01-21,Zarah Fairn,Decision - Unanimous,80,0,0,80
Josiane Nunes,2022-02-26,Ramona Pascual,Decision - Unanimous,80,46,0,126
Josiane Nunes,2021-08-21,Bea Malecki,KO/TKO,100,17,0,117
Josiane Nunes,2024-08-24,Jacqueline Cavalcanti,Decision - Split,0,0,0,0
Josiane Nunes,2024-03-16,Chelsea Chandler,Decision - Unanimous,0,0,0,0
Zarah Fairn,2023-01-21,Josiane Nunes,Decision - Unanimous,0,15,0,15
Zarah Fairn,2019-10-05,Megan Anderson,Submission,0,0,0,0
Zarah Fairn,2020-02-29,Felicia Spencer,KO/TKO,0,0,0,0
Zarah Fairn,2023-09-02,Jacqueline Cavalcanti,Decision - Unanimous,0,0,0,0
Mark Hall,1995-09-08,Harold Howard,KO/TKO,100,0,0,100
Mark Hall,1996-12-07,Don Frye,Submission,0,0,0,0
Mark Hall,1996-07-12,Don Frye,KO/TKO,0,0,0,0
Mark Hall,1995-09-08,Paul Varelans,Submission,0,0,0,0
Mark Hall,1996-05-17,Koji Kitao,TKO - Doctor's Stoppage,0,2,0,2
Harold Howard,1995-09-08,Mark Hall,KO/TKO,0,3,0,3
Harold Howard,1994-09-09,Roland Payne,KO/TKO,100,6,0,106
Harold Howard,1994-09-09,Steve Jennum,KO/TKO,0,0,0,0
Rich Franklin,2009-06-13,Wanderlei Silva,Decision - Unanimous,80,14,0,94
Rich Franklin,2009-09-19,Vitor Belfort,KO/TKO,0,0,0,0
Rich Franklin,2004-12-12,Curtis Stout,KO/TKO,100,15,0,115
Rich Franklin,2007-06-16,Yushin Okami,Decision - Unanimous,80,19,0,99
Rich Franklin,2011-02-05,Forrest Griffin,Decision - Unanimous,0,0,0,0
Rich Franklin,2009-01-17,Dan Henderson,Decision - Split,0,3,0,3
Rich Franklin,2008-09-06,Matt Hamill,KO/TKO,100,58,0,158
Rich Franklin,2005-04-09,Ken Shamrock,KO/TKO,100,23,0,123
Rich Franklin,2004-10-22,Jorge Rivera,Submission,90,19,0,109
Rich Franklin,2003-04-25,Evan Tanner,KO/TKO,100,10,0,110
Rich Franklin,2005-06-04,Evan Tanner,TKO - Doctor's Stoppage,0,72,25,97
Rich Franklin,2000-06-29,Dennis Reed,Submission,90,0,0,90
Rich Franklin,2010-06-12,Chuck Liddell,KO/TKO,100,7,0,107
Rich Franklin,2004-07-14,Ralph Dillon,Submission,90,1,0,91
Rich Franklin,2006-10-14,Anderson Silva,KO/TKO,0,0,25,25
Rich Franklin,2002-06-15,Yan Pellerin,Submission,90,1,0,91
Rich Franklin,2008-04-19,Travis Lutter,KO/TKO,100,27,0,127
Rich Franklin,2004-04-16,Leo Sylvest,KO/TKO,100,8,0,108
Rich Franklin,2001-11-03,Marvin Eastman,Submission,90,1,0,91
Rich Franklin,2003-12-31,Lyoto Machida,KO/TKO,0,0,0,0
Rich Franklin,2007-10-20,Anderson Silva,KO/TKO,0,0,25,25
Rich Franklin,2002-09-17,Antony Rea,KO/TKO,100,7,0,107
Rich Franklin,2007-03-03,Jason MacDonald,KO/TKO,100,33,0,133
Rich Franklin,2005-11-19,Nate Quarry,KO/TKO,100,9,25,134
Rich Franklin,2012-06-23,Wanderlei Silva,Decision - Unanimous,80,64,25,169
Rich Franklin,2012-11-10,Cung Le,KO/TKO,0,4,25,29
Rich Franklin,2003-09-26,Edwin DeWees,KO/TKO,100,33,0,133
Rich Franklin,2006-03-04,David Loiseau,Decision - Unanimous,80,106,25,211
Wanderlei Silva,2009-06-13,Rich Franklin,Decision - Unanimous,0,0,0,0
Wanderlei Silva,2005-06-26,Kazuhiro Nakamura,KO/TKO,100,21,0,121
Wanderlei Silva,2003-11-09,Hidehiko Yoshida,Decision - Unanimous,80,22,0,102
Wanderlei Silva,2013-03-02,Brian Stann,KO/TKO,100,0,25,125
Wanderlei Silva,1999-09-12,Carl Malenko,Decision - Unanimous,80,23,0,103
Wanderlei Silva,2004-12-31,Mark Hunt,Decision - Split,0,0,0,0
Wanderlei Silva,2001-05-27,Shungo Oyama,KO/TKO,100,2,0,102
Wanderlei Silva,1999-05-07,Tony Petarra,KO/TKO,100,21,0,121
Wanderlei Silva,2002-11-24,Hiromitsu Kanehara,KO/TKO,100,23,0,123
Wanderlei Silva,2008-12-27,Quinton Jackson,KO/TKO,0,0,0,0
Wanderlei Silva,1999-11-21,Daijiro Matsui,Decision,0,39,0,39
Wanderlei Silva,2003-11-09,Quinton Jackson,KO/TKO,100,15,0,115
Wanderlei Silva,2004-10-31,Quinton Jackson,KO/TKO,100,17,0,117
Wanderlei Silva,2002-02-24,Kiyoshi Tamura,KO/TKO,100,19,0,119
Wanderlei Silva,2000-08-27,Guy Mezger,KO/TKO,100,9,0,109
Wanderlei Silva,2007-02-24,Dan Henderson,KO/TKO,0,0,25,25
Wanderlei Silva,2000-01-30,Bob Schrijber,Submission,90,10,0,100
Wanderlei Silva,2004-02-15,Ikuhisa Minowa,KO/TKO,100,6,0,106
Wanderlei Silva,2000-12-09,Dan Henderson,Decision - Unanimous,80,45,0,125
Wanderlei Silva,2005-12-31,Ricardo Arona,Decision - Split,70,8,0,78
Wanderlei Silva,2008-05-24,Keith Jardine,KO/TKO,100,10,0,110
Wanderlei Silva,2005-08-28,Ricardo Arona,Decision - Unanimous,0,0,0,0
Wanderlei Silva,2004-08-15,Yuki Kondo,KO/TKO,100,11,0,111
Wanderlei Silva,2006-07-01,Kazuyuki Fujita,KO/TKO,100,25,0,125
Wanderlei Silva,2011-07-02,Chris Leben,KO/TKO,0,0,0,0
Wanderlei Silva,1998-10-16,Vitor Belfort,KO/TKO,0,0,0,0
Wanderlei Silva,2011-11-19,Cung Le,KO/TKO,100,11,0,111
Wanderlei Silva,2007-12-29,Chuck Liddell,Decision - Unanimous,0,0,0,0
Wanderlei Silva,2002-08-28,Tatsuya Iwasaki,KO/TKO,100,10,0,110
Wanderlei Silva,2001-11-03,Kazushi Sakuraba,TKO - Doctor's Stoppage,0,13,0,13
Wanderlei Silva,2001-03-25,Kazushi Sakuraba,KO/TKO,100,23,0,123
Wanderlei Silva,2005-04-23,Hidehiko Yoshida,Decision - Split,70,35,0,105
Wanderlei Silva,2003-08-10,Kazushi Sakuraba,KO/TKO,100,7,0,107
Wanderlei Silva,2010-02-20,Michael Bisping,Decision - Unanimous,80,10,0,90
Wanderlei Silva,2012-06-23,Rich Franklin,Decision - Unanimous,0,0,25,25
Wanderlei Silva,2001-12-23,Alexander Otsuka,TKO - Doctor's Stoppage,0,34,0,34
Wanderlei Silva,2006-09-10,Mirko Filipovic,KO/TKO,0,0,0,0
Wanderlei Silva,2000-04-14,Tito Ortiz,Decision - Unanimous,0,0,25,25
Jaime Alvarez,2017-08-15,Martin Day,Decision - Unanimous,80,0,0,80
Martin Day,2017-08-15,Jaime Alvarez,Decision - Unanimous,0,27,0,27
Martin Day,2021-02-06,Timur Valiev,Decision - Unanimous,0,0,0,0
Martin Day,2020-07-11,Davey Grant,KO/TKO,0,0,0,0
Martin Day,2018-11-24,Pingyuan Liu,Decision - Split,0,45,0,45
Martin Day,2020-11-28,Anderson Dos Santos,Submission,0,0,0,0
Stephen Thompson,2014-09-27,Patrick Cote,Decision - Unanimous,80,11,0,91
Stephen Thompson,2017-03-04,Tyron Woodley,Decision - Majority,0,0,25,25
Stephen Thompson,2018-05-27,Darren Till,Decision - Unanimous,0,0,25,25
Stephen Thompson,2020-12-19,Geoff Neal,Decision - Unanimous,80,86,25,191
Stephen Thompson,2012-04-21,Matt Brown,Decision - Unanimous,0,31,0,31
Stephen Thompson,2014-02-22,Robert Whittaker,KO/TKO,100,19,0,119
Stephen Thompson,2013-09-21,Chris Clements,KO/TKO,100,6,0,106
Stephen Thompson,2013-05-25,Nah-Shon Burrell,Decision - Unanimous,80,9,0,89
Stephen Thompson,2022-12-03,Kevin Holland,KO/TKO,100,44,25,169
Stephen Thompson,2021-12-18,Belal Muhammad,Decision - Unanimous,0,0,0,0
Stephen Thompson,2021-07-10,Gilbert Burns,Decision - Unanimous,0,0,0,0
Stephen Thompson,2017-11-04,Jorge Masvidal,Decision - Unanimous,80,28,0,108
Stephen Thompson,2016-06-18,Rory MacDonald,Decision - Unanimous,80,49,25,154
Stephen Thompson,2024-10-05,Joaquin Buckley,KO/TKO,0,15,0,15
Stephen Thompson,2019-03-23,Anthony Pettis,KO/TKO,0,15,25,40
Stephen Thompson,2015-07-12,Jake Ellenberger,KO/TKO,100,15,25,140
Stephen Thompson,2012-02-04,Dan Stittgen,KO/TKO,100,14,0,114
Stephen Thompson,2016-02-06,Johny Hendricks,KO/TKO,100,17,25,142
Stephen Thompson,2019-11-02,Vicente Luque,Decision - Unanimous,80,61,0,141
Stephen Thompson,2023-12-16,Shavkat Rakhmonov,Submission,0,0,0,0
Patrick Cote,2014-09-27,Stephen Thompson,Decision - Unanimous,0,0,0,0
Patrick Cote,2007-02-03,Scott Smith,Decision - Unanimous,80,16,0,96
Patrick Cote,2008-01-23,Drew McFedries,KO/TKO,100,6,0,106
Patrick Cote,2013-03-16,Bobby Voelker,Decision - Unanimous,80,0,0,80
Patrick Cote,2007-08-25,Kendall Grove,KO/TKO,100,8,0,108
Patrick Cote,2007-06-01,Jason Day,KO/TKO,100,2,25,127
Patrick Cote,2006-11-11,Travis Lutter,Submission,0,0,0,0
Patrick Cote,2016-01-17,Ben Saunders,KO/TKO,100,31,0,131
Patrick Cote,2017-04-08,Thiago Alves,Decision - Unanimous,0,0,0,0
Patrick Cote,2004-05-22,Bill Mahood,KO/TKO,100,4,0,104
Patrick Cote,2004-10-22,Tito Ortiz,Decision - Unanimous,0,0,0,0
Patrick Cote,2012-11-17,Alessio Sakara,DQ,0,0,0,0
Patrick Cote,2010-10-23,Tom Lawlor,Decision - Unanimous,0,0,0,0
Patrick Cote,2008-07-05,Ricardo Almeida,Decision - Split,70,0,0,70
Patrick Cote,2012-07-07,Cung Le,Decision - Unanimous,0,0,0,0
Patrick Cote,2015-04-25,Joe Riggs,Decision - Unanimous,80,0,0,80
Patrick Cote,2016-06-18,Donald Cerrone,KO/TKO,0,0,0,0
Patrick Cote,2015-08-23,Joshua Burkman,KO/TKO,100,15,0,115
Patrick Cote,2010-05-08,Alan Belcher,Submission,0,0,0,0
Patrick Cote,2005-08-06,Chris Leben,Decision - Split,0,0,0,0
Patrick Cote,2003-11-29,Steve Vigneault,KO/TKO,100,6,0,106
Patrick Cote,2008-10-25,Anderson Silva,KO/TKO,0,0,25,25
Patrick Cote,2014-04-16,Kyle Noke,Decision - Unanimous,80,0,0,80
Patrick Cote,2005-04-16,Joe Doerksen,Submission,0,28,0,28
Shamil Gaziev,2023-12-16,Martin Buday,KO/TKO,100,41,0,141
Shamil Gaziev,2023-09-19,Greg Velasco,Submission,90,4,0,94
Shamil Gaziev,2024-03-02,Jairzinho Rozenstruik,KO/TKO,0,0,25,25
Shamil Gaziev,2024-08-03,Don'Tale Mayes,Decision - Unanimous,80,4,0,84
Martin Buday,2023-12-16,Shamil Gaziev,KO/TKO,0,0,0,0
Martin Buday,2023-08-12,Josh Parisian,Submission,90,16,0,106
Martin Buday,2022-08-13,Lukasz Brzeski,Decision - Split,70,0,0,70
Martin Buday,2023-04-29,Jake Collier,Decision - Unanimous,80,4,0,84
Martin Buday,2024-06-29,Andrei Arlovski,Decision - Split,70,0,0,70
Martin Buday,2021-10-12,Lorenzo Hood,KO/TKO,100,10,0,110
Martin Buday,2022-04-16,Chris Barnett,Decision - Unanimous,80,33,0,113
Jalin Turner,2022-03-05,Jamie Mullarkey,KO/TKO,100,17,0,117
Jalin Turner,2023-03-04,Mateusz Gamrot,Decision - Split,0,11,0,11
Jalin Turner,2020-09-12,Brok Weaver,Submission,90,10,0,100
Jalin Turner,2023-07-08,Dan Hooker,Decision - Split,0,0,0,0
Jalin Turner,2022-07-02,Brad Riddell,Submission,90,1,0,91
Jalin Turner,2018-07-10,Max Mustaki,TKO - Doctor's Stoppage,0,24,0,24
Jalin Turner,2021-09-25,Uros Medic,Submission,90,19,0,109
Jalin Turner,2018-10-06,Vicente Luque,KO/TKO,0,0,0,0
Jalin Turner,2019-04-13,Matt Frevola,Decision - Unanimous,0,4,0,4
Jalin Turner,2024-04-13,Renato Moicano,KO/TKO,0,0,0,0
Jalin Turner,2019-02-09,Callan Potter,KO/TKO,100,6,0,106
Jalin Turner,2023-12-02,Bobby Green,KO/TKO,100,18,0,118
Jalin Turner,2020-02-22,Josh Culibao,KO/TKO,100,43,0,143
Jamie Mullarkey,2022-03-05,Jalin Turner,KO/TKO,0,0,0,0
Jamie Mullarkey,2021-10-02,Devonte Smith,KO/TKO,100,26,0,126
Jamie Mullarkey,2024-05-04,Mauricio Ruffy,KO/TKO,0,0,0,0
Jamie Mullarkey,2023-06-03,Muhammad Naimov,KO/TKO,0,11,0,11
Jamie Mullarkey,2023-12-09,Nasrat Haqparast,KO/TKO,0,0,0,0
Jamie Mullarkey,2023-02-11,Francisco Prado,Decision - Unanimous,80,31,0,111
Jamie Mullarkey,2022-07-09,Michael Johnson,Decision - Split,70,30,0,100
Jamie Mullarkey,2019-10-05,Brad Riddell,Decision - Unanimous,0,0,0,0
Jamie Mullarkey,2021-03-27,Khama Worthy,KO/TKO,100,1,0,101
Jamie Mullarkey,2020-10-17,Fares Ziam,Decision - Unanimous,0,0,0,0
Jamie Mullarkey,2023-09-09,John Makdessi,Decision - Unanimous,80,5,0,85
Minoki Ichihara,1994-03-11,Royce Gracie,Submission,0,1,0,1
Daniel Cormier,2018-07-07,Stipe Miocic,KO/TKO,100,1,25,126
Daniel Cormier,2015-10-03,Alexander Gustafsson,Decision - Split,70,20,25,115
Daniel Cormier,2017-04-08,Anthony Johnson,Submission,90,14,25,129
Daniel Cormier,2018-11-03,Derrick Lewis,Submission,90,15,25,130
Daniel Cormier,2013-10-19,Roy Nelson,Decision - Unanimous,80,57,0,137
Daniel Cormier,2010-08-21,Jason Riley,KO/TKO,100,10,0,110
Daniel Cormier,2014-02-22,Patrick Cummins,KO/TKO,100,10,0,110
Daniel Cormier,2009-09-25,Gary Frazier,KO/TKO,100,11,0,111
Daniel Cormier,2010-03-26,John Devine,KO/TKO,100,1,0,101
Daniel Cormier,2018-01-20,Volkan Oezdemir,KO/TKO,100,0,25,125
Daniel Cormier,2011-01-07,Devin Cole,Decision - Unanimous,80,20,0,100
Daniel Cormier,2011-06-18,Jeff Monson,Decision - Unanimous,80,71,0,151
Daniel Cormier,2011-09-10,Antonio Silva,KO/TKO,100,9,0,109
Daniel Cormier,2019-08-17,Stipe Miocic,KO/TKO,0,58,25,83
Daniel Cormier,2015-01-03,Jon Jones,Decision - Unanimous,0,0,25,25
Daniel Cormier,2015-05-23,Anthony Johnson,Submission,90,0,25,115
Daniel Cormier,2013-04-20,Frank Mir,Decision - Unanimous,80,35,0,115
Daniel Cormier,2013-01-12,Dion Staring,KO/TKO,100,45,0,145
Daniel Cormier,2016-07-09,Anderson Silva,Decision - Unanimous,80,16,0,96
Daniel Cormier,2020-08-15,Stipe Miocic,Decision - Unanimous,0,0,25,25
Daniel Cormier,2014-05-24,Dan Henderson,Submission,90,44,0,134
Daniel Cormier,2012-05-19,Josh Barnett,Decision - Unanimous,80,31,25,136
Stipe Miocic,2018-07-07,Daniel Cormier,KO/TKO,0,0,25,25
Stipe Miocic,2016-01-02,Andrei Arlovski,KO/TKO,100,4,0,104
Stipe Miocic,2016-05-14,Fabricio Werdum,KO/TKO,100,5,25,130
Stipe Miocic,2012-05-26,Shane del Rosario,KO/TKO,100,0,0,100
Stipe Miocic,2024-11-16,Jon Jones,KO/TKO,0,0,25,25
Stipe Miocic,2021-03-27,Francis Ngannou,KO/TKO,0,0,25,25
Stipe Miocic,2012-09-29,Stefan Struve,KO/TKO,0,0,25,25
Stipe Miocic,2013-06-15,Roy Nelson,Decision - Unanimous,80,83,0,163
Stipe Miocic,2011-10-08,Joey Beltran,Decision - Unanimous,80,16,0,96
Stipe Miocic,2018-01-20,Francis Ngannou,Decision - Unanimous,80,49,25,154
Stipe Miocic,2012-02-15,Philip De Fries,KO/TKO,100,1,0,101
Stipe Miocic,2014-01-25,Gabriel Gonzaga,Decision - Unanimous,80,34,0,114
Stipe Miocic,2019-08-17,Daniel Cormier,KO/TKO,100,0,25,125
Stipe Miocic,2015-05-09,Mark Hunt,KO/TKO,100,80,25,205
Stipe Miocic,2020-08-15,Daniel Cormier,Decision - Unanimous,80,10,25,115
Stipe Miocic,2014-12-13,Junior Dos Santos,Decision - Unanimous,0,0,25,25
Stipe Miocic,2016-09-10,Alistair Overeem,KO/TKO,100,25,25,150
Stipe Miocic,2017-05-13,Junior Dos Santos,KO/TKO,100,14,25,139
Stipe Miocic,2014-05-31,Fabio Maldonado,KO/TKO,100,6,25,131
Jack Jenkins,2023-06-24,Jamall Emmers,Decision - Split,70,2,0,72
Jack Jenkins,2024-08-17,Herbert Burns,KO/TKO,100,49,0,149
Jack Jenkins,2023-02-11,Don Shainis,Decision - Unanimous,80,32,0,112
Jack Jenkins,2022-09-27,Emiliano Linares,KO/TKO,100,35,0,135
Jack Jenkins,2023-09-09,Chepe Mariscal,KO/TKO,0,3,0,3
Jamall Emmers,2023-06-24,Jack Jenkins,Decision - Split,0,0,0,0
Jamall Emmers,2021-08-28,Pat Sabatini,Submission,0,9,0,9
Jamall Emmers,2020-03-07,Giga Chikadze,Decision - Split,0,16,0,16
Jamall Emmers,2020-08-01,Vince Cachero,Decision - Unanimous,80,27,0,107
Jamall Emmers,2024-03-30,Nate Landwehr,KO/TKO,0,2,0,2
Jamall Emmers,2018-06-26,Julian Erosa,KO/TKO,0,0,0,0
Jamall Emmers,2023-02-18,Khusein Askhabov,Decision - Unanimous,80,32,0,112
Jamall Emmers,2023-11-11,Dennis Buzukja,KO/TKO,100,11,0,111
Bojan Velickovic,2016-04-10,Alessio Di Chirico,Decision - Unanimous,80,0,0,80
Bojan Velickovic,2017-09-02,Darren Till,Decision - Unanimous,0,0,0,0
Bojan Velickovic,2017-05-28,Nicholas Musoke,KO/TKO,100,4,0,104
Bojan Velickovic,2017-11-18,Jake Matthews,Decision - Split,0,4,0,4
Bojan Velickovic,2016-12-17,Sultan Aliev,Decision - Split,0,7,0,7
Alessio Di Chirico,2016-04-10,Bojan Velickovic,Decision - Unanimous,0,20,0,20
Alessio Di Chirico,2016-08-27,Garreth McLellan,Decision - Split,70,4,0,74
Alessio Di Chirico,2021-08-28,Abdul Razak Alhassan,KO/TKO,0,0,0,0
Alessio Di Chirico,2019-09-28,Makhmud Muradov,Decision - Unanimous,0,0,0,0
Alessio Di Chirico,2019-06-22,Kevin Holland,Decision - Unanimous,0,0,0,0
Alessio Di Chirico,2021-01-16,Joaquin Buckley,KO/TKO,100,9,0,109
Alessio Di Chirico,2018-07-06,Julian Marquez,Decision - Split,70,3,0,73
Alessio Di Chirico,2017-01-28,Eric Spicely,Submission,0,0,0,0
Alessio Di Chirico,2017-12-16,Oluwale Bamgbose,KO/TKO,100,0,0,100
Alessio Di Chirico,2022-09-03,Roman Kopylov,KO/TKO,0,0,0,0
Alessio Di Chirico,2020-08-29,Zak Cummings,Decision - Unanimous,0,0,0,0
Michel Prazeres,2014-03-23,Mairbek Taisumov,Decision - Unanimous,80,9,0,89
Michel Prazeres,2018-02-03,Desmond Green,Decision - Unanimous,80,3,0,83
Michel Prazeres,2018-05-19,Zak Cummings,Decision - Split,70,2,0,72
Michel Prazeres,2015-02-14,Kevin Lee,Decision - Unanimous,0,0,0,0
Michel Prazeres,2015-11-21,Valmir Lazaro,Decision - Split,70,0,0,70
Michel Prazeres,2019-02-23,Ismail Naurdiev,Decision - Unanimous,0,0,0,0
Michel Prazeres,2016-07-23,JC Cottrell,Decision - Unanimous,80,34,0,114
Michel Prazeres,2016-09-24,Gilbert Burns,Decision - Unanimous,80,21,0,101
Michel Prazeres,2013-09-21,Jesse Ronson,Decision - Split,70,0,0,70
Michel Prazeres,2017-09-02,Mads Burnell,Submission,90,16,0,106
Michel Prazeres,2013-05-18,Paulo Thiago,Decision - Unanimous,0,0,0,0
Michel Prazeres,2018-11-17,Bartosz Fabinski,Submission,90,17,0,107
Michel Prazeres,2017-03-11,Joshua Burkman,Submission,90,23,0,113
Michel Prazeres,2021-06-26,Shavkat Rakhmonov,Submission,0,0,0,0
Mairbek Taisumov,2014-03-23,Michel Prazeres,Decision - Unanimous,0,0,0,0
Mairbek Taisumov,2018-09-15,Desmond Green,Decision - Unanimous,80,0,0,80
Mairbek Taisumov,2015-01-24,Anthony Christodoulou,KO/TKO,100,28,0,128
Mairbek Taisumov,2017-09-02,Felipe Silva,KO/TKO,100,2,0,102
Mairbek Taisumov,2019-09-07,Diego Ferreira,Decision - Unanimous,0,0,0,0
Mairbek Taisumov,2016-04-10,Damir Hadzovic,KO/TKO,100,14,0,114
Mairbek Taisumov,2014-10-04,Marcin Bandel,KO/TKO,100,6,0,106
Mairbek Taisumov,2014-01-04,Tae Hyun Bang,Decision - Unanimous,80,7,0,87
Mairbek Taisumov,2015-06-20,Alan Patrick,KO/TKO,100,6,0,106
Mike Pyle,2010-06-12,Jesse Lennox,Submission,90,12,0,102
Mike Pyle,2012-01-14,Ricardo Funch,KO/TKO,100,9,0,109
Mike Pyle,2016-02-06,Sean Spencer,KO/TKO,100,25,0,125
Mike Pyle,2013-05-25,Rick Story,Decision - Split,70,0,0,70
Mike Pyle,2016-07-07,Alberto Mina,KO/TKO,0,0,0,0
Mike Pyle,2005-10-14,Bret Bergmark,Submission,90,0,0,90
Mike Pyle,2014-08-23,Jordan Mein,KO/TKO,0,0,0,0
Mike Pyle,2018-03-03,Zak Ottow,KO/TKO,0,0,0,0
Mike Pyle,2011-08-06,Rory MacDonald,KO/TKO,0,0,0,0
Mike Pyle,2012-06-08,Josh Neer,KO/TKO,100,0,0,100
Mike Pyle,2009-05-23,Brock Larson,Submission,0,0,0,0
Mike Pyle,2011-03-19,Ricardo Almeida,Decision - Unanimous,80,0,0,80
Mike Pyle,2010-10-16,John Hathaway,Decision - Unanimous,80,28,0,108
Mike Pyle,2014-02-22,TJ Waldburger,KO/TKO,100,18,0,118
Mike Pyle,2013-08-17,Matt Brown,KO/TKO,0,0,0,0
Mike Pyle,2009-09-16,Chris Wilson,Submission,90,0,0,90
Mike Pyle,2008-07-19,JJ Ambrose,Submission,90,9,0,99
Mike Pyle,2016-12-30,Alex Garcia,KO/TKO,0,0,0,0
Mike Pyle,2007-11-10,Jake Shields,Submission,0,2,0,2
Mike Pyle,2010-01-02,Jake Ellenberger,KO/TKO,0,0,0,0
Mike Pyle,2012-12-15,James Head,KO/TKO,100,0,0,100
Mike Pyle,2007-06-22,Aaron Wetherspoon,Decision - Unanimous,80,31,0,111
Mike Pyle,2015-05-23,Colby Covington,Decision - Unanimous,0,0,0,0
Jesse Lennox,2010-06-12,Mike Pyle,Submission,0,0,0,0
Jesse Lennox,2010-01-11,Rick Story,Decision - Split,0,0,0,0
Jesse Lennox,2009-08-08,Danillo Villefort,TKO - Doctor's Stoppage,0,0,0,0
Jesse Lennox,2009-01-25,Blas Avena,KO/TKO,100,18,0,118
Torrez Finney,2023-10-10,Yuri Panferov,Submission,90,0,0,90
Torrez Finney,2024-08-20,Cam Rowston,Decision - Unanimous,80,0,0,80
Torrez Finney,2024-10-01,Abdellah Er-Ramy,KO/TKO,100,35,0,135
Yuri Panferov,2023-10-10,Torrez Finney,Submission,0,11,0,11
Julianna Pena,2013-11-30,Jessica Rakoczy,KO/TKO,100,29,0,129
Julianna Pena,2015-04-04,Milana Dudieva,KO/TKO,100,37,0,137
Julianna Pena,2015-10-03,Jessica Eye,Decision - Unanimous,80,4,0,84
Julianna Pena,2017-01-28,Valentina Shevchenko,Submission,0,14,25,39
Julianna Pena,2016-07-09,Cat Zingano,Decision - Unanimous,80,1,0,81
Julianna Pena,2021-01-23,Sara McMann,Submission,90,17,0,107
Julianna Pena,2020-10-03,Germaine de Randamie,Submission,0,0,0,0
Julianna Pena,2022-07-30,Amanda Nunes,Decision - Unanimous,0,0,25,25
Julianna Pena,2019-07-13,Nicco Montano,Decision - Unanimous,80,7,0,87
Julianna Pena,2024-10-05,Raquel Pennington,Decision - Split,70,0,25,95
Julianna Pena,2021-12-11,Amanda Nunes,Submission,90,33,25,148
Jessica Rakoczy,2013-11-30,Julianna Pena,KO/TKO,0,0,0,0
Jessica Rakoczy,2015-04-25,Valerie Letourneau,Decision - Unanimous,0,8,0,8
John Moraga,2012-12-29,Chris Cariaso,Submission,90,0,0,90
John Moraga,2014-01-15,Dustin Ortiz,Decision - Split,70,8,0,78
John Moraga,2013-07-27,Demetrious Johnson,Submission,0,0,25,25
John Moraga,2014-06-07,John Dodson,TKO - Doctor's Stoppage,0,0,0,0
John Moraga,2016-07-08,Matheus Nicolau,Decision - Split,0,0,0,0
John Moraga,2014-09-05,Justin Scoggins,Submission,90,0,0,90
John Moraga,2018-08-25,Deiveson Figueiredo,KO/TKO,0,0,0,0
John Moraga,2017-01-15,Sergio Pettis,Decision - Unanimous,0,0,0,0
John Moraga,2014-12-13,Willie Gates,Submission,90,34,0,124
John Moraga,2017-10-07,Bibulatov Magomed,KO/TKO,100,3,0,103
John Moraga,2015-05-23,Joseph Benavidez,Decision - Unanimous,0,0,0,0
John Moraga,2018-04-14,Wilson Reis,Decision - Unanimous,80,34,0,114
John Moraga,2017-06-10,Ashkan Mokhtarian,Decision - Unanimous,80,44,0,124
John Moraga,2012-08-04,Ulysses Gomez,KO/TKO,100,18,0,118
Chris Cariaso,2012-12-29,John Moraga,Submission,0,13,0,13
Chris Cariaso,2013-05-18,Jussier Formiga,Decision - Unanimous,0,16,0,16
Chris Cariaso,2014-02-01,Danny Martinez,Decision - Unanimous,80,40,0,120
Chris Cariaso,2011-01-22,Will Campuzano,Decision - Unanimous,80,5,0,85
Chris Cariaso,2014-05-10,Louis Smolka,Decision - Split,70,22,0,92
Chris Cariaso,2014-09-27,Demetrious Johnson,Submission,0,0,25,25
Chris Cariaso,2010-06-20,Rafael Rebello,Decision - Unanimous,80,47,0,127
Chris Cariaso,2015-03-14,Henry Cejudo,Decision - Unanimous,0,0,0,0
Chris Cariaso,2007-06-22,Anthony Figueroa,Decision - Unanimous,80,20,0,100
Chris Cariaso,2008-06-27,Anthony Figueroa,Submission,90,14,0,104
Chris Cariaso,2011-05-28,Michael McDonald,Decision - Split,0,12,0,12
Chris Cariaso,2011-11-05,Vaughan Lee,Decision - Split,70,23,0,93
Chris Cariaso,2013-10-09,Iliarde Santos,KO/TKO,100,19,0,119
Chris Cariaso,2012-02-25,Takeya Mizugaki,Decision - Unanimous,80,9,0,89
Chris Cariaso,2015-10-03,Sergio Pettis,Decision - Unanimous,0,0,0,0
Chris Cariaso,2012-07-11,Josh Ferguson,Decision - Unanimous,80,50,0,130
Chris Cariaso,2010-12-16,Renan Barao,Submission,0,0,0,0
Johnny Eduardo,2012-05-15,Jeff Curran,Decision - Unanimous,80,20,0,100
Johnny Eduardo,2021-10-02,Alejandro Perez,Submission,0,8,0,8
Johnny Eduardo,2011-08-27,Raphael Assuncao,Decision - Unanimous,0,0,0,0
Johnny Eduardo,2015-12-10,Aljamain Sterling,Submission,0,0,0,0
Johnny Eduardo,2018-06-01,Nathaniel Wood,Submission,0,4,0,4
Johnny Eduardo,2017-06-03,Matthew Lopez,KO/TKO,0,0,0,0
Johnny Eduardo,2014-05-10,Eddie Wineland,KO/TKO,100,5,0,105
Johnny Eduardo,2016-11-19,Manvel Gamburyan,KO/TKO,100,15,0,115
Jeff Curran,2012-05-15,Johnny Eduardo,Decision - Unanimous,0,0,0,0
Jeff Curran,2009-04-05,Joseph Benavidez,Decision - Unanimous,0,0,0,0
Jeff Curran,2009-08-09,Takeya Mizugaki,Decision - Split,0,6,0,6
Jeff Curran,2006-08-27,Hatsu Hioki,Decision - Unanimous,0,0,0,0
Jeff Curran,2004-01-31,Matt Serra,Decision - Unanimous,0,0,0,0
Jeff Curran,2008-06-01,Mike Brown,Decision - Unanimous,0,0,0,0
Jeff Curran,2007-12-12,Urijah Faber,Submission,0,0,25,25
Jeff Curran,2011-10-29,Scott Jorgensen,Decision - Unanimous,0,0,0,0
Jeff Curran,2007-08-05,Stephen Ledbetter,Decision - Unanimous,80,6,0,86
Pat Barry,2012-01-20,Christian Morecraft,KO/TKO,100,9,0,109
Pat Barry,2009-05-23,Tim Hague,Submission,0,3,0,3
Pat Barry,2009-10-24,Antoni Hardonk,KO/TKO,100,0,0,100
Pat Barry,2012-12-15,Shane del Rosario,KO/TKO,100,0,0,100
Pat Barry,2012-05-05,Lavar Johnson,KO/TKO,0,0,0,0
Pat Barry,2010-06-12,Mirko Filipovic,Submission,0,0,0,0
Pat Barry,2008-12-27,Dan Evensen,KO/TKO,100,6,0,106
Pat Barry,2011-06-26,Cheick Kongo,KO/TKO,0,0,0,0
Pat Barry,2011-01-22,Joey Beltran,Decision - Unanimous,80,0,0,80
Pat Barry,2013-12-06,Soa Palelei,KO/TKO,0,0,0,0
Pat Barry,2013-06-15,Shawn Jordan,KO/TKO,0,0,0,0
Pat Barry,2011-10-01,Stefan Struve,Submission,0,0,0,0
Christian Morecraft,2012-01-20,Pat Barry,KO/TKO,0,0,0,0
Christian Morecraft,2011-03-26,Sean McCorkle,Submission,90,14,0,104
Christian Morecraft,2010-08-07,Stefan Struve,KO/TKO,0,25,0,25
Christian Morecraft,2011-06-26,Matt Mitrione,KO/TKO,0,0,0,0
Diego Lopes,2024-06-29,Dan Ige,Decision - Unanimous,80,7,0,87
Diego Lopes,2021-08-31,Joanderson Brito,Decision - Unanimous,0,0,0,0
Diego Lopes,2023-08-05,Gavin Tucker,Submission,90,0,0,90
Diego Lopes,2024-04-13,Sodiq Yusuff,KO/TKO,100,24,0,124
Diego Lopes,2024-09-14,Brian Ortega,Decision - Unanimous,80,43,0,123
Diego Lopes,2023-11-11,Pat Sabatini,KO/TKO,100,6,0,106
Diego Lopes,2023-05-06,Movsar Evloev,Decision - Unanimous,0,0,0,0
Dan Ige,2024-06-29,Diego Lopes,Decision - Unanimous,0,0,0,0
Dan Ige,2017-07-25,Luis Gomez,Submission,90,33,0,123
Dan Ige,2019-06-22,Kevin Aguilar,Decision - Unanimous,80,38,0,118
Dan Ige,2023-09-23,Bryce Mitchell,Decision - Unanimous,0,0,0,0
Dan Ige,2018-06-09,Mike Santiago,KO/TKO,100,25,0,125
Dan Ige,2021-03-13,Gavin Tucker,KO/TKO,100,0,0,100
Dan Ige,2024-10-26,Lerone Murphy,Decision - Unanimous,0,0,0,0
Dan Ige,2023-01-14,Damon Jackson,KO/TKO,100,0,0,100
Dan Ige,2020-02-08,Mirsad Bektic,Decision - Split,70,26,0,96
Dan Ige,2019-03-16,Danny Henry,Submission,90,6,0,96
Dan Ige,2020-07-15,Calvin Kattar,Decision - Unanimous,0,0,25,25
Dan Ige,2022-06-04,Movsar Evloev,Decision - Unanimous,0,0,0,0
Dan Ige,2021-12-11,Josh Emmett,Decision - Unanimous,0,10,0,10
Dan Ige,2020-05-16,Edson Barboza,Decision - Split,70,0,0,70
Dan Ige,2021-06-19,Chan Sung Jung,Decision - Unanimous,0,0,25,25
Dan Ige,2018-01-20,Julio Arce,Decision - Unanimous,0,0,0,0
Dan Ige,2023-06-10,Nate Landwehr,Decision - Unanimous,80,14,0,94
Dan Ige,2024-02-10,Andre Fili,KO/TKO,100,3,0,103
Dan Ige,2018-12-15,Jordan Griffin,Decision - Unanimous,80,0,0,80
Tarec Saffiedine,2010-02-26,James Terry,Decision - Unanimous,80,46,0,126
Tarec Saffiedine,2009-10-25,Dong Sik Yoon,Decision - Split,0,21,0,21
Tarec Saffiedine,2011-07-30,Scott Smith,Decision - Unanimous,80,92,0,172
Tarec Saffiedine,2009-07-20,Seichi Ikemoto,Decision - Unanimous,80,10,0,90
Tarec Saffiedine,2016-05-29,Rick Story,Decision - Unanimous,0,0,0,0
Tarec Saffiedine,2017-06-17,Rafael Dos Anjos,Decision - Unanimous,0,0,0,0
Tarec Saffiedine,2010-05-21,Nate Moore,KO/TKO,100,1,0,101
Tarec Saffiedine,2012-01-07,Tyler Stinson,Decision - Split,70,18,0,88
Tarec Saffiedine,2013-01-12,Nate Marquardt,Decision - Unanimous,80,48,25,153
Tarec Saffiedine,2012-08-18,Roger Bowling,Decision - Unanimous,80,14,0,94
Tarec Saffiedine,2014-10-04,Rory MacDonald,KO/TKO,0,0,25,25
Tarec Saffiedine,2011-01-07,Tyron Woodley,Decision - Unanimous,0,0,0,0
Tarec Saffiedine,2016-01-30,Jake Ellenberger,Decision - Unanimous,80,24,0,104
Tarec Saffiedine,2014-01-04,Hyun Gyu Lim,Decision - Unanimous,80,0,25,105
Tarec Saffiedine,2016-12-30,Dong Hyun Kim,Decision - Split,0,16,0,16
James Terry,2010-02-26,Tarec Saffiedine,Decision - Unanimous,0,0,0,0
James Terry,2011-01-29,Lucas Gamaza,KO/TKO,100,0,0,100
James Terry,2012-01-07,Nah-Shon Burrell,Decision - Split,0,0,0,0
Antonio Rodrigo Nogueira,2008-02-02,Tim Sylvia,Submission,90,0,25,115
Antonio Rodrigo Nogueira,2001-07-29,Gary Goodridge,Submission,90,0,0,90
Antonio Rodrigo Nogueira,2006-12-31,Josh Barnett,Decision - Unanimous,80,20,0,100
Antonio Rodrigo Nogueira,2001-11-03,Heath Herring,Decision - Unanimous,80,32,0,112
Antonio Rodrigo Nogueira,2003-03-16,Fedor Emelianenko,Decision - Unanimous,0,0,0,0
Antonio Rodrigo Nogueira,2004-08-15,Sergei Kharitonov,Decision - Unanimous,80,8,0,88
Antonio Rodrigo Nogueira,2012-10-13,Dave Herman,Submission,90,7,0,97
Antonio Rodrigo Nogueira,2006-05-05,Wagner da Conceicao Martins,Submission,90,7,0,97
Antonio Rodrigo Nogueira,2006-02-26,Kiyoshi Tamura,Submission,90,2,0,92
Antonio Rodrigo Nogueira,2005-06-26,Pawel Nastula,KO/TKO,100,14,0,114
Antonio Rodrigo Nogueira,2010-02-20,Cain Velasquez,KO/TKO,0,0,0,0
Antonio Rodrigo Nogueira,2011-08-27,Brendan Schaub,KO/TKO,100,4,0,104
Antonio Rodrigo Nogueira,2002-12-23,Dan Henderson,Submission,90,12,0,102
Antonio Rodrigo Nogueira,2003-08-10,Ricco Rodriguez,Decision - Unanimous,80,0,0,80
Antonio Rodrigo Nogueira,2015-08-01,Stefan Struve,Decision - Unanimous,0,0,0,0
Antonio Rodrigo Nogueira,2002-02-24,Enson Inoue,Submission,90,0,0,90
Antonio Rodrigo Nogueira,2011-12-10,Frank Mir,Submission,0,15,0,15
Antonio Rodrigo Nogueira,2013-06-08,Fabricio Werdum,Submission,0,0,25,25
Antonio Rodrigo Nogueira,2001-09-24,Mark Coleman,Submission,90,10,0,100
Antonio Rodrigo Nogueira,2002-08-28,Bob Sapp,Submission,90,0,0,90
Antonio Rodrigo Nogueira,2003-11-09,Mirko Filipovic,Submission,90,0,0,90
Antonio Rodrigo Nogueira,2004-04-25,Hirotaka Yokoi,Submission,90,14,0,104
Antonio Rodrigo Nogueira,2004-06-20,Heath Herring,Submission,90,0,0,90
Antonio Rodrigo Nogueira,2007-07-07,Heath Herring,Decision - Unanimous,80,24,0,104
Antonio Rodrigo Nogueira,2006-09-10,Josh Barnett,Decision - Split,0,0,0,0
Antonio Rodrigo Nogueira,2002-11-24,Semmy Schilt,Submission,90,1,0,91
Antonio Rodrigo Nogueira,2009-08-29,Randy Couture,Decision - Unanimous,80,0,0,80
Antonio Rodrigo Nogueira,2014-04-11,Roy Nelson,KO/TKO,0,0,25,25
Antonio Rodrigo Nogueira,2002-08-08,Sanae Kikuta,KO/TKO,100,10,0,110
Antonio Rodrigo Nogueira,2004-12-31,Fedor Emelianenko,Decision - Unanimous,0,0,0,0
Antonio Rodrigo Nogueira,2006-07-01,Fabricio Werdum,Decision - Unanimous,80,21,0,101
Antonio Rodrigo Nogueira,2008-12-27,Frank Mir,KO/TKO,0,0,25,25
Carlos Newton,2004-05-23,Daiju Takase,Decision - Split,0,7,0,7
Carlos Newton,1999-07-04,Daijiro Matsui,Decision - Unanimous,80,0,0,80
Carlos Newton,2004-10-14,Ryo Chonan,Decision - Unanimous,0,0,0,0
Carlos Newton,2003-10-05,Renzo Gracie,Decision - Split,70,9,0,79
Carlos Newton,2002-02-24,Jose Landi-Jons,Submission,90,0,0,90
Carlos Newton,2000-06-04,Yuhi Sano,Submission,90,3,0,93
Carlos Newton,1998-05-15,Bob Gilstrap,Submission,90,1,0,91
Carlos Newton,2004-01-31,Renato Verissimo,Decision - Unanimous,0,0,0,0
Carlos Newton,2001-11-02,Matt Hughes,KO/TKO,0,0,25,25
Carlos Newton,2002-11-22,Pete Spratt,Submission,90,0,0,90
Carlos Newton,2001-05-04,Pat Miletich,Submission,90,0,25,115
Carlos Newton,1998-05-15,Dan Henderson,Decision - Split,0,0,0,0
Carlos Newton,2003-03-16,Anderson Silva,KO/TKO,0,0,0,0
Carlos Newton,2002-07-13,Matt Hughes,KO/TKO,0,0,25,25
Carlos Newton,1998-06-24,Kazushi Sakuraba,Submission,0,2,0,2
Carlos Newton,2000-12-09,Johil de Oliveira,Decision - Unanimous,80,5,0,85
Joselyne Edwards,2024-10-19,Tamires Vidal,Submission,90,47,0,137
Joselyne Edwards,2023-09-02,Nora Cornolle,Decision - Unanimous,0,0,0,0
Joselyne Edwards,2021-01-16,Wu Yanan,Decision - Unanimous,80,30,0,110
Joselyne Edwards,2021-02-06,Karol Rosa,Decision - Unanimous,0,0,0,0
Joselyne Edwards,2023-04-15,Lucie Pudilova,Decision - Split,70,17,0,87
Joselyne Edwards,2021-10-23,Jessica-Rose Clark,Decision - Unanimous,0,12,0,12
Joselyne Edwards,2022-06-11,Ramona Pascual,Decision - Unanimous,80,101,0,181
Joselyne Edwards,2024-06-01,Ailin Perez,Decision - Unanimous,0,0,0,0
Joselyne Edwards,2022-07-30,Ji Yeon Kim,Decision - Split,70,23,0,93
Tamires Vidal,2024-10-19,Joselyne Edwards,Submission,0,0,0,0
Tamires Vidal,2022-11-05,Ramona Pascual,KO/TKO,100,4,0,104
Tamires Vidal,2024-05-18,Melissa Gatto,KO/TKO,0,0,0,0
Tamires Vidal,2023-09-23,Montserrat Rendon,Decision - Split,0,0,0,0
Doug Marshall,2006-07-28,Jeff Terry,KO/TKO,100,15,0,115
Doug Marshall,2008-03-26,Brian Stann,KO/TKO,0,0,25,25
Doug Marshall,2006-08-17,Lodune Sincaid,KO/TKO,100,14,0,114
Doug Marshall,2007-05-12,Justin McElfresh,KO/TKO,100,13,25,138
Doug Marshall,2007-12-12,Ariel Gandulla,Submission,90,0,25,115
Jeff Terry,2006-07-28,Doug Marshall,KO/TKO,0,0,0,0
Macy Chiasson,2022-05-07,Norma Dumont,Decision - Split,70,0,0,70
Macy Chiasson,2021-03-20,Marion Reneau,Decision - Unanimous,80,21,0,101
Macy Chiasson,2018-11-30,Pannie Kianzad,Submission,90,5,0,95
Macy Chiasson,2020-02-15,Shanna Young,Decision - Unanimous,80,46,0,126
Macy Chiasson,2024-06-29,Mayra Bueno Silva,TKO - Doctor's Stoppage,0,4,0,4
Macy Chiasson,2022-09-10,Irene Aldana,KO/TKO,0,2,0,2
Macy Chiasson,2019-03-02,Gina Mazany,KO/TKO,100,11,0,111
Macy Chiasson,2021-12-18,Raquel Pennington,Submission,0,0,0,0
Macy Chiasson,2019-05-04,Sarah Moras,KO/TKO,100,34,0,134
Macy Chiasson,2024-03-16,Pannie Kianzad,Submission,90,2,0,92
Macy Chiasson,2019-09-28,Lina Lansberg,Decision - Unanimous,0,5,0,5
Norma Dumont,2022-05-07,Macy Chiasson,Decision - Split,0,6,0,6
Norma Dumont,2022-09-10,Danyelle Wolf,Decision - Unanimous,80,32,0,112
Norma Dumont,2023-07-15,Chelsea Chandler,Decision - Unanimous,80,25,0,105
Norma Dumont,2020-02-29,Megan Anderson,KO/TKO,0,0,0,0
Norma Dumont,2021-10-16,Aspen Ladd,Decision - Unanimous,80,32,25,137
Norma Dumont,2020-11-28,Ashlee Evans-Smith,Decision - Unanimous,80,52,0,132
Norma Dumont,2024-09-14,Irene Aldana,Decision - Unanimous,80,90,0,170
Norma Dumont,2024-04-06,Germaine de Randamie,Decision - Unanimous,80,0,0,80
Norma Dumont,2021-05-22,Felicia Spencer,Decision - Split,70,21,0,91
Norma Dumont,2023-04-22,Karol Rosa,Decision - Unanimous,80,2,0,82
Brian Ebersole,2014-09-27,John Howard,Decision - Split,70,7,0,77
Brian Ebersole,2011-12-10,Claude Patrick,Decision - Split,70,0,0,70
Brian Ebersole,2011-02-26,Chris Lytle,Decision - Unanimous,80,8,0,88
Brian Ebersole,2006-03-10,Matt Horwich,Decision - Unanimous,80,15,0,95
Brian Ebersole,2012-07-21,James Head,Decision - Split,0,0,0,0
Brian Ebersole,2013-11-16,Rick Story,Decision - Unanimous,0,0,0,0
Brian Ebersole,2012-06-22,TJ Waldburger,Decision - Unanimous,80,21,0,101
Brian Ebersole,2011-08-06,Dennis Hallman,KO/TKO,100,19,0,119
Brian Ebersole,2015-06-06,Omari Akhmedov,KO/TKO,0,0,0,0
John Howard,2014-09-27,Brian Ebersole,Decision - Split,0,0,0,0
John Howard,2010-12-11,Thiago Alves,Decision - Unanimous,0,0,0,0
John Howard,2009-08-08,Tamdan McCrory,Decision - Split,70,8,0,78
John Howard,2010-03-21,Daniel Roberts,KO/TKO,100,0,0,100
John Howard,2010-08-01,Jake Ellenberger,TKO - Doctor's Stoppage,0,0,0,0
John Howard,2013-12-28,Siyar Bahadurzada,Decision - Unanimous,80,3,0,83
John Howard,2015-01-18,Lorenz Larkin,KO/TKO,0,0,0,0
John Howard,2014-04-11,Ryan LaFlare,Decision - Unanimous,0,0,0,0
John Howard,2015-12-10,Tim Means,KO/TKO,0,0,0,0
John Howard,2011-06-26,Matt Brown,Decision - Unanimous,0,0,0,0
John Howard,2013-08-17,Uriah Hall,Decision - Split,70,0,0,70
John Howard,2015-07-11,Cathal Pendred,Decision - Split,70,3,0,73
John Howard,2009-12-05,Dennis Hallman,KO/TKO,100,6,0,106
John Howard,2009-01-31,Chris Wilson,Decision - Split,70,0,0,70
Abus Magomedov,2024-05-18,Warlley Alves,Decision - Unanimous,80,6,0,86
Abus Magomedov,2023-07-01,Sean Strickland,KO/TKO,0,0,25,25
Abus Magomedov,2022-09-03,Dustin Stoltzfus,KO/TKO,100,7,0,107
Abus Magomedov,2024-10-26,Brunno Ferreira,Submission,90,0,0,90
Abus Magomedov,2023-11-04,Caio Borralho,Decision - Unanimous,0,0,0,0
Warlley Alves,2024-05-18,Abus Magomedov,Decision - Unanimous,0,0,0,0
Warlley Alves,2023-01-21,Nicolas Dalby,Decision - Split,0,0,0,0
Warlley Alves,2019-11-16,Randy Brown,Submission,0,0,0,0
Warlley Alves,2021-01-20,Mounir Lazzez,KO/TKO,100,15,0,115
Warlley Alves,2014-11-08,Alan Jouban,Decision - Unanimous,80,0,0,80
Warlley Alves,2014-05-31,Marcio Alexandre Junior,Submission,90,11,0,101
Warlley Alves,2016-11-19,Kamaru Usman,Decision - Unanimous,0,0,0,0
Warlley Alves,2016-05-14,Bryan Barberena,Decision - Unanimous,0,0,0,0
Warlley Alves,2017-10-21,Salim Touahri,Decision - Unanimous,80,3,0,83
Warlley Alves,2021-06-26,Jeremiah Wells,KO/TKO,0,0,0,0
Warlley Alves,2015-08-01,Nordine Taleb,Submission,90,0,0,90
Warlley Alves,2023-10-21,Ikram Aliskerov,KO/TKO,0,0,0,0
Warlley Alves,2018-08-25,James Krause,KO/TKO,0,0,0,0
Warlley Alves,2019-05-11,Sergio Moraes,KO/TKO,100,52,0,152
Warlley Alves,2018-05-12,Sultan Aliev,TKO - Doctor's Stoppage,0,17,0,17
Warlley Alves,2015-12-12,Colby Covington,Submission,90,0,0,90
Jeremy Stephens,2010-05-08,Sam Stout,Decision - Split,70,0,0,70
Jeremy Stephens,2011-01-01,Marcus Davis,KO/TKO,100,8,0,108
Jeremy Stephens,2017-04-15,Renato Moicano,Decision - Split,0,0,0,0
Jeremy Stephens,2019-10-18,Yair Rodriguez,Decision - Unanimous,0,0,0,0
Jeremy Stephens,2008-01-23,Cole Miller,KO/TKO,100,25,0,125
Jeremy Stephens,2019-03-02,Zabit Magomedsharipov,Decision - Unanimous,0,0,0,0
Jeremy Stephens,2016-05-29,Renan Barao,Decision - Unanimous,80,12,0,92
Jeremy Stephens,2007-05-26,Din Thomas,Submission,0,0,0,0
Jeremy Stephens,2007-09-22,Diego Saraiva,Decision - Unanimous,80,39,0,119
Jeremy Stephens,2008-11-15,Rafael Dos Anjos,KO/TKO,100,13,0,113
Jeremy Stephens,2012-12-08,Yves Edwards,KO/TKO,0,0,0,0
Jeremy Stephens,2009-04-01,Gleison Tibau,Decision - Unanimous,0,16,0,16
Jeremy Stephens,2016-11-12,Frankie Edgar,Decision - Unanimous,0,0,0,0
Jeremy Stephens,2017-09-09,Gilbert Melendez,Decision - Unanimous,80,67,0,147
Jeremy Stephens,2010-09-25,Melvin Guillard,Decision - Split,0,0,0,0
Jeremy Stephens,2009-02-07,Joe Lauzon,Submission,0,4,0,4
Jeremy Stephens,2008-06-21,Spencer Fisher,Decision - Unanimous,0,0,0,0
Jeremy Stephens,2011-06-04,Danny Downes,Decision - Unanimous,80,23,0,103
Jeremy Stephens,2021-07-17,Mateusz Gamrot,Submission,0,0,0,0
Jeremy Stephens,2014-01-25,Darren Elkins,Decision - Unanimous,80,19,0,99
Jeremy Stephens,2018-07-28,Jose Aldo,KO/TKO,0,0,0,0
Jeremy Stephens,2018-01-14,Dooho Choi,KO/TKO,100,5,25,130
Jeremy Stephens,2018-02-24,Josh Emmett,KO/TKO,100,6,25,131
Jeremy Stephens,2015-07-11,Dennis Bermudez,KO/TKO,100,3,0,103
Jeremy Stephens,2012-05-15,Donald Cerrone,Decision - Unanimous,0,0,0,0
Jeremy Stephens,2014-06-28,Cub Swanson,Decision - Unanimous,0,0,25,25
Jeremy Stephens,2009-09-16,Justin Buchholz,TKO - Doctor's Stoppage,0,19,0,19
Jeremy Stephens,2015-12-12,Max Holloway,Decision - Unanimous,0,0,0,0
Jeremy Stephens,2013-11-09,Rony Jason,KO/TKO,100,2,0,102
Jeremy Stephens,2011-10-08,Anthony Pettis,Decision - Split,0,0,0,0
Jeremy Stephens,2014-12-12,Charles Oliveira,Decision - Unanimous,0,5,0,5
Jeremy Stephens,2013-05-25,Estevan Payan,Decision - Unanimous,80,24,0,104
Jeremy Stephens,2020-05-09,Calvin Kattar,KO/TKO,0,5,0,5
Sam Stout,2010-05-08,Jeremy Stephens,Decision - Split,0,15,0,15
Sam Stout,2009-04-18,Matt Wiman,Decision - Unanimous,80,16,0,96
Sam Stout,2008-01-19,Per Eklund,Decision - Unanimous,80,13,0,93
Sam Stout,2010-01-02,Joe Lauzon,Decision - Unanimous,80,68,0,148
Sam Stout,2008-10-18,Terry Etim,Decision - Unanimous,0,0,0,0
Sam Stout,2012-01-14,Thiago Tavares,Decision - Unanimous,0,0,0,0
Sam Stout,2010-10-23,Paul Taylor,Decision - Split,70,0,0,70
Sam Stout,2006-06-24,Kenny Florian,Submission,0,0,0,0
Sam Stout,2006-03-04,Spencer Fisher,Decision - Split,70,9,0,79
Sam Stout,2012-06-22,Spencer Fisher,Decision - Unanimous,80,0,0,80
Sam Stout,2013-06-15,James Krause,Submission,0,0,0,0
Sam Stout,2013-12-14,Cody McKenzie,Decision - Unanimous,80,23,0,103
Sam Stout,2012-11-17,John Makdessi,Decision - Unanimous,0,0,0,0
Sam Stout,2011-06-11,Yves Edwards,KO/TKO,100,0,0,100
Sam Stout,2015-08-23,Frankie Perez,KO/TKO,0,0,0,0
Sam Stout,2014-04-16,KJ Noons,KO/TKO,0,0,0,0
Sam Stout,2013-02-23,Caros Fodor,Decision - Split,70,0,0,70
Sam Stout,2008-04-19,Rich Clementi,Decision - Split,0,8,0,8
Sam Stout,2007-06-12,Spencer Fisher,Decision - Unanimous,0,0,0,0
Sam Stout,2015-03-14,Ross Pearson,KO/TKO,0,0,0,0
Erin Blanchfield,2021-12-11,Miranda Maverick,Decision - Unanimous,80,25,0,105
Erin Blanchfield,2024-03-30,Manon Fiorot,Decision - Unanimous,0,0,25,25
Erin Blanchfield,2023-02-18,Jessica Andrade,Submission,90,0,25,115
Erin Blanchfield,2022-11-12,Molly McCann,Submission,90,18,0,108
Erin Blanchfield,2022-06-04,JJ Aldrich,Submission,90,16,0,106
Erin Blanchfield,2023-08-26,Taila Santos,Decision - Unanimous,80,6,0,86
Erin Blanchfield,2024-11-02,Rose Namajunas,Decision - Unanimous,80,16,25,121
Erin Blanchfield,2021-09-18,Sarah Alpar,Decision - Unanimous,80,79,0,159
Miranda Maverick,2021-12-11,Erin Blanchfield,Decision - Unanimous,0,0,0,0
Miranda Maverick,2024-07-20,Dione Barbosa,Decision - Unanimous,80,9,0,89
Miranda Maverick,2024-12-14,Jamey-Lyn Horth,Decision - Unanimous,80,9,0,89
Miranda Maverick,2024-02-17,Andrea Lee,Decision - Unanimous,80,30,0,110
Miranda Maverick,2022-03-12,Sabina Mazo,Submission,90,4,0,94
Miranda Maverick,2021-03-27,Gillian Robertson,Decision - Unanimous,80,44,0,124
Miranda Maverick,2021-07-24,Maycee Barber,Decision - Split,0,11,0,11
Miranda Maverick,2023-07-29,Priscila Cachoeira,Submission,90,25,0,115
Miranda Maverick,2022-11-05,Shanna Young,Decision - Unanimous,80,34,0,114
Miranda Maverick,2020-10-24,Liana Jojua,TKO - Doctor's Stoppage,0,19,0,19
Miranda Maverick,2023-06-10,Jasmine Jasudavicius,Decision - Unanimous,0,0,0,0
Justin McCully,2007-04-05,Antoni Hardonk,Decision - Unanimous,80,0,0,80
Justin McCully,2008-07-05,Gabriel Gonzaga,Submission,0,0,0,0
Justin McCully,2009-08-29,Mike Russow,Decision - Unanimous,0,0,0,0
Justin McCully,2008-12-10,Eddie Sanchez,Decision - Unanimous,80,0,0,80
Antoni Hardonk,2007-04-05,Justin McCully,Decision - Unanimous,0,5,0,5
Antoni Hardonk,2007-08-25,Frank Mir,Submission,0,0,0,0
Antoni Hardonk,2009-10-24,Pat Barry,KO/TKO,0,0,0,0
Antoni Hardonk,2009-04-18,Cheick Kongo,KO/TKO,0,0,0,0
Antoni Hardonk,2008-06-07,Eddie Sanchez,KO/TKO,100,15,0,115
Antoni Hardonk,2008-12-27,Mike Wessel,KO/TKO,100,33,0,133
Antoni Hardonk,2006-11-18,Sherman Pendergarst,KO/TKO,100,6,0,106
Antoni Hardonk,2008-01-19,Colin Robinson,KO/TKO,100,5,0,105
Rose Namajunas,2017-11-04,Joanna Jedrzejczyk,KO/TKO,100,10,25,135
Rose Namajunas,2024-03-23,Amanda Ribas,Decision - Unanimous,80,10,25,115
Rose Namajunas,2017-04-15,Michelle Waterson-Gomez,Submission,90,25,0,115
Rose Namajunas,2020-07-11,Jessica Andrade,Decision - Split,70,11,0,81
Rose Namajunas,2015-12-10,Paige VanZant,Submission,90,47,25,162
Rose Namajunas,2022-05-07,Carla Esparza,Decision - Split,0,7,25,32
Rose Namajunas,2018-04-07,Joanna Jedrzejczyk,Decision - Unanimous,80,0,25,105
Rose Namajunas,2016-07-30,Karolina Kowalkiewicz,Decision - Split,0,0,0,0
Rose Namajunas,2014-12-12,Carla Esparza,Submission,0,0,25,25
Rose Namajunas,2021-04-24,Zhang Weili,KO/TKO,100,0,25,125
Rose Namajunas,2023-09-02,Manon Fiorot,Decision - Unanimous,0,2,0,2
Rose Namajunas,2015-10-03,Angela Hill,Submission,90,1,0,91
Rose Namajunas,2016-04-16,Tecia Pennington,Decision - Unanimous,80,0,0,80
Rose Namajunas,2021-11-06,Zhang Weili,Decision - Split,70,3,25,98
Rose Namajunas,2024-11-02,Erin Blanchfield,Decision - Unanimous,0,0,25,25
Rose Namajunas,2024-07-13,Tracy Cortez,Decision - Unanimous,80,38,25,143
Rose Namajunas,2019-05-11,Jessica Andrade,KO/TKO,0,8,25,33
Joanna Jedrzejczyk,2017-11-04,Rose Namajunas,KO/TKO,0,0,25,25
Joanna Jedrzejczyk,2019-10-12,Michelle Waterson-Gomez,Decision - Unanimous,80,122,25,227
Joanna Jedrzejczyk,2014-07-26,Juliana Lima,Decision - Unanimous,80,28,0,108
Joanna Jedrzejczyk,2020-03-07,Zhang Weili,Decision - Split,0,21,25,46
Joanna Jedrzejczyk,2015-03-14,Carla Esparza,KO/TKO,100,49,25,174
Joanna Jedrzejczyk,2018-04-07,Rose Namajunas,Decision - Unanimous,0,40,25,65
Joanna Jedrzejczyk,2014-12-13,Claudia Gadelha,Decision - Split,70,11,0,81
Joanna Jedrzejczyk,2016-07-08,Claudia Gadelha,Decision - Unanimous,80,113,25,218
Joanna Jedrzejczyk,2018-12-08,Valentina Shevchenko,Decision - Unanimous,0,0,25,25
Joanna Jedrzejczyk,2016-11-12,Karolina Kowalkiewicz,Decision - Unanimous,80,121,25,226
Joanna Jedrzejczyk,2022-06-11,Zhang Weili,KO/TKO,0,0,0,0
Joanna Jedrzejczyk,2015-11-14,Valerie Letourneau,Decision - Unanimous,80,117,25,222
Joanna Jedrzejczyk,2015-06-20,Jessica Penne,KO/TKO,100,101,25,226
Joanna Jedrzejczyk,2017-05-13,Jessica Andrade,Decision - Unanimous,80,142,25,247
Joanna Jedrzejczyk,2018-07-28,Tecia Pennington,Decision - Unanimous,80,29,0,109
Jon Tuck,2017-06-17,Takanori Gomi,Submission,90,7,0,97
Jon Tuck,2013-10-26,Norman Parke,Decision - Unanimous,0,0,0,0
Jon Tuck,2014-09-27,Kevin Lee,Decision - Unanimous,0,0,0,0
Jon Tuck,2012-11-10,Zhang Tiequan,Decision - Unanimous,80,0,0,80
Jon Tuck,2016-05-08,Josh Emmett,Decision - Split,0,0,0,0
Jon Tuck,2016-11-26,Damien Brown,Decision - Split,0,5,0,5
Jon Tuck,2014-06-07,Jake Lindsey,KO/TKO,100,0,0,100
Jon Tuck,2015-05-16,Tae Hyun Bang,Submission,90,1,0,91
Jon Tuck,2018-08-25,Drew Dober,Decision - Unanimous,0,0,0,0
War Machine,2007-12-08,Jared Rollins,KO/TKO,100,0,0,100
War Machine,2008-05-24,Yoshiyuki Yoshida,Submission,0,0,0,0
Jared Rollins,2007-12-08,War Machine,KO/TKO,0,11,0,11
Jack Shore,2019-09-28,Nohelin Hernandez,Submission,90,40,0,130
Jack Shore,2020-07-15,Aaron Phillips,Submission,90,23,0,113
Jack Shore,2024-05-04,Joanderson Brito,TKO - Doctor's Stoppage,0,0,0,0
Jack Shore,2022-07-16,Ricky Simon,Submission,0,0,0,0
Jack Shore,2022-03-19,Timur Valiev,Decision - Unanimous,80,0,0,80
Jack Shore,2024-11-02,Youssef Zalal,Submission,0,0,0,0
Jack Shore,2021-09-04,Liudvik Sholinian,Decision - Unanimous,80,73,0,153
Jack Shore,2021-04-10,Hunter Azure,Decision - Split,70,0,0,70
Jack Shore,2023-03-18,Makwan Amirkhani,Submission,90,18,0,108
Nohelin Hernandez,2019-09-28,Jack Shore,Submission,0,0,0,0
Nohelin Hernandez,2019-07-06,Marlon Vera,Submission,0,12,0,12
Amir Sadollah,2009-11-21,Phil Baroni,Decision - Unanimous,80,83,0,163
Amir Sadollah,2011-03-26,DaMarques Johnson,KO/TKO,100,35,0,135
Amir Sadollah,2010-01-11,Brad Blackburn,Decision - Unanimous,80,50,0,130
Amir Sadollah,2010-05-29,Dong Hyun Kim,Decision - Unanimous,0,0,0,0
Amir Sadollah,2010-11-13,Peter Sobotta,Decision - Unanimous,80,56,0,136
Amir Sadollah,2009-08-08,Johny Hendricks,KO/TKO,0,0,0,0
Amir Sadollah,2014-09-20,Yoshihiro Akiyama,Decision - Unanimous,0,0,0,0
Amir Sadollah,2012-09-29,Dan Hardy,Decision - Unanimous,0,0,0,0
Amir Sadollah,2012-05-15,Jorge Lopez,Decision - Split,70,4,0,74
Amir Sadollah,2011-08-14,Duane Ludwig,Decision - Unanimous,0,0,0,0
Amir Sadollah,2008-06-21,CB Dollaway,Submission,90,0,0,90
Phil Baroni,2009-11-21,Amir Sadollah,Decision - Unanimous,0,0,0,0
Phil Baroni,2011-01-01,Brad Tavares,KO/TKO,0,0,0,0
Phil Baroni,2001-11-02,Matt Lindland,Decision - Majority,0,0,0,0
Phil Baroni,2005-05-22,Ikuhisa Minowa,KO/TKO,100,30,0,130
Phil Baroni,2012-12-31,Hayato Sakurai,Decision - Unanimous,0,0,0,0
Phil Baroni,2003-11-21,Evan Tanner,KO/TKO,0,0,0,0
Phil Baroni,2005-09-25,Ikuhisa Minowa,Decision - Unanimous,0,10,0,10
Phil Baroni,2001-02-23,Curtis Stout,Decision - Unanimous,80,37,0,117
Phil Baroni,2005-02-05,Pete Sell,Submission,0,1,0,1
Phil Baroni,2009-06-06,Joe Riggs,Decision - Unanimous,0,0,0,0
Phil Baroni,2006-06-04,Kazuo Misaki,Decision - Unanimous,0,0,0,0
Phil Baroni,2003-02-28,Matt Lindland,Decision - Unanimous,0,4,0,4
Phil Baroni,2004-06-19,Evan Tanner,Decision - Unanimous,0,0,0,0
Phil Baroni,2008-05-31,Joey Villasenor,KO/TKO,0,0,0,0
Phil Baroni,2006-10-21,Yosuke Nishijima,Submission,90,14,0,104
Phil Baroni,2007-06-22,Frank Shamrock,Submission,0,0,25,25
Phil Baroni,2002-05-10,Amar Suloev,KO/TKO,100,2,0,102
Phil Baroni,2002-09-27,Dave Menne,KO/TKO,100,7,0,107
Phil Baroni,2006-04-02,Yuki Kondo,KO/TKO,100,9,0,109
Phil Baroni,2005-07-17,Ryo Chonan,KO/TKO,100,0,0,100
Te Edwards,2018-06-26,Austin Tweedy,KO/TKO,100,1,0,101
Te Edwards,2018-10-27,Don Madge,KO/TKO,0,0,0,0
Te Edwards,2019-01-19,Dennis Bermudez,Decision - Unanimous,0,0,0,0
Austin Tweedy,2018-06-26,Te Edwards,KO/TKO,0,0,0,0
Matt Wiman,2008-01-23,Justin Buchholz,Submission,90,3,0,93
Matt Wiman,2013-01-26,TJ Grant,KO/TKO,0,0,0,0
Matt Wiman,2009-04-18,Sam Stout,Decision - Unanimous,0,0,0,0
Matt Wiman,2011-01-22,Cole Miller,Decision - Unanimous,80,54,0,134
Matt Wiman,2008-12-10,Jim Miller,Decision - Unanimous,0,0,0,0
Matt Wiman,2010-06-12,Mac Danzig,Submission,90,0,0,90
Matt Wiman,2011-07-02,Dennis Siver,Decision - Unanimous,0,0,0,0
Matt Wiman,2019-06-22,Luis Pena,KO/TKO,0,0,0,0
Matt Wiman,2019-12-07,Joe Solecki,Decision - Unanimous,0,0,0,0
Matt Wiman,2014-11-22,Isaac Vallie-Flagg,Decision - Unanimous,80,0,0,80
Matt Wiman,2008-06-07,Thiago Tavares,KO/TKO,100,5,0,105
Matt Wiman,2009-12-12,Shane Nelson,Decision - Unanimous,80,35,0,115
Matt Wiman,2006-05-27,Spencer Fisher,KO/TKO,0,0,0,0
Matt Wiman,2020-12-05,Jordan Leavitt,KO/TKO,0,0,0,0
Matt Wiman,2007-09-22,Michihiro Omigawa,Decision - Unanimous,80,26,0,106
Matt Wiman,2007-06-23,Brian Geraghty,KO/TKO,100,20,0,120
Matt Wiman,2011-10-01,Mac Danzig,Decision - Unanimous,80,27,0,107
Matt Wiman,2012-09-29,Paul Sass,Submission,90,0,0,90
Justin Buchholz,2008-01-23,Matt Wiman,Submission,0,0,0,0
Justin Buchholz,2008-07-05,Corey Hill,Submission,90,0,0,90
Justin Buchholz,2009-09-16,Jeremy Stephens,TKO - Doctor's Stoppage,0,0,0,0
Justin Buchholz,2010-02-06,Mac Danzig,Decision - Unanimous,0,0,0,0
Justin Buchholz,2009-06-13,Terry Etim,Submission,0,0,0,0
Justin Tafa,2021-12-18,Harry Hunsucker,KO/TKO,100,0,0,100
Justin Tafa,2023-09-09,Austen Lane,KO/TKO,100,4,0,104
Justin Tafa,2023-02-11,Parker Porter,KO/TKO,100,1,0,101
Justin Tafa,2024-03-23,Karl Williams,Decision - Unanimous,0,0,0,0
Justin Tafa,2019-10-05,Yorgan De Castro,KO/TKO,0,2,0,2
Justin Tafa,2020-02-08,Juan Adams,KO/TKO,100,3,0,103
Justin Tafa,2021-05-22,Jared Vanderaa,Decision - Unanimous,0,0,0,0
Justin Tafa,2021-01-16,Carlos Felipe,Decision - Split,0,9,0,9
Harry Hunsucker,2021-12-18,Justin Tafa,KO/TKO,0,0,0,0
Harry Hunsucker,2020-11-04,Jared Vanderaa,KO/TKO,0,0,0,0
Harry Hunsucker,2021-03-20,Tai Tuivasa,KO/TKO,0,0,0,0
Harry Hunsucker,2022-08-20,Tyson Pedro,KO/TKO,0,0,0,0
Ian Machado Garry,2024-06-29,Michael Page,Decision - Unanimous,80,0,0,80
Ian Machado Garry,2023-03-04,Song Kenan,KO/TKO,100,72,0,172
Ian Machado Garry,2023-05-13,Daniel Rodriguez,KO/TKO,100,16,0,116
Ian Machado Garry,2024-02-17,Geoff Neal,Decision - Split,70,21,0,91
Ian Machado Garry,2023-08-19,Neil Magny,Decision - Unanimous,80,64,0,144
Ian Machado Garry,2021-11-06,Jordan Williams,KO/TKO,100,0,0,100
Ian Machado Garry,2022-07-02,Gabe Green,Decision - Unanimous,80,26,0,106
Ian Machado Garry,2022-04-09,Darian Weeks,Decision - Unanimous,80,34,0,114
Ian Machado Garry,2024-12-07,Shavkat Rakhmonov,Decision - Unanimous,0,5,25,30
Michael Page,2024-06-29,Ian Machado Garry,Decision - Unanimous,0,2,0,2
Michael Page,2024-03-09,Kevin Holland,Decision - Unanimous,80,12,0,92
Devin Cole,2011-07-22,Shawn Jordan,Decision - Unanimous,80,31,0,111
Devin Cole,2011-01-07,Daniel Cormier,Decision - Unanimous,0,0,0,0
Devin Cole,2006-01-13,Mike Kyle,KO/TKO,100,51,0,151
Devin Cole,2006-12-29,Ben Rothwell,KO/TKO,0,0,0,0
Shawn Jordan,2011-07-22,Devin Cole,Decision - Unanimous,0,0,0,0
Shawn Jordan,2013-10-19,Gabriel Gonzaga,KO/TKO,0,0,0,0
Shawn Jordan,2013-01-26,Mike Russow,KO/TKO,100,17,0,117
Shawn Jordan,2015-01-03,Jared Cannonier,KO/TKO,100,2,0,102
Shawn Jordan,2014-03-01,Matt Mitrione,KO/TKO,0,0,0,0
Shawn Jordan,2012-03-02,Oli Thompson,KO/TKO,100,35,0,135
Shawn Jordan,2012-07-21,Cheick Kongo,Decision - Unanimous,0,0,0,0
Shawn Jordan,2015-06-06,Derrick Lewis,KO/TKO,100,17,0,117
Shawn Jordan,2015-10-03,Ruslan Magomedov,Decision - Unanimous,0,0,0,0
Shawn Jordan,2013-06-15,Pat Barry,KO/TKO,100,8,0,108
Shawn Jordan,2014-08-16,Jack May,KO/TKO,100,12,0,112
Shawn Jordan,2011-09-23,Lavar Johnson,Submission,90,0,0,90
Sumudaerji,2023-12-09,Tim Elliott,Submission,0,0,0,0
Sumudaerji,2021-01-20,Zarrukh Adashev,Decision - Unanimous,80,22,0,102
Sumudaerji,2022-07-16,Matt Schnell,Submission,0,11,0,11
Sumudaerji,2018-11-24,Louis Smolka,Submission,0,0,0,0
Sumudaerji,2020-11-28,Malcolm Gordon,KO/TKO,100,9,0,109
Sumudaerji,2024-10-19,Charles Johnson,Decision - Unanimous,0,10,0,10
Sumudaerji,2019-08-31,Andre Soukhamthath,Decision - Unanimous,80,70,0,150
Joshua Burkman,2006-01-16,Drew Fickett,Submission,90,5,0,95
Joshua Burkman,2006-04-06,Jon Fitch,Submission,0,0,0,0
Joshua Burkman,2005-11-05,Sammy Morgan,KO/TKO,100,3,0,103
Joshua Burkman,2016-02-06,KJ Noons,Decision - Unanimous,80,24,0,104
Joshua Burkman,2008-10-25,Pete Sell,Decision - Unanimous,0,0,0,0
Joshua Burkman,2015-05-23,Dong Hyun Kim,Submission,0,0,0,0
Joshua Burkman,2007-10-20,Forrest Petz,Decision - Split,70,0,0,70
Joshua Burkman,2008-06-21,Dustin Hazelett,Submission,0,21,0,21
Joshua Burkman,2016-05-29,Paul Felder,Decision - Unanimous,0,0,0,0
Joshua Burkman,2018-02-18,Alex Morono,Submission,0,0,0,0
Joshua Burkman,2007-01-25,Chad Reiner,Decision - Unanimous,80,21,0,101
Joshua Burkman,2015-08-23,Patrick Cote,KO/TKO,0,0,0,0
Joshua Burkman,2017-07-29,Drew Dober,KO/TKO,0,0,0,0
Joshua Burkman,2007-05-26,Karo Parisyan,Decision - Unanimous,0,0,0,0
Joshua Burkman,2016-10-01,Zak Ottow,Decision - Split,0,0,0,0
Joshua Burkman,2008-01-23,Mike Swick,Decision - Majority,0,0,0,0
Joshua Burkman,2017-03-11,Michel Prazeres,Submission,0,0,0,0
Joshua Burkman,2006-07-08,Josh Neer,Decision - Unanimous,80,16,0,96
Drew Fickett,2006-01-16,Joshua Burkman,Submission,0,0,0,0
Drew Fickett,2005-10-03,Josh Koscheck,Submission,90,0,0,90
Drew Fickett,2005-02-05,Nick Diaz,KO/TKO,0,0,0,0
Drew Fickett,2008-03-29,Jae Suk Lim,Submission,90,2,0,92
Drew Fickett,2006-07-08,Kurt Pellegrino,Submission,90,0,0,90
Drew Fickett,2006-12-13,Karo Parisyan,Decision - Unanimous,0,0,0,0
Drew Fickett,2005-08-06,Josh Neer,Submission,90,1,0,91
Drew Fickett,2007-04-05,Keita Nakamura,Decision - Unanimous,80,47,0,127
Drew Fickett,2011-07-16,Tatsuya Kawajiri,KO/TKO,0,0,0,0
Andre Soukhamthath,2017-12-09,Luke Sanders,KO/TKO,100,0,0,100
Andre Soukhamthath,2018-03-03,Sean O'Malley,Decision - Unanimous,0,0,0,0
Andre Soukhamthath,2018-10-27,Jonathan Martinez,Decision - Unanimous,80,8,0,88
Andre Soukhamthath,2019-04-13,Montel Jackson,Decision - Unanimous,0,0,0,0
Andre Soukhamthath,2017-08-05,Alejandro Perez,Decision - Split,0,0,0,0
Andre Soukhamthath,2017-03-04,Albert Morales,Decision - Split,0,0,0,0
Andre Soukhamthath,2019-08-31,Sumudaerji,Decision - Unanimous,0,0,0,0
Luke Sanders,2017-12-09,Andre Soukhamthath,KO/TKO,0,3,0,3
Luke Sanders,2020-11-28,Nate Maness,Submission,0,22,0,22
Luke Sanders,2016-01-17,Maximo Blanco,Submission,90,10,0,100
Luke Sanders,2019-02-17,Renan Barao,KO/TKO,100,0,0,100
Luke Sanders,2018-08-25,Rani Yahya,Submission,0,0,0,0
Luke Sanders,2017-03-04,Iuri Alcantara,Submission,0,71,0,71
Luke Sanders,2018-04-14,Patrick Williams,Decision - Unanimous,80,0,0,80
Luke Sanders,2021-05-01,Felipe Colares,Decision - Unanimous,0,40,0,40
Brad Tavares,2011-01-01,Phil Baroni,KO/TKO,100,11,0,111
Brad Tavares,2014-04-19,Yoel Romero,Decision - Unanimous,0,0,0,0
Brad Tavares,2011-07-02,Aaron Simpson,Decision - Unanimous,0,0,0,0
Brad Tavares,2024-02-10,Gregory Rodrigues,KO/TKO,0,0,0,0
Brad Tavares,2012-09-29,Tom Watson,Decision - Split,70,18,0,88
Brad Tavares,2023-04-22,Bruno Silva,KO/TKO,0,0,0,0
Brad Tavares,2016-09-10,Caio Magalhaes,Decision - Split,70,20,0,90
Brad Tavares,2013-03-02,Riki Fukuda,Decision - Unanimous,80,47,0,127
Brad Tavares,2015-01-03,Nate Marquardt,Decision - Unanimous,80,20,0,100
Brad Tavares,2019-11-02,Edmen Shahbazyan,KO/TKO,0,0,0,0
Brad Tavares,2021-01-23,Antonio Carlos Junior,Decision - Unanimous,80,20,0,100
Brad Tavares,2014-01-15,Lorenz Larkin,Decision - Unanimous,80,6,0,86
Brad Tavares,2013-08-28,Robert McDaniel,Decision - Unanimous,80,16,0,96
Brad Tavares,2014-08-16,Tim Boetsch,KO/TKO,0,10,0,10
Brad Tavares,2015-05-09,Robert Whittaker,KO/TKO,0,0,0,0
Brad Tavares,2024-10-12,JunYong Park,Decision - Split,0,0,0,0
Brad Tavares,2017-07-07,Elias Theodorou,Decision - Unanimous,80,0,0,80
Brad Tavares,2022-07-02,Dricus Du Plessis,Decision - Unanimous,0,0,0,0
Brad Tavares,2010-06-19,Seth Baczynski,Decision - Unanimous,80,0,0,80
Brad Tavares,2012-05-15,Dongi Yang,Decision - Unanimous,80,7,0,87
Brad Tavares,2018-07-06,Israel Adesanya,Decision - Unanimous,0,0,25,25
Brad Tavares,2017-10-07,Thales Leites,Decision - Unanimous,80,24,0,104
Brad Tavares,2021-07-10,Omari Akhmedov,Decision - Split,70,36,0,106
Brad Tavares,2023-08-19,Chris Weidman,Decision - Unanimous,80,33,0,113
Brad Tavares,2018-04-14,Krzysztof Jotko,KO/TKO,100,22,0,122
Rulon Gardner,2004-12-31,Hidehiko Yoshida,Decision - Unanimous,80,12,0,92
Hidehiko Yoshida,2004-12-31,Rulon Gardner,Decision - Unanimous,0,0,0,0
Hidehiko Yoshida,2003-11-09,Wanderlei Silva,Decision - Unanimous,0,0,0,0
Hidehiko Yoshida,2003-08-10,Kiyoshi Tamura,Submission,90,0,0,90
Hidehiko Yoshida,2006-12-31,James Thompson,KO/TKO,0,0,0,0
Hidehiko Yoshida,2006-07-01,Mirko Filipovic,KO/TKO,0,0,0,0
Hidehiko Yoshida,2005-12-31,Naoya Ogawa,Submission,90,3,0,93
Hidehiko Yoshida,2009-12-31,Satoshi Ishii,Decision - Unanimous,80,0,0,80
Hidehiko Yoshida,2006-05-05,Yosuke Nishijima,Submission,90,1,0,91
Hidehiko Yoshida,2004-06-20,Mark Hunt,Submission,90,0,0,90
Hidehiko Yoshida,2005-04-23,Wanderlei Silva,Decision - Split,0,0,0,0
Hidehiko Yoshida,2002-11-24,Don Frye,Submission,90,0,0,90
Hidehiko Yoshida,2005-08-28,David Abbott,Submission,90,12,0,102
Shara Magomedov,2024-06-22,Antonio Trocoli,KO/TKO,100,66,0,166
Shara Magomedov,2024-08-03,Michal Oleksiejczuk,Decision - Unanimous,80,20,0,100
Shara Magomedov,2023-10-21,Bruno Silva,Decision - Unanimous,80,48,0,128
Shara Magomedov,2024-10-26,Armen Petrosyan,KO/TKO,100,0,0,100
Antonio Trocoli,2024-06-22,Shara Magomedov,KO/TKO,0,0,0,0
Antonio Trocoli,2024-11-09,Tresean Gore,Submission,0,0,0,0
Sijara Eubanks,2020-05-13,Sarah Moras,Decision - Unanimous,80,41,0,121
Sijara Eubanks,2020-09-26,Ketlen Vieira,Decision - Unanimous,0,1,0,1
Sijara Eubanks,2021-12-18,Melissa Gatto,KO/TKO,0,0,0,0
Sijara Eubanks,2020-09-12,Julia Avila,Decision - Unanimous,80,19,0,99
Sijara Eubanks,2019-09-21,Bethe Correia,Decision - Unanimous,0,18,0,18
Sijara Eubanks,2021-07-24,Elise Reed,KO/TKO,100,21,0,121
Sijara Eubanks,2018-06-01,Lauren Murphy,Decision - Unanimous,80,26,0,106
Sijara Eubanks,2018-11-03,Roxanne Modafferi,Decision - Unanimous,80,29,0,109
Sijara Eubanks,2020-12-19,Pannie Kianzad,Decision - Unanimous,0,0,0,0
Sijara Eubanks,2019-05-18,Aspen Ladd,Decision - Unanimous,0,8,0,8
Sarah Moras,2020-05-13,Sijara Eubanks,Decision - Unanimous,0,0,0,0
Sarah Moras,2014-07-06,Alexis Dufresne,Decision - Unanimous,80,3,0,83
Sarah Moras,2015-07-15,Jessica Andrade,Decision - Unanimous,0,0,0,0
Sarah Moras,2017-09-09,Ashlee Evans-Smith,Submission,90,0,0,90
Sarah Moras,2021-01-16,Vanessa Melo,Decision - Unanimous,0,0,0,0
Sarah Moras,2019-09-07,Liana Jojua,KO/TKO,100,25,0,125
Sarah Moras,2018-10-27,Talita Bernardo,Decision - Unanimous,0,0,0,0
Sarah Moras,2019-05-04,Macy Chiasson,KO/TKO,0,0,0,0
Sarah Moras,2018-02-18,Lucie Pudilova,Decision - Unanimous,0,0,0,0
Azamat Murzakanov,2024-08-03,Alonzo Menifield,KO/TKO,100,30,0,130
Azamat Murzakanov,2022-03-12,Tafon Nchukwi,KO/TKO,100,0,0,100
Azamat Murzakanov,2022-08-13,Devin Clark,KO/TKO,100,65,0,165
Azamat Murzakanov,2023-04-15,Dustin Jacoby,Decision - Unanimous,80,3,0,83
Azamat Murzakanov,2021-08-31,Matheus Scheffel,KO/TKO,100,5,0,105
Alonzo Menifield,2024-08-03,Azamat Murzakanov,KO/TKO,0,0,0,0
Alonzo Menifield,2017-07-25,Daniel Jolly,TKO - Doctor's Stoppage,0,1,0,1
Alonzo Menifield,2021-08-07,Ed Herman,Decision - Unanimous,80,52,0,132
Alonzo Menifield,2019-06-29,Paul Craig,KO/TKO,100,1,0,101
Alonzo Menifield,2018-06-12,Dashawn Boatwright,KO/TKO,100,7,0,107
Alonzo Menifield,2024-05-11,Carlos Ulberg,KO/TKO,0,0,0,0
Alonzo Menifield,2022-06-04,Askar Mozharov,KO/TKO,100,17,0,117
Alonzo Menifield,2019-01-19,Vinicius Moreira,KO/TKO,100,22,0,122
Alonzo Menifield,2023-07-08,Jimmy Crute,Submission,90,0,0,90
Alonzo Menifield,2020-06-06,Devin Clark,Decision - Unanimous,0,0,0,0
Alonzo Menifield,2022-10-15,Misha Cirkunov,KO/TKO,100,3,0,103
Alonzo Menifield,2023-12-16,Dustin Jacoby,Decision - Unanimous,80,0,0,80
Alonzo Menifield,2021-03-27,Fabio Cherant,Submission,90,3,0,93
Alonzo Menifield,2021-12-04,William Knight,Decision - Unanimous,0,0,0,0
Alonzo Menifield,2020-09-05,Ovince Saint Preux,KO/TKO,0,0,0,0
Cory Sandhagen,2019-08-17,Raphael Assuncao,Decision - Unanimous,80,17,0,97
Cory Sandhagen,2018-01-27,Austin Arnett,KO/TKO,100,48,0,148
Cory Sandhagen,2019-01-19,Mario Bautista,Submission,90,8,0,98
Cory Sandhagen,2022-09-17,Song Yadong,TKO - Doctor's Stoppage,0,40,25,65
Cory Sandhagen,2020-06-06,Aljamain Sterling,Submission,0,0,0,0
Cory Sandhagen,2019-04-27,John Lineker,Decision - Split,70,14,0,84
Cory Sandhagen,2021-02-06,Frankie Edgar,KO/TKO,100,0,0,100
Cory Sandhagen,2020-10-10,Marlon Moraes,KO/TKO,100,24,25,149
Cory Sandhagen,2023-08-05,Rob Font,Decision - Unanimous,80,25,25,130
Cory Sandhagen,2018-08-25,Iuri Alcantara,KO/TKO,100,57,0,157
Cory Sandhagen,2023-03-25,Marlon Vera,Decision - Split,70,70,25,165
Cory Sandhagen,2024-08-03,Umar Nurmagomedov,Decision - Unanimous,0,0,25,25
Cory Sandhagen,2021-07-24,TJ Dillashaw,Decision - Split,0,18,25,43
Cory Sandhagen,2021-10-30,Petr Yan,Decision - Unanimous,0,20,25,45
Raphael Assuncao,2019-08-17,Cory Sandhagen,Decision - Unanimous,0,0,0,0
Raphael Assuncao,2014-02-22,Pedro Munhoz,Decision - Unanimous,80,67,0,147
Raphael Assuncao,2013-06-08,Vaughan Lee,Submission,90,3,0,93
Raphael Assuncao,2010-06-20,Diego Nunes,Decision - Split,0,0,0,0
Raphael Assuncao,2010-11-11,LC Davis,Decision - Unanimous,80,29,0,109
Raphael Assuncao,2016-07-09,TJ Dillashaw,Decision - Unanimous,0,0,0,0
Raphael Assuncao,2012-12-08,Mike Easton,Decision - Unanimous,80,27,0,107
Raphael Assuncao,2012-07-11,Issei Tamura,KO/TKO,100,34,0,134
Raphael Assuncao,2021-12-18,Ricky Simon,KO/TKO,0,0,0,0
Raphael Assuncao,2013-10-09,TJ Dillashaw,Decision - Split,70,3,0,73
Raphael Assuncao,2022-10-15,Victor Henry,Decision - Unanimous,80,5,0,85
Raphael Assuncao,2023-03-11,Davey Grant,Submission,0,0,0,0
Raphael Assuncao,2011-08-27,Johnny Eduardo,Decision - Unanimous,80,25,0,105
Raphael Assuncao,2017-01-28,Aljamain Sterling,Decision - Split,70,0,0,70
Raphael Assuncao,2009-10-10,Yves Jabouin,Decision - Split,70,9,0,79
Raphael Assuncao,2010-01-10,Urijah Faber,Submission,0,0,0,0
Raphael Assuncao,2019-02-02,Marlon Moraes,Submission,0,0,25,25
Raphael Assuncao,2017-06-03,Marlon Moraes,Decision - Split,70,0,0,70
Raphael Assuncao,2011-03-19,Erik Koch,KO/TKO,0,5,0,5
Raphael Assuncao,2017-11-11,Matthew Lopez,KO/TKO,100,12,0,112
Raphael Assuncao,2018-07-07,Rob Font,Decision - Unanimous,80,34,0,114
Raphael Assuncao,2009-04-05,Jameel Massouh,Decision - Unanimous,80,34,0,114
Raphael Assuncao,2020-06-06,Cody Garbrandt,KO/TKO,0,0,0,0
Raphael Assuncao,2014-10-04,Bryan Caraway,Decision - Unanimous,80,36,0,116
Jeff Monson,2006-04-15,Marcio Cruz,Decision - Split,70,0,0,70
Jeff Monson,2006-02-04,Branden Lee Hinkle,Submission,90,5,0,95
Jeff Monson,2006-07-08,Anthony Perosh,KO/TKO,100,10,0,110
Jeff Monson,2000-12-16,Chuck Liddell,Decision - Unanimous,0,0,0,0
Jeff Monson,2011-06-18,Daniel Cormier,Decision - Unanimous,0,0,0,0
Jeff Monson,2007-04-08,Kazuyuki Fujita,Submission,90,1,0,91
Jeff Monson,2009-04-05,Sergei Kharitonov,Submission,90,0,0,90
Jeff Monson,2006-11-18,Tim Sylvia,Decision - Unanimous,0,0,25,25
Jeff Monson,2011-11-20,Fedor Emelianenko,Decision - Unanimous,0,0,0,0
Jeff Monson,2002-01-11,Ricco Rodriguez,KO/TKO,0,0,0,0
Jeff Monson,2000-09-22,Tim Lajcik,Decision - Unanimous,80,26,0,106
Frank Mir,2016-03-19,Mark Hunt,KO/TKO,0,0,25,25
Frank Mir,2008-02-02,Brock Lesnar,Submission,90,0,0,90
Frank Mir,2007-08-25,Antoni Hardonk,Submission,90,3,0,93
Frank Mir,2004-06-19,Tim Sylvia,Submission,90,1,25,116
Frank Mir,2011-05-28,Roy Nelson,Decision - Unanimous,80,25,0,105
Frank Mir,2006-11-18,Brandon Vera,KO/TKO,0,0,0,0
Frank Mir,2003-06-06,Wes Sims,DQ,0,3,0,3
Frank Mir,2013-08-31,Josh Barnett,KO/TKO,0,0,0,0
Frank Mir,2009-12-12,Cheick Kongo,Submission,90,2,0,92
Frank Mir,2003-02-28,David Abbott,Submission,90,0,0,90
Frank Mir,2006-07-08,Dan Christison,Decision - Unanimous,80,5,0,85
Frank Mir,2011-12-10,Antonio Rodrigo Nogueira,Submission,90,0,0,90
Frank Mir,2009-07-11,Brock Lesnar,KO/TKO,0,0,25,25
Frank Mir,2002-03-22,Pete Williams,Submission,90,4,0,94
Frank Mir,2015-09-05,Andrei Arlovski,Decision - Unanimous,0,0,0,0
Frank Mir,2014-02-01,Alistair Overeem,Decision - Unanimous,0,0,0,0
Frank Mir,2001-11-02,Roberto Traven,Submission,90,2,0,92
Frank Mir,2010-03-27,Shane Carwin,KO/TKO,0,0,25,25
Frank Mir,2013-04-20,Daniel Cormier,Decision - Unanimous,0,0,0,0
Frank Mir,2004-01-31,Wes Sims,KO/TKO,100,10,0,110
Frank Mir,2006-02-04,Marcio Cruz,KO/TKO,0,0,0,0
Frank Mir,2012-05-26,Junior Dos Santos,KO/TKO,0,0,25,25
Frank Mir,2015-07-15,Todd Duffee,KO/TKO,100,7,25,132
Frank Mir,2010-09-25,Mirko Filipovic,KO/TKO,100,6,0,106
Frank Mir,2002-07-13,Ian Freeman,KO/TKO,0,0,0,0
Frank Mir,2015-02-22,Antonio Silva,KO/TKO,100,9,25,134
Frank Mir,2008-12-27,Antonio Rodrigo Nogueira,KO/TKO,100,27,25,152
Melvin Guillard,2010-02-06,Ronys Torres,Decision - Unanimous,80,28,0,108
Melvin Guillard,2005-11-05,Marcus Davis,TKO - Doctor's Stoppage,0,16,0,16
Melvin Guillard,2007-04-05,Joe Stevenson,Submission,0,0,0,0
Melvin Guillard,2006-01-16,Josh Neer,Submission,0,8,0,8
Melvin Guillard,2009-06-20,Gleison Tibau,Decision - Split,70,0,0,70
Melvin Guillard,2011-10-08,Joe Lauzon,Submission,0,1,0,1
Melvin Guillard,2012-01-20,Jim Miller,Submission,0,12,0,12
Melvin Guillard,2010-09-25,Jeremy Stephens,Decision - Split,70,11,0,81
Melvin Guillard,2013-07-27,Mac Danzig,KO/TKO,100,16,0,116
Melvin Guillard,2012-08-11,Donald Cerrone,KO/TKO,0,6,0,6
Melvin Guillard,2014-03-08,Michael Johnson,Decision - Unanimous,0,0,0,0
Melvin Guillard,2011-01-22,Evan Dunham,KO/TKO,100,15,0,115
Melvin Guillard,2010-05-29,Waylon Lowe,KO/TKO,100,13,0,113
Melvin Guillard,2006-09-23,Gabe Ruediger,KO/TKO,100,13,0,113
Melvin Guillard,2006-05-27,Rick Davis,KO/TKO,100,5,0,105
Melvin Guillard,2007-12-29,Rich Clementi,Submission,0,0,0,0
Melvin Guillard,2011-07-02,Shane Roller,KO/TKO,100,16,0,116
Melvin Guillard,2008-07-05,Dennis Siver,KO/TKO,100,10,0,110
Melvin Guillard,2009-09-16,Nate Diaz,Submission,0,0,0,0
Melvin Guillard,2012-12-29,Jamie Varner,Decision - Split,0,25,0,25
Melvin Guillard,2012-07-07,Fabricio Camoes,Decision - Unanimous,80,19,0,99
Ronys Torres,2010-02-06,Melvin Guillard,Decision - Unanimous,0,0,0,0
Ronys Torres,2010-03-31,Jacob Volkmann,Decision - Split,0,0,0,0
Genki Sudo,2002-07-13,Leigh Remedios,Submission,90,4,0,94
Genki Sudo,2003-04-25,Duane Ludwig,Decision - Unanimous,0,0,0,0
Genki Sudo,2004-04-02,Mike Brown,Submission,90,0,0,90
Leigh Remedios,2002-07-13,Genki Sudo,Submission,0,0,0,0
Phil Rowe,2021-07-31,Orion Cosce,KO/TKO,100,24,0,124
Phil Rowe,2023-06-24,Neil Magny,Decision - Split,0,5,0,5
Phil Rowe,2024-06-01,Jake Matthews,Decision - Unanimous,0,0,0,0
Phil Rowe,2022-12-03,Niko Price,KO/TKO,100,0,0,100
Phil Rowe,2019-08-20,Leon Shahbazyan,KO/TKO,100,19,0,119
Phil Rowe,2021-02-13,Gabe Green,Decision - Unanimous,0,0,0,0
Phil Rowe,2022-02-05,Jason Witt,KO/TKO,100,0,0,100
Orion Cosce,2021-07-31,Phil Rowe,KO/TKO,0,0,0,0
Orion Cosce,2020-08-18,Matt Dixon,KO/TKO,100,38,0,138
Orion Cosce,2023-05-20,Gilbert Urbina,KO/TKO,0,0,0,0
Orion Cosce,2022-07-30,Blood Diamond,Decision - Unanimous,80,0,0,80
Evan Tanner,1999-01-08,Darrel Gholar,Submission,90,20,0,110
Evan Tanner,2001-02-23,Tito Ortiz,KO/TKO,0,0,25,25
Evan Tanner,2006-04-15,Justin Levens,Submission,90,8,0,98
Evan Tanner,2002-07-13,Chris Haseman,Decision - Unanimous,80,56,0,136
Evan Tanner,2003-11-21,Phil Baroni,KO/TKO,100,11,0,111
Evan Tanner,2003-04-25,Rich Franklin,KO/TKO,0,0,0,0
Evan Tanner,2005-06-04,Rich Franklin,TKO - Doctor's Stoppage,0,0,25,25
Evan Tanner,2008-06-21,Kendall Grove,Decision - Split,0,0,0,0
Evan Tanner,2004-10-22,Robbie Lawler,Submission,90,3,0,93
Evan Tanner,2001-11-02,Homer Moore,Submission,90,0,0,90
Evan Tanner,2005-02-05,David Terrell,KO/TKO,100,15,25,140
Evan Tanner,2004-06-19,Phil Baroni,Decision - Unanimous,80,50,0,130
Evan Tanner,2005-10-03,David Loiseau,TKO - Doctor's Stoppage,0,2,0,2
Evan Tanner,1999-03-05,Valeri Ignatov,KO/TKO,100,21,0,121
Evan Tanner,2002-03-22,Elvis Sinosic,TKO - Doctor's Stoppage,0,3,0,3
Evan Tanner,2008-03-01,Yushin Okami,KO/TKO,0,0,0,0
Evan Tanner,2000-12-16,Lance Gibson,KO/TKO,100,26,0,126
Darrel Gholar,1999-01-08,Evan Tanner,Submission,0,0,0,0
Mark Coleman,1999-11-21,Ricardo Morais,Decision - Unanimous,80,9,0,89
Mark Coleman,2010-02-06,Randy Couture,Submission,0,0,0,0
Mark Coleman,2009-07-11,Stephan Bonnar,Decision - Unanimous,80,0,0,80
Mark Coleman,2003-06-08,Don Frye,Decision - Unanimous,80,34,0,114
Mark Coleman,1996-07-12,Moti Horenstein,KO/TKO,100,25,0,125
Mark Coleman,1996-07-12,Gary Goodridge,Submission,90,30,0,120
Mark Coleman,1996-09-20,Brian Johnston,KO/TKO,100,6,0,106
Mark Coleman,1996-09-20,Julian Sanchez,Submission,90,7,0,97
Mark Coleman,2006-02-26,Mauricio Rua,KO/TKO,100,0,0,100
Mark Coleman,1998-05-15,Pete Williams,KO/TKO,0,4,0,4
Mark Coleman,2004-04-25,Fedor Emelianenko,Submission,0,1,0,1
Mark Coleman,2001-03-25,Allan Goes,KO/TKO,100,10,0,110
Mark Coleman,2005-10-09,Milco Voorn,Submission,90,0,0,90
Mark Coleman,2000-05-01,Igor Vovchanchyn,KO/TKO,100,60,0,160
Mark Coleman,1999-01-08,Pedro Rizzo,Decision - Split,0,9,0,9
Mark Coleman,2000-01-30,Masaaki Satake,Submission,90,9,0,99
Mark Coleman,2001-09-24,Antonio Rodrigo Nogueira,Submission,0,0,0,0
Mark Coleman,1996-07-12,Don Frye,KO/TKO,100,33,0,133
Mark Coleman,2005-02-20,Mirko Filipovic,KO/TKO,0,0,0,0
Mark Coleman,1999-04-29,Nobuhiko Takada,Submission,0,14,0,14
Mark Coleman,1997-02-07,Dan Severn,Submission,90,2,0,92
Mark Coleman,2009-01-17,Mauricio Rua,KO/TKO,0,0,0,0
Mark Coleman,2000-05-01,Kazuyuki Fujita,KO/TKO,100,0,0,100
Mark Coleman,1997-07-27,Maurice Smith,Decision - Unanimous,0,0,0,0
Mark Coleman,2006-10-21,Fedor Emelianenko,Submission,0,0,0,0
Mark Coleman,2000-05-01,Akira Shoji,Decision - Unanimous,80,69,0,149
Ricardo Morais,1999-11-21,Mark Coleman,Decision - Unanimous,0,0,0,0
Ricardo Morais,2006-09-10,Tae Hyun Lee,KO/TKO,100,12,0,112
Ricardo Morais,2005-04-03,Aleksander Emelianenko,KO/TKO,0,0,0,0
Alatengheili,2022-04-16,Kevin Croom,KO/TKO,100,7,0,107
Alatengheili,2020-10-03,Casey Kenney,Decision - Unanimous,0,0,0,0
Alatengheili,2023-10-14,Chris Gutierrez,Decision - Unanimous,0,0,0,0
Alatengheili,2024-05-18,Kleydson Rodrigues,Decision - Unanimous,80,0,0,80
Alatengheili,2022-09-10,Chad Anheliger,Decision - Unanimous,80,10,0,90
Alatengheili,2019-08-31,Batgerel Danaa,Decision - Unanimous,80,0,0,80
Alatengheili,2019-12-21,Ryan Benoit,Decision - Split,70,0,0,70
Kevin Croom,2022-04-16,Alatengheili,KO/TKO,0,0,0,0
Kevin Croom,2022-01-15,Brian Kelleher,Decision - Unanimous,0,22,0,22
Kevin Croom,2021-02-27,Alex Caceres,Decision - Unanimous,0,0,0,0
Tim Kennedy,2012-07-14,Luke Rockhold,Decision - Unanimous,0,0,25,25
Tim Kennedy,2010-06-16,Trevor Prangley,Submission,90,7,0,97
Tim Kennedy,2009-06-19,Nick Thompson,KO/TKO,100,15,0,115
Tim Kennedy,2009-09-25,Zak Cummings,Submission,90,38,0,128
Tim Kennedy,2013-01-12,Trevor Smith,Submission,90,24,0,114
Tim Kennedy,2013-07-06,Roger Gracie,Decision - Unanimous,80,42,0,122
Tim Kennedy,2011-03-05,Melvin Manhoef,Submission,90,11,0,101
Tim Kennedy,2002-10-18,Mack Brewer,KO/TKO,100,7,0,107
Tim Kennedy,2010-08-21,Jacare Souza,Decision - Unanimous,0,22,25,47
Tim Kennedy,2011-07-30,Robbie Lawler,Decision - Unanimous,80,21,0,101
Tim Kennedy,2014-09-27,Yoel Romero,KO/TKO,0,0,0,0
Tim Kennedy,2014-04-16,Michael Bisping,Decision - Unanimous,80,11,25,116
Tim Kennedy,2013-11-06,Rafael Natal,KO/TKO,100,0,25,125
Tim Kennedy,2016-12-10,Kelvin Gastelum,KO/TKO,0,0,0,0
Dan Cramer,2009-01-31,Matt Arroyo,Decision - Split,70,8,0,78
Dan Cramer,2009-08-08,Matthew Riddle,Decision - Unanimous,0,0,0,0
Matt Arroyo,2009-01-31,Dan Cramer,Decision - Split,0,0,0,0
Matt Arroyo,2007-12-08,John Kolosci,Submission,90,3,0,93
Matt Arroyo,2008-06-21,Matt Brown,KO/TKO,0,0,0,0
Rodrigo Nascimento,2023-05-20,Ilir Latifi,Decision - Split,70,19,0,89
Rodrigo Nascimento,2020-05-16,Don'Tale Mayes,Submission,90,5,0,95
Rodrigo Nascimento,2024-11-02,Alexandr Romanov,Decision - Unanimous,0,0,0,0
Rodrigo Nascimento,2024-05-11,Derrick Lewis,KO/TKO,0,0,25,25
Rodrigo Nascimento,2019-07-30,Michal Martinek,Submission,90,6,0,96
Rodrigo Nascimento,2022-09-17,Tanner Boser,Decision - Split,70,0,0,70
Rodrigo Nascimento,2020-10-10,Chris Daukaus,KO/TKO,0,0,0,0
Rodrigo Nascimento,2023-11-04,Don'Tale Mayes,Decision - Unanimous,80,0,0,80
Ilir Latifi,2023-05-20,Rodrigo Nascimento,Decision - Split,0,0,0,0
Ilir Latifi,2019-08-10,Volkan Oezdemir,KO/TKO,0,0,0,0
Ilir Latifi,2022-10-01,Aleksei Oleinik,Decision - Unanimous,80,10,0,90
Ilir Latifi,2020-02-08,Derrick Lewis,Decision - Unanimous,0,0,0,0
Ilir Latifi,2015-07-18,Hans Stringer,KO/TKO,100,5,0,105
Ilir Latifi,2018-12-29,Corey Anderson,Decision - Unanimous,0,0,0,0
Ilir Latifi,2018-02-24,Ovince Saint Preux,Submission,90,18,0,108
Ilir Latifi,2014-07-19,Chris Dempsey,KO/TKO,100,15,0,115
Ilir Latifi,2017-09-09,Tyson Pedro,Decision - Unanimous,80,13,0,93
Ilir Latifi,2014-10-04,Jan Blachowicz,KO/TKO,0,0,0,0
Ilir Latifi,2014-03-08,Cyrille Diabate,Submission,90,0,0,90
Ilir Latifi,2016-09-03,Ryan Bader,KO/TKO,0,0,0,0
Ilir Latifi,2013-04-06,Gegard Mousasi,Decision - Unanimous,0,0,0,0
Ilir Latifi,2016-01-17,Sean O'Connell,KO/TKO,100,1,0,101
Ilir Latifi,2016-03-05,Gian Villante,Decision - Unanimous,80,7,0,87
Ilir Latifi,2021-06-05,Tanner Boser,Decision - Split,70,0,0,70
Benson Henderson,2015-02-14,Brandon Thatch,Submission,90,13,25,128
Benson Henderson,2013-08-31,Anthony Pettis,Submission,0,2,25,27
Benson Henderson,2011-04-30,Mark Bocek,Decision - Unanimous,80,45,0,125
Benson Henderson,2012-12-08,Nate Diaz,Decision - Unanimous,80,94,25,199
Benson Henderson,2009-04-05,Shane Roller,KO/TKO,100,12,0,112
Benson Henderson,2015-11-28,Jorge Masvidal,Decision - Split,70,9,25,104
Benson Henderson,2015-01-18,Donald Cerrone,Decision - Unanimous,0,29,0,29
Benson Henderson,2010-04-24,Donald Cerrone,Submission,90,14,25,129
Benson Henderson,2009-01-25,Anthony Njokuani,Submission,90,6,0,96
Benson Henderson,2014-01-25,Josh Thomson,Decision - Split,70,27,25,122
Benson Henderson,2012-08-11,Frankie Edgar,Decision - Split,70,0,25,95
Benson Henderson,2014-06-07,Rustam Khabilov,Submission,90,8,25,123
Benson Henderson,2013-04-20,Gilbert Melendez,Decision - Split,70,25,25,120
Benson Henderson,2011-11-12,Clay Guida,Decision - Unanimous,80,29,0,109
Benson Henderson,2011-08-14,Jim Miller,Decision - Unanimous,80,51,0,131
Benson Henderson,2012-02-25,Frankie Edgar,Decision - Unanimous,80,19,25,124
Benson Henderson,2014-08-23,Rafael Dos Anjos,KO/TKO,0,0,25,25
Benson Henderson,2009-10-10,Donald Cerrone,Decision - Unanimous,80,6,25,111
Benson Henderson,2010-12-16,Anthony Pettis,Decision - Unanimous,0,0,25,25
Benson Henderson,2010-01-10,Jamie Varner,Submission,90,0,25,115
Brandon Thatch,2015-02-14,Benson Henderson,Submission,0,0,25,25
Brandon Thatch,2016-03-05,Siyar Bahadurzada,Submission,0,0,0,0
Brandon Thatch,2016-12-30,Niko Price,Submission,0,2,0,2
Brandon Thatch,2013-08-28,Justin Edwards,KO/TKO,100,15,0,115
Brandon Thatch,2013-11-09,Paulo Thiago,KO/TKO,100,7,0,107
Brandon Thatch,2015-07-11,Gunnar Nelson,Submission,0,2,0,2
Riki Fukuda,2012-02-25,Steve Cantwell,Decision - Unanimous,80,77,0,157
Riki Fukuda,2012-11-10,Tom DeBlass,Decision - Unanimous,80,41,0,121
Riki Fukuda,2013-03-02,Brad Tavares,Decision - Unanimous,0,0,0,0
Riki Fukuda,2009-04-05,Murilo Rua,Decision - Unanimous,80,0,0,80
Riki Fukuda,2011-02-26,Nick Ring,Decision - Unanimous,0,0,0,0
Riki Fukuda,2012-07-07,Constantinos Philippou,Decision - Unanimous,0,2,0,2
Steve Cantwell,2012-02-25,Riki Fukuda,Decision - Unanimous,0,0,0,0
Steve Cantwell,2007-03-24,Brian Stann,KO/TKO,0,0,0,0
Steve Cantwell,2008-12-10,Razak Al-Hassan,Submission,90,2,0,92
Steve Cantwell,2009-09-16,Brian Stann,Decision - Unanimous,0,0,0,0
Steve Cantwell,2011-03-03,Cyrille Diabate,Decision - Unanimous,0,0,0,0
Steve Cantwell,2008-08-03,Brian Stann,KO/TKO,100,25,25,150
Steve Cantwell,2008-03-26,Tim McKenzie,Submission,90,11,0,101
Steve Cantwell,2011-10-08,Mike Massenzio,Decision - Unanimous,0,0,0,0
Steve Cantwell,2009-04-18,Luiz Cane,Decision - Unanimous,0,0,0,0
Steve Cantwell,2007-08-05,Justin McElfresh,KO/TKO,100,12,0,112
Leandro Issa,2014-12-20,Yuta Sasaki,Submission,90,17,0,107
Leandro Issa,2014-01-04,Russell Doane,Submission,0,0,0,0
Leandro Issa,2016-09-03,Taylor Lapilus,Decision - Unanimous,0,0,0,0
Leandro Issa,2014-07-06,Jumabieke Tuerxun,Submission,90,11,0,101
Leandro Issa,2015-08-01,Iuri Alcantara,Decision - Unanimous,0,0,0,0
Sarah Alpar,2019-08-13,Shanna Young,Submission,90,5,0,95
Sarah Alpar,2020-09-19,Jessica-Rose Clark,KO/TKO,0,0,0,0
Sarah Alpar,2021-09-18,Erin Blanchfield,Decision - Unanimous,0,0,0,0
Shanna Young,2019-08-13,Sarah Alpar,Submission,0,0,0,0
Shanna Young,2020-02-15,Macy Chiasson,Decision - Unanimous,0,0,0,0
Shanna Young,2021-10-02,Stephanie Egger,KO/TKO,0,0,0,0
Shanna Young,2022-04-30,Gina Mazany,KO/TKO,100,1,0,101
Shanna Young,2022-11-05,Miranda Maverick,Decision - Unanimous,0,0,0,0
Sara McMann,2013-04-27,Sheila Gaff,KO/TKO,100,1,0,101
Sara McMann,2015-08-08,Amanda Nunes,Submission,0,0,0,0
Sara McMann,2022-03-26,Karol Rosa,Decision - Unanimous,80,0,0,80
Sara McMann,2011-08-27,Raquel Pa'aluhi,Submission,90,22,0,112
Sara McMann,2016-12-03,Alexis Davis,Submission,90,0,0,90
Sara McMann,2017-02-19,Gina Mazany,Submission,90,7,0,97
Sara McMann,2016-05-29,Jessica Eye,Decision - Unanimous,80,12,0,92
Sara McMann,2017-09-09,Ketlen Vieira,Submission,0,12,0,12
Sara McMann,2012-07-28,Shayna Baszler,Decision - Unanimous,80,4,0,84
Sara McMann,2021-01-23,Julianna Pena,Submission,0,0,0,0
Sara McMann,2015-01-31,Miesha Tate,Decision - Majority,0,11,0,11
Sara McMann,2020-01-25,Lina Lansberg,Decision - Unanimous,80,37,0,117
Sara McMann,2012-01-21,Hitomi Akano,Decision - Unanimous,80,21,0,101
Sara McMann,2014-02-22,Ronda Rousey,KO/TKO,0,0,25,25
Sara McMann,2018-02-24,Marion Reneau,Submission,0,0,0,0
Sara McMann,2011-07-29,Tonya Evinger,Decision - Unanimous,80,10,0,90
Sara McMann,2014-08-16,Lauren Murphy,Decision - Split,70,0,0,70
Sheila Gaff,2013-04-27,Sara McMann,KO/TKO,0,0,0,0
Sheila Gaff,2013-08-03,Amanda Nunes,KO/TKO,0,0,0,0
Saidyokub Kakhramonov,2022-07-09,Ronnie Lawrence,Decision - Unanimous,80,17,0,97
Saidyokub Kakhramonov,2022-12-17,Said Nurmagomedov,Submission,0,4,0,4
Saidyokub Kakhramonov,2021-08-21,Trevin Jones,Submission,90,24,0,114
Ronnie Lawrence,2022-07-09,Saidyokub Kakhramonov,Decision - Unanimous,0,0,0,0
Ronnie Lawrence,2020-09-01,Jose Johnson,Decision - Unanimous,80,13,0,93
Ronnie Lawrence,2022-02-12,Mana Martinez,Decision - Unanimous,80,7,0,87
Ronnie Lawrence,2021-02-27,Vince Cachero,KO/TKO,100,62,0,162
Josh Thomson,2010-06-26,Pat Healy,Submission,90,1,0,91
Josh Thomson,2004-01-31,Hermes Franca,Decision - Majority,75,18,0,93
Josh Thomson,2012-03-03,KJ Noons,Decision - Unanimous,80,12,0,92
Josh Thomson,2004-08-21,Yves Edwards,KO/TKO,0,0,0,0
Josh Thomson,2008-06-27,Gilbert Melendez,Decision - Unanimous,80,56,25,161
Josh Thomson,2007-09-29,Adam Lynn,KO/TKO,100,26,0,126
Josh Thomson,2015-07-15,Tony Ferguson,Decision - Unanimous,0,0,0,0
Josh Thomson,2005-07-17,Daisuke Sugie,Submission,90,1,0,91
Josh Thomson,2006-03-10,Clay Guida,Decision - Unanimous,0,0,25,25
Josh Thomson,2010-10-09,Gesias Cavalcante,Decision - Unanimous,80,2,0,82
Josh Thomson,2002-11-23,Rob McCullough,Decision - Unanimous,80,56,0,136
Josh Thomson,2014-01-25,Benson Henderson,Decision - Split,0,0,25,25
Josh Thomson,2007-06-22,Nick Gonzalez,Submission,90,3,0,93
Josh Thomson,2006-06-09,Harris Sarmiento,Submission,90,22,0,112
Josh Thomson,2013-04-20,Nate Diaz,KO/TKO,100,15,0,115
Josh Thomson,2010-12-31,Tatsuya Kawajiri,Decision - Unanimous,0,0,0,0
Josh Thomson,2012-05-19,Gilbert Melendez,Decision - Split,0,0,25,25
Josh Thomson,2003-09-26,Gerald Strebendt,KO/TKO,100,11,0,111
Josh Thomson,2009-12-19,Gilbert Melendez,Decision - Unanimous,0,0,25,25
Josh Thomson,2014-07-26,Bobby Green,Decision - Split,0,0,0,0
Josh Thomson,2006-12-08,Nam Phan,Decision - Unanimous,80,66,0,146
Josh Thomson,2008-09-20,Ashe Bowman,KO/TKO,100,3,0,103
Josh Thomson,2006-10-07,Duane Ludwig,Submission,90,19,0,109
Pat Healy,2010-06-26,Josh Thomson,Submission,0,0,0,0
Pat Healy,2014-04-19,Jorge Masvidal,Decision - Unanimous,0,0,0,0
Pat Healy,2013-12-14,Bobby Green,Decision - Unanimous,0,0,0,0
Pat Healy,2010-05-21,Bryan Travers,Decision - Unanimous,80,24,0,104
Pat Healy,2011-08-12,Eric Wisely,Decision - Unanimous,80,9,0,89
Pat Healy,2006-03-17,Tiki Ghosn,TKO - Doctor's Stoppage,0,0,0,0
Pat Healy,2005-05-19,Chris Lytle,Decision - Split,0,0,0,0
Pat Healy,2013-09-21,Khabib Nurmagomedov,Decision - Unanimous,0,0,0,0
Pat Healy,2014-07-16,Gleison Tibau,Decision - Unanimous,0,10,0,10
Pat Healy,2012-03-03,Caros Fodor,Submission,90,3,0,93
Pat Healy,2011-09-10,Maximo Blanco,Submission,90,0,0,90
Pat Healy,2011-02-18,Lyle Beerbohm,Decision - Unanimous,80,27,0,107
Pat Healy,2012-07-14,Mizuto Hirota,Decision - Unanimous,80,4,0,84
Pat Healy,2006-08-17,Anthony Torres,Submission,0,2,0,2
Pat Healy,2013-01-12,Kurt Holobaugh,Decision - Unanimous,80,0,0,80
Paul Buentello,2005-06-04,Kevin Jordan,Submission,90,2,0,92
Paul Buentello,2010-03-21,Cheick Kongo,KO/TKO,0,0,0,0
Paul Buentello,2009-01-24,Kiril Sidelnikov,TKO - Doctor's Stoppage,0,23,0,23
Paul Buentello,2005-02-05,Justin Eilers,KO/TKO,100,15,0,115
Paul Buentello,2007-06-22,Carter Williams,KO/TKO,100,4,0,104
Paul Buentello,2006-02-04,Gilbert Aldana,KO/TKO,100,21,0,121
Paul Buentello,2009-12-12,Stefan Struve,Decision - Majority,0,0,0,0
Paul Buentello,2007-11-16,Alistair Overeem,KO/TKO,0,0,25,25
Paul Buentello,2006-10-07,David Abbott,KO/TKO,100,5,0,105
Paul Buentello,2006-12-08,Ruben Villareal,KO/TKO,100,0,0,100
Paul Buentello,2005-10-07,Andrei Arlovski,KO/TKO,0,0,25,25
Kevin Jordan,2005-06-04,Paul Buentello,Submission,0,0,0,0
Kevin Jordan,2009-09-25,Ray Sefo,Submission,0,9,0,9
Kevin Jordan,2005-11-19,Gabriel Gonzaga,KO/TKO,0,0,0,0
Ricardo Almeida,2001-09-28,Eugene Jackson,Submission,90,3,0,93
Ricardo Almeida,2001-05-04,Matt Lindland,DQ,0,0,0,0
Ricardo Almeida,2009-08-08,Kendall Grove,Decision - Unanimous,80,13,0,93
Ricardo Almeida,2011-03-19,Mike Pyle,Decision - Unanimous,0,12,0,12
Ricardo Almeida,2008-02-02,Rob Yundt,Submission,90,2,0,92
Ricardo Almeida,2008-07-05,Patrick Cote,Decision - Split,0,2,0,2
Ricardo Almeida,2000-12-09,Akira Shoji,Decision - Unanimous,80,14,0,94
Ricardo Almeida,2009-04-01,Matt Horwich,Decision - Unanimous,80,16,0,96
Ricardo Almeida,2010-12-11,TJ Grant,Decision - Unanimous,80,42,0,122
Ricardo Almeida,2004-05-23,Ryo Chonan,Decision - Unanimous,80,6,0,86
Ricardo Almeida,2002-01-11,Andrei Semenov,KO/TKO,0,7,0,7
Ricardo Almeida,2010-08-07,Matt Hughes,Submission,0,8,0,8
Ricardo Almeida,2010-03-27,Matt Brown,Submission,90,9,0,99
Eugene Jackson,2001-09-28,Ricardo Almeida,Submission,0,0,0,0
Eugene Jackson,2006-12-08,Ronald Jhun,Submission,90,9,25,124
Eugene Jackson,2000-04-14,Sanae Kikuta,Submission,0,0,0,0
Eugene Jackson,2007-09-29,Joe Riggs,KO/TKO,0,0,0,0
Eugene Jackson,2006-03-10,Jorge Ortiz,Decision - Unanimous,80,0,0,80
Eugene Jackson,2006-06-09,Mike Seal,KO/TKO,100,0,0,100
Eugene Jackson,1999-07-16,Royce Alger,KO/TKO,100,10,0,110
Eugene Jackson,2000-09-22,Jeremy Horn,Submission,0,0,0,0
Eugene Jackson,2002-07-13,Mark Weir,KO/TKO,0,0,0,0
Eugene Jackson,1999-11-19,Keiichiro Yamamiya,KO/TKO,100,8,0,108
Eugene Jackson,2002-01-11,Keith Rockel,Submission,90,0,0,90
Trevor Prangley,2007-11-16,Falaniko Vitale,Other,0,17,0,17
Trevor Prangley,2006-04-06,Chael Sonnen,Decision - Unanimous,0,0,0,0
Trevor Prangley,2005-08-20,Travis Lutter,Decision - Unanimous,80,45,0,125
Trevor Prangley,2010-06-16,Tim Kennedy,Submission,0,0,0,0
Trevor Prangley,2011-01-29,Roger Gracie,Submission,0,0,0,0
Trevor Prangley,2011-07-16,Tatsuya Mizuno,KO/TKO,0,0,0,0
Trevor Prangley,2008-09-20,Anthony Ruiz,Decision - Unanimous,80,28,0,108
Trevor Prangley,2005-11-19,Jeremy Horn,Decision - Unanimous,0,0,0,0
Trevor Prangley,2004-06-19,Curtis Stout,Submission,90,7,0,97
Trevor Prangley,2006-10-07,Anthony Ruiz,Submission,90,0,0,90
Trevor Prangley,2007-11-16,Jorge Santiago,KO/TKO,0,0,0,0
Falaniko Vitale,2007-11-16,Trevor Prangley,Other,0,0,0,0
Falaniko Vitale,2003-11-21,Matt Lindland,KO/TKO,0,0,0,0
Falaniko Vitale,2007-09-29,Ron Fields,KO/TKO,100,7,0,107
Falaniko Vitale,2003-06-06,Matt Lindland,KO/TKO,100,0,0,100
Falaniko Vitale,2008-10-03,Frank Trigg,Decision - Unanimous,0,0,0,0
Dan Christison,2006-04-06,Brad Imes,Submission,90,15,0,105
Dan Christison,2006-07-08,Frank Mir,Decision - Unanimous,0,0,0,0
Brad Imes,2006-04-06,Dan Christison,Submission,0,0,0,0
Brad Imes,2005-11-05,Rashad Evans,Decision - Split,0,0,0,0
Brad Imes,2007-04-07,Heath Herring,Decision - Unanimous,0,0,0,0
Raquel Pennington,2024-01-20,Mayra Bueno Silva,Decision - Unanimous,80,65,25,170
Raquel Pennington,2016-11-12,Miesha Tate,Decision - Unanimous,80,22,0,102
Raquel Pennington,2014-03-15,Jessica Andrade,Decision - Split,0,16,0,16
Raquel Pennington,2020-06-20,Marion Reneau,Decision - Unanimous,80,61,0,141
Raquel Pennington,2022-04-09,Aspen Ladd,Decision - Unanimous,80,49,0,129
Raquel Pennington,2021-12-18,Macy Chiasson,Submission,90,19,0,109
Raquel Pennington,2014-12-06,Ashlee Evans-Smith,Submission,90,0,0,90
Raquel Pennington,2016-08-20,Elizabeth Phillips,Decision - Unanimous,80,18,0,98
Raquel Pennington,2023-01-14,Ketlen Vieira,Decision - Split,70,17,0,87
Raquel Pennington,2016-04-16,Bethe Correia,Decision - Split,70,9,0,79
Raquel Pennington,2020-01-18,Holly Holm,Decision - Unanimous,0,8,0,8
Raquel Pennington,2018-05-12,Amanda Nunes,KO/TKO,0,0,25,25
Raquel Pennington,2015-02-28,Holly Holm,Decision - Split,0,0,0,0
Raquel Pennington,2021-09-18,Pannie Kianzad,Decision - Unanimous,80,0,0,80
Raquel Pennington,2013-11-30,Roxanne Modafferi,Decision - Unanimous,80,38,0,118
Raquel Pennington,2024-10-05,Julianna Pena,Decision - Split,0,0,25,25
Raquel Pennington,2015-09-05,Jessica Andrade,Submission,90,0,0,90
Raquel Pennington,2018-11-10,Germaine de Randamie,Decision - Unanimous,0,0,0,0
Raquel Pennington,2019-07-20,Irene Aldana,Decision - Split,70,0,0,70
Mayra Bueno Silva,2024-01-20,Raquel Pennington,Decision - Unanimous,0,0,25,25
Mayra Bueno Silva,2023-02-18,Lina Lansberg,Submission,90,14,0,104
Mayra Bueno Silva,2018-08-10,Mayana Kellem,Submission,90,1,0,91
Mayra Bueno Silva,2021-10-16,Manon Fiorot,Decision - Unanimous,0,0,0,0
Mayra Bueno Silva,2024-06-29,Macy Chiasson,TKO - Doctor's Stoppage,0,0,0,0
Mayra Bueno Silva,2022-08-06,Stephanie Egger,Submission,90,0,0,90
Mayra Bueno Silva,2020-09-19,Mara Romero Borella,Submission,90,0,0,90
Mayra Bueno Silva,2022-04-16,Wu Yanan,Decision - Unanimous,80,25,0,105
Mayra Bueno Silva,2020-03-14,Maryna Moroz,Decision - Unanimous,0,0,0,0
Mayra Bueno Silva,2018-09-22,Gillian Robertson,Submission,90,0,0,90
Amanda Ribas,2024-03-23,Rose Namajunas,Decision - Unanimous,0,0,25,25
Amanda Ribas,2022-05-14,Katlyn Cerminara,Decision - Split,0,0,0,0
Amanda Ribas,2020-03-14,Randa Markos,Decision - Unanimous,80,49,0,129
Amanda Ribas,2019-06-29,Emily Whitmire,Submission,90,14,0,104
Amanda Ribas,2021-10-30,Virna Jandiroba,Decision - Unanimous,80,38,0,118
Amanda Ribas,2021-01-23,Marina Rodriguez,KO/TKO,0,0,0,0
Amanda Ribas,2023-11-18,Luana Pinheiro,KO/TKO,100,32,0,132
Amanda Ribas,2020-07-11,Paige VanZant,Submission,90,3,0,93
Amanda Ribas,2019-10-12,Mackenzie Dern,Decision - Unanimous,80,54,0,134
Amanda Ribas,2023-06-24,Maycee Barber,KO/TKO,0,0,0,0
Amanda Ribas,2023-03-04,Viviane Araujo,Decision - Unanimous,80,52,0,132
Alessio Sakara,2009-08-08,Thales Leites,Decision - Split,70,2,0,72
Alessio Sakara,2007-04-21,Victor Valimaki,KO/TKO,100,6,0,106
Alessio Sakara,2006-11-18,Drew McFedries,KO/TKO,0,2,0,2
Alessio Sakara,2012-04-14,Brian Stann,KO/TKO,0,0,0,0
Alessio Sakara,2008-09-17,Joe Vedepo,KO/TKO,100,0,0,100
Alessio Sakara,2007-09-08,Houston Alexander,KO/TKO,0,0,0,0
Alessio Sakara,2012-11-17,Patrick Cote,DQ,0,10,0,10
Alessio Sakara,2008-03-01,Chris Leben,KO/TKO,0,0,0,0
Alessio Sakara,2011-03-03,Chris Weidman,Decision - Unanimous,0,0,0,0
Alessio Sakara,2006-05-27,Dean Lister,Submission,0,0,0,0
Alessio Sakara,2013-10-26,Nicholas Musoke,Submission,0,8,0,8
Alessio Sakara,2010-03-21,James Irvin,KO/TKO,100,7,0,107
Alessio Sakara,2006-02-04,Elvis Sinosic,Decision - Unanimous,80,57,0,137
Alessio Sakara,2008-01-19,James Lee,KO/TKO,100,8,0,108
Thales Leites,2009-08-08,Alessio Sakara,Decision - Split,0,0,0,0
Thales Leites,2006-11-11,Martin Kampmann,Decision - Unanimous,0,0,0,0
Thales Leites,2013-11-16,Ed Herman,Decision - Unanimous,80,6,0,86
Thales Leites,2018-09-22,Hector Lombard,Decision - Unanimous,80,8,0,88
Thales Leites,2016-02-27,Gegard Mousasi,Decision - Unanimous,0,0,0,0
Thales Leites,2013-08-03,Tom Watson,Decision - Unanimous,80,18,0,98
Thales Leites,2014-04-11,Trevor Smith,KO/TKO,100,2,0,102
Thales Leites,2016-08-06,Chris Camozzi,Submission,90,28,0,118
Thales Leites,2015-01-31,Tim Boetsch,Submission,90,0,0,90
Thales Leites,2014-08-23,Francis Carmont,KO/TKO,100,0,0,100
Thales Leites,2009-04-18,Anderson Silva,Decision - Unanimous,0,0,25,25
Thales Leites,2007-04-07,Pete Sell,Decision - Unanimous,80,53,0,133
Thales Leites,2007-08-25,Ryan Jensen,Submission,90,0,0,90
Thales Leites,2008-10-25,Drew McFedries,Submission,90,0,0,90
Thales Leites,2016-11-19,Krzysztof Jotko,Decision - Unanimous,0,0,0,0
Thales Leites,2015-07-18,Michael Bisping,Decision - Split,0,0,25,25
Thales Leites,2017-04-22,Sam Alvey,Decision - Unanimous,80,11,0,91
Thales Leites,2017-10-07,Brad Tavares,Decision - Unanimous,0,0,0,0
Thales Leites,2007-06-23,Floyd Sword,Submission,90,3,0,93
Thales Leites,2008-06-07,Nate Marquardt,Decision - Split,70,0,0,70
Thales Leites,2018-05-12,Jack Hermansson,KO/TKO,0,0,0,0
Ben Rothwell,2008-12-11,Chris Guillen,KO/TKO,100,4,0,104
Ben Rothwell,2019-07-20,Andrei Arlovski,Decision - Unanimous,0,0,0,0
Ben Rothwell,2006-09-23,Bryan Vetell,KO/TKO,100,0,0,100
Ben Rothwell,2010-06-12,Gilbert Yvel,Decision - Unanimous,80,11,0,91
Ben Rothwell,2011-09-24,Mark Hunt,Decision - Unanimous,0,0,0,0
Ben Rothwell,2019-12-07,Stefan Struve,KO/TKO,100,5,0,105
Ben Rothwell,2009-10-24,Cain Velasquez,KO/TKO,0,0,0,0
Ben Rothwell,2007-04-07,Roy Nelson,Decision - Split,70,21,0,91
Ben Rothwell,2016-01-30,Josh Barnett,Submission,90,0,0,90
Ben Rothwell,2016-04-10,Junior Dos Santos,Decision - Unanimous,0,0,25,25
Ben Rothwell,2013-08-31,Brandon Vera,KO/TKO,100,15,0,115
Ben Rothwell,2019-03-09,Blagoy Ivanov,Decision - Unanimous,0,0,0,0
Ben Rothwell,2006-12-29,Devin Cole,KO/TKO,100,6,0,106
Ben Rothwell,2012-04-21,Brendan Schaub,KO/TKO,100,0,0,100
Ben Rothwell,2007-08-02,Krzysztof Soszynski,KO/TKO,100,4,0,104
Ben Rothwell,2020-05-13,Ovince Saint Preux,Decision - Split,70,14,0,84
Ben Rothwell,2021-05-22,Chris Barnett,Submission,90,27,0,117
Ben Rothwell,2013-01-19,Gabriel Gonzaga,Submission,0,0,0,0
Ben Rothwell,2007-09-20,Ricco Rodriguez,Decision - Unanimous,80,0,0,80
Ben Rothwell,2020-10-10,Marcin Tybura,Decision - Unanimous,0,0,0,0
Ben Rothwell,2014-09-05,Alistair Overeem,KO/TKO,100,0,0,100
Ben Rothwell,2021-11-13,Marcos Rogerio de Lima,KO/TKO,0,0,0,0
Ben Rothwell,2008-07-19,Andrei Arlovski,KO/TKO,0,0,0,0
Ben Rothwell,2006-04-29,Krzysztof Soszynski,KO/TKO,100,9,0,109
Ben Rothwell,2015-06-06,Matt Mitrione,Submission,90,0,0,90
Chris Guillen,2008-12-11,Ben Rothwell,KO/TKO,0,0,0,0
Jorge de Oliveira,2014-11-08,Dhiego Lima,Decision - Unanimous,0,0,0,0
Jorge de Oliveira,2015-03-21,Christos Giagos,Submission,0,0,0,0
Jon Jones,2020-02-08,Dominick Reyes,Decision - Unanimous,80,0,25,105
Jon Jones,2014-04-26,Glover Teixeira,Decision - Unanimous,80,85,25,190
Jon Jones,2011-03-19,Mauricio Rua,KO/TKO,100,66,25,191
Jon Jones,2018-12-29,Alexander Gustafsson,KO/TKO,100,37,25,162
Jon Jones,2008-08-09,Andre Gusmao,Decision - Unanimous,80,8,0,88
Jon Jones,2024-11-16,Stipe Miocic,KO/TKO,100,59,25,184
Jon Jones,2009-01-31,Stephan Bonnar,Decision - Unanimous,80,8,0,88
Jon Jones,2012-04-21,Rashad Evans,Decision - Unanimous,80,60,25,165
Jon Jones,2019-07-06,Thiago Santos,Decision - Split,70,16,25,111
Jon Jones,2012-09-22,Vitor Belfort,Submission,90,49,25,164
Jon Jones,2011-12-10,Lyoto Machida,Submission,90,11,25,126
Jon Jones,2013-04-27,Chael Sonnen,KO/TKO,100,14,25,139
Jon Jones,2010-08-01,Vladimir Matyushenko,KO/TKO,100,15,0,115
Jon Jones,2009-07-11,Jake O'Brien,Submission,90,14,0,104
Jon Jones,2011-02-05,Ryan Bader,Submission,90,15,0,105
Jon Jones,2023-03-04,Ciryl Gane,Submission,90,0,25,115
Jon Jones,2019-03-02,Anthony Smith,Decision - Unanimous,80,89,25,194
Jon Jones,2015-01-03,Daniel Cormier,Decision - Unanimous,80,34,25,139
Jon Jones,2010-03-21,Brandon Vera,KO/TKO,100,6,0,106
Jon Jones,2009-12-05,Matt Hamill,DQ,0,39,0,39
Jon Jones,2011-09-24,Quinton Jackson,Submission,90,45,25,160
Jon Jones,2013-09-21,Alexander Gustafsson,Decision - Unanimous,80,24,25,129
Jon Jones,2016-04-23,Ovince Saint Preux,Decision - Unanimous,80,48,25,153
Dominick Reyes,2020-02-08,Jon Jones,Decision - Unanimous,0,12,25,37
Dominick Reyes,2017-06-25,Joachim Christensen,KO/TKO,100,12,0,112
Dominick Reyes,2017-12-02,Jeremy Kimball,Submission,90,12,0,102
Dominick Reyes,2024-12-07,Anthony Smith,KO/TKO,100,100,0,200
Dominick Reyes,2019-03-16,Volkan Oezdemir,Decision - Split,70,9,0,79
Dominick Reyes,2022-11-12,Ryan Spann,KO/TKO,0,0,0,0
Dominick Reyes,2020-09-26,Jan Blachowicz,KO/TKO,0,0,25,25
Dominick Reyes,2018-10-06,Ovince Saint Preux,Decision - Unanimous,80,56,0,136
Dominick Reyes,2021-05-01,Jiri Prochazka,KO/TKO,0,0,25,25
Dominick Reyes,2024-06-08,Dustin Jacoby,KO/TKO,100,14,0,114
Dominick Reyes,2018-05-19,Jared Cannonier,KO/TKO,100,14,0,114
Dominick Reyes,2019-10-18,Chris Weidman,KO/TKO,100,5,25,130
Gregor Gillespie,2016-09-24,Glaico Franca Moreira,Decision - Unanimous,80,0,0,80
Gregor Gillespie,2019-11-02,Kevin Lee,KO/TKO,0,0,0,0
Gregor Gillespie,2018-01-27,Jordan Rinaldi,KO/TKO,100,27,0,127
Gregor Gillespie,2018-06-01,Vinc Pichel,Submission,90,6,0,96
Gregor Gillespie,2017-04-08,Andrew Holbrook,KO/TKO,100,4,0,104
Gregor Gillespie,2021-05-08,Diego Ferreira,KO/TKO,100,14,0,114
Gregor Gillespie,2017-09-16,Jason Gonzalez,Submission,90,0,0,90
Gregor Gillespie,2019-01-19,Yancy Medeiros,KO/TKO,100,50,0,150
Glaico Franca Moreira,2016-09-24,Gregor Gillespie,Decision - Unanimous,0,2,0,2
Glaico Franca Moreira,2016-04-23,James Vick,Decision - Unanimous,0,0,0,0
Glaico Franca Moreira,2015-08-01,Fernando Bruno,Submission,90,3,0,93
Katlyn Cerminara,2022-05-14,Amanda Ribas,Decision - Split,70,8,0,78
Katlyn Cerminara,2022-01-15,Jennifer Maia,Decision - Unanimous,80,20,0,100
Katlyn Cerminara,2016-07-13,Lauren Murphy,Decision - Unanimous,80,7,0,87
Katlyn Cerminara,2020-10-17,Jessica Andrade,KO/TKO,0,0,0,0
Katlyn Cerminara,2018-01-27,Mara Romero Borella,Decision - Unanimous,80,0,0,80
Katlyn Cerminara,2018-07-28,Alexis Davis,Decision - Unanimous,80,0,0,80
Katlyn Cerminara,2020-05-30,Antonina Shevchenko,Decision - Unanimous,80,48,0,128
Katlyn Cerminara,2021-05-15,Viviane Araujo,Decision - Unanimous,80,38,0,118
Katlyn Cerminara,2019-06-08,Joanne Wood,Decision - Unanimous,80,0,0,80
Katlyn Cerminara,2016-11-12,Liz Carmouche,Decision - Split,0,0,0,0
Katlyn Cerminara,2019-11-02,Jennifer Maia,Decision - Unanimous,80,15,0,95
Katlyn Cerminara,2024-03-09,Maycee Barber,Decision - Unanimous,0,0,0,0
Katlyn Cerminara,2022-10-22,Manon Fiorot,Decision - Unanimous,0,0,0,0
Katlyn Cerminara,2017-04-08,Irene Aldana,Decision - Split,70,21,0,91
Katlyn Cerminara,2020-11-21,Cynthia Calvillo,Decision - Unanimous,80,9,0,89
Katlyn Cerminara,2020-02-08,Valentina Shevchenko,KO/TKO,0,0,25,25
Katlyn Cerminara,2018-12-08,Jessica Eye,Decision - Split,0,0,0,0
Brian Melancon,2013-07-06,Seth Baczynski,KO/TKO,100,11,0,111
Brian Melancon,2013-08-28,Kelvin Gastelum,Submission,0,0,0,0
Seth Baczynski,2013-07-06,Brian Melancon,KO/TKO,0,0,0,0
Seth Baczynski,2015-04-11,Leon Edwards,KO/TKO,0,0,0,0
Seth Baczynski,2012-12-14,Mike Pierce,Decision - Unanimous,0,18,0,18
Seth Baczynski,2011-09-17,Clay Harvison,Submission,90,29,0,119
Seth Baczynski,2012-09-22,Simeon Thoresen,KO/TKO,100,0,0,100
Seth Baczynski,2013-11-06,Neil Magny,Decision - Unanimous,80,0,0,80
Seth Baczynski,2014-08-16,Alan Jouban,KO/TKO,0,0,0,0
Seth Baczynski,2011-11-19,Matt Brown,Submission,90,0,0,90
Seth Baczynski,2010-06-19,Brad Tavares,Decision - Unanimous,0,4,0,4
Seth Baczynski,2012-06-08,Lance Benoist,Decision - Split,70,0,0,70
Seth Baczynski,2014-04-19,Thiago Alves,Decision - Unanimous,0,0,0,0
Cole Miller,2014-01-15,Sam Sicilia,Submission,90,24,0,114
Cole Miller,2011-01-22,Matt Wiman,Decision - Unanimous,0,0,0,0
Cole Miller,2012-08-04,Nam Phan,Decision - Split,0,14,0,14
Cole Miller,2008-01-23,Jeremy Stephens,KO/TKO,0,0,0,0
Cole Miller,2007-09-19,Leonard Garcia,Decision - Unanimous,80,5,0,85
Cole Miller,2008-07-05,Jorge Gurgel,Submission,90,0,0,90
Cole Miller,2009-09-19,Efrain Escudero,KO/TKO,0,0,0,0
Cole Miller,2016-06-04,Alex Caceres,Decision - Unanimous,0,0,0,0
Cole Miller,2012-03-02,Steven Siler,Decision - Unanimous,0,0,0,0
Cole Miller,2015-02-14,Max Holloway,Decision - Unanimous,0,0,0,0
Cole Miller,2013-04-13,Bart Palaszewski,Submission,90,0,0,90
Cole Miller,2016-12-17,Mizuto Hirota,Decision - Unanimous,0,0,0,0
Cole Miller,2011-08-14,TJ O'Brien,Submission,90,4,0,94
Cole Miller,2010-01-02,Dan Lauzon,Submission,90,5,0,95
Cole Miller,2007-06-23,Andy Wang,KO/TKO,100,8,0,108
Cole Miller,2009-04-01,Junie Browning,Submission,90,2,0,92
Cole Miller,2010-09-15,Ross Pearson,Submission,90,0,0,90
Cole Miller,2013-08-17,Manvel Gamburyan,Decision - Unanimous,0,9,0,9
Cole Miller,2013-10-26,Andy Ogle,Decision - Unanimous,80,0,0,80
Sam Sicilia,2014-01-15,Cole Miller,Submission,0,0,0,0
Sam Sicilia,2012-06-01,Cristiano Marcello,KO/TKO,100,0,0,100
Sam Sicilia,2015-01-24,Akira Corassani,KO/TKO,100,0,0,100
Sam Sicilia,2012-10-13,Rony Jason,KO/TKO,0,0,0,0
Sam Sicilia,2015-11-28,Dooho Choi,KO/TKO,0,0,0,0
Sam Sicilia,2014-05-24,Aaron Phillips,Decision - Unanimous,80,19,0,99
Sam Sicilia,2014-09-20,Katsunori Kikuno,Submission,0,4,0,4
Sam Sicilia,2015-07-15,Yaotzin Meza,Decision - Unanimous,80,0,0,80
Sam Sicilia,2016-09-17,Gabriel Benitez,Submission,0,0,0,0
Sam Sicilia,2017-02-19,Gavin Tucker,Decision - Unanimous,0,0,0,0
Sam Sicilia,2013-11-09,Godofredo Pepey,KO/TKO,100,8,0,108
Sam Sicilia,2013-04-13,Maximo Blanco,Decision - Unanimous,0,0,0,0
Tatsuro Taira,2022-10-15,CJ Vergara,Submission,90,3,0,93
Tatsuro Taira,2023-07-08,Edgar Chairez,Decision - Unanimous,80,36,0,116
Tatsuro Taira,2023-02-04,Jesus Aguilar,Submission,90,0,0,90
Tatsuro Taira,2024-10-12,Brandon Royval,Decision - Split,0,0,25,25
Tatsuro Taira,2023-12-09,Carlos Hernandez,KO/TKO,100,31,0,131
Tatsuro Taira,2024-06-15,Alex Perez,KO/TKO,100,0,25,125
Tatsuro Taira,2022-05-14,Carlos Candelario,Decision - Unanimous,80,48,0,128
CJ Vergara,2022-10-15,Tatsuro Taira,Submission,0,0,0,0
CJ Vergara,2024-10-12,Ramazan Temirov,KO/TKO,0,0,0,0
CJ Vergara,2023-07-29,Vinicius Salvador,Decision - Unanimous,80,21,0,101
CJ Vergara,2022-05-07,Kleydson Rodrigues,Decision - Split,70,0,0,70
CJ Vergara,2021-11-06,Ode Osbourne,Decision - Unanimous,0,14,0,14
CJ Vergara,2021-09-07,Bruno Korea,KO/TKO,100,7,0,107
CJ Vergara,2024-03-09,Asu Almabayev,Decision - Unanimous,0,0,0,0
CJ Vergara,2023-03-25,Daniel Lacerda,KO/TKO,100,35,0,135
Hermes Franca,2004-01-31,Josh Thomson,Decision - Majority,0,0,0,0
Hermes Franca,2006-08-26,Jamie Varner,Submission,90,4,0,94
Hermes Franca,2009-09-19,Tyson Griffin,KO/TKO,0,0,0,0
Hermes Franca,2008-07-19,Frankie Edgar,Decision - Unanimous,0,0,0,0
Hermes Franca,2008-10-25,Marcus Aurelio,Decision - Unanimous,80,20,0,100
Hermes Franca,2007-07-07,Sean Sherk,Decision - Unanimous,0,0,25,25
Hermes Franca,2003-04-25,Richard Crunkilton,Decision - Unanimous,80,0,0,80
Hermes Franca,2004-04-02,Yves Edwards,Decision - Split,0,0,0,0
Hermes Franca,2007-01-25,Spencer Fisher,KO/TKO,100,1,0,101
Hermes Franca,2003-09-26,Caol Uno,KO/TKO,100,0,0,100
Hermes Franca,2006-10-12,Nate Diaz,Submission,90,0,25,115
Hermes Franca,2006-07-08,Joe Jordan,Submission,90,26,0,116
Dave Herman,2008-06-14,Ron Waterman,KO/TKO,100,17,0,117
Dave Herman,2012-02-15,Stefan Struve,KO/TKO,0,4,0,4
Dave Herman,2012-10-13,Antonio Rodrigo Nogueira,Submission,0,0,0,0
Dave Herman,2013-07-06,Gabriel Gonzaga,KO/TKO,0,0,0,0
Dave Herman,2011-06-11,Jon Olav Einemo,KO/TKO,100,21,0,121
Dave Herman,2012-05-26,Roy Nelson,KO/TKO,0,1,0,1
Ron Waterman,2008-06-14,Dave Herman,KO/TKO,0,0,0,0
Ron Waterman,2000-04-14,Satoshi Honma,Decision - Unanimous,80,45,0,125
Ron Waterman,1999-07-16,Andre Roberts,KO/TKO,0,12,0,12
Ron Waterman,2002-12-23,Valentijn Overeem,Submission,90,0,0,90
Ron Waterman,1999-05-07,Chris Condo,KO/TKO,100,6,0,106
Ron Waterman,2004-08-15,Kevin Randleman,Submission,90,0,0,90
Ron Waterman,2005-08-18,Ricco Rodriguez,Decision - Unanimous,80,5,0,85
Ron Waterman,2004-02-01,Mirko Filipovic,KO/TKO,0,0,0,0
Pedro Munhoz,2014-02-22,Raphael Assuncao,Decision - Unanimous,0,0,0,0
Pedro Munhoz,2014-05-31,Matt Hobar,KO/TKO,100,17,0,117
Pedro Munhoz,2024-03-09,Kyler Phillips,Decision - Unanimous,0,0,0,0
Pedro Munhoz,2020-08-22,Frankie Edgar,Decision - Split,0,31,25,56
Pedro Munhoz,2023-04-15,Chris Gutierrez,Decision - Unanimous,80,0,0,80
Pedro Munhoz,2015-11-07,Jimmie Rivera,Decision - Split,0,0,0,0
Pedro Munhoz,2018-08-04,Brett Johns,Decision - Unanimous,80,44,0,124
Pedro Munhoz,2018-03-03,John Dodson,Decision - Split,0,0,0,0
Pedro Munhoz,2021-02-27,Jimmie Rivera,Decision - Unanimous,80,29,0,109
Pedro Munhoz,2024-11-02,Aiemann Zahabi,Decision - Unanimous,0,0,0,0
Pedro Munhoz,2021-12-11,Dominick Cruz,Decision - Unanimous,0,0,0,0
Pedro Munhoz,2018-11-30,Bryan Caraway,KO/TKO,100,15,0,115
Pedro Munhoz,2016-07-07,Russell Doane,Submission,90,0,0,90
Pedro Munhoz,2021-08-07,Jose Aldo,Decision - Unanimous,0,0,0,0
Pedro Munhoz,2017-05-28,Damian Stasiak,Decision - Unanimous,80,21,0,101
Pedro Munhoz,2023-08-19,Marlon Vera,Decision - Unanimous,0,0,0,0
Pedro Munhoz,2019-03-02,Cody Garbrandt,KO/TKO,100,4,0,104
Pedro Munhoz,2016-11-19,Justin Scoggins,Submission,90,0,0,90
Pedro Munhoz,2019-06-08,Aljamain Sterling,Decision - Unanimous,0,0,0,0
Pedro Munhoz,2017-10-28,Rob Font,Submission,90,0,0,90
Hayato Sakurai,2005-05-22,Milton Vieira,Decision - Unanimous,80,28,0,108
Hayato Sakurai,2005-09-25,Joachim Hansen,Decision - Unanimous,80,0,0,80
Hayato Sakurai,2002-03-22,Matt Hughes,KO/TKO,0,0,25,25
Hayato Sakurai,2009-07-20,Marius Zaromskis,KO/TKO,0,4,0,4
Hayato Sakurai,2008-03-15,Hidetaka Monma,KO/TKO,100,34,0,134
Hayato Sakurai,2010-05-29,Nick Diaz,Submission,0,0,0,0
Hayato Sakurai,2001-08-26,Anderson Silva,Decision - Unanimous,0,0,0,0
Hayato Sakurai,2012-12-31,Phil Baroni,Decision - Unanimous,80,5,0,85
Hayato Sakurai,2004-10-14,Crosley Gracie,Submission,0,0,0,0
Hayato Sakurai,2006-08-27,Luciano Azevedo,TKO - Doctor's Stoppage,0,8,0,8
Hayato Sakurai,2004-07-19,Brady Fink,Submission,90,0,0,90
Hayato Sakurai,2003-12-31,Daiju Takase,Decision - Unanimous,80,24,0,104
Hayato Sakurai,2009-12-31,Akihiro Gono,Submission,0,0,0,0
Hayato Sakurai,2008-09-23,Kuniyoshi Hironaka,Decision - Unanimous,80,22,0,102
Hayato Sakurai,2009-04-05,Shinya Aoki,KO/TKO,100,7,0,107
Hayato Sakurai,2011-12-31,Ryo Chonan,Decision - Unanimous,80,13,0,93
Hayato Sakurai,2008-12-31,Katsuyori Shibata,KO/TKO,100,22,0,122
Hayato Sakurai,2006-06-04,Olaf Alfonso,KO/TKO,100,2,0,102
Hayato Sakurai,2007-02-24,Mac Danzig,KO/TKO,100,22,0,122
Hayato Sakurai,2010-12-31,Jason High,Decision - Split,0,0,0,0
Hayato Sakurai,2004-02-15,Rodrigo Gracie,Decision - Unanimous,0,0,0,0
Hayato Sakurai,2005-12-31,Takanori Gomi,KO/TKO,0,0,0,0
Hayato Sakurai,2005-09-25,Jens Pulver,KO/TKO,100,41,0,141
Milton Vieira,2005-05-22,Hayato Sakurai,Decision - Unanimous,0,0,0,0
Milton Vieira,2013-01-19,Godofredo Pepey,Decision - Split,0,0,0,0
Dominick Cruz,2008-06-01,Charlie Valencia,Decision - Unanimous,80,28,0,108
Dominick Cruz,2009-08-09,Joseph Benavidez,Decision - Unanimous,80,5,0,85
Dominick Cruz,2021-03-06,Casey Kenney,Decision - Split,70,15,0,85
Dominick Cruz,2011-10-01,Demetrious Johnson,Decision - Unanimous,80,0,25,105
Dominick Cruz,2010-08-18,Joseph Benavidez,Decision - Split,70,23,25,118
Dominick Cruz,2007-03-24,Urijah Faber,Submission,0,0,25,25
Dominick Cruz,2016-01-17,TJ Dillashaw,Decision - Split,70,3,25,98
Dominick Cruz,2010-03-06,Brian Bowles,TKO - Doctor's Stoppage,0,27,25,52
Dominick Cruz,2021-12-11,Pedro Munhoz,Decision - Unanimous,80,29,0,109
Dominick Cruz,2016-06-04,Urijah Faber,Decision - Unanimous,80,53,25,158
Dominick Cruz,2011-07-02,Urijah Faber,Decision - Unanimous,80,40,25,145
Dominick Cruz,2009-04-05,Ivan Lopez,Decision - Unanimous,80,18,0,98
Dominick Cruz,2014-09-27,Takeya Mizugaki,KO/TKO,100,24,0,124
Dominick Cruz,2009-01-25,Ian McCall,Decision - Unanimous,80,25,0,105
Dominick Cruz,2020-05-09,Henry Cejudo,KO/TKO,0,0,25,25
Dominick Cruz,2010-12-16,Scott Jorgensen,Decision - Unanimous,80,75,25,180
Dominick Cruz,2016-12-30,Cody Garbrandt,Decision - Unanimous,0,20,25,45
Dominick Cruz,2022-08-13,Marlon Vera,KO/TKO,0,31,25,56
Charlie Valencia,2008-06-01,Dominick Cruz,Decision - Unanimous,0,0,0,0
Charlie Valencia,2007-12-12,Ian McCall,Submission,90,3,0,93
Charlie Valencia,2010-09-30,Miguel Torres,Submission,0,0,0,0
Charlie Valencia,2009-10-10,Coty Wheeler,Decision - Unanimous,80,5,0,85
Charlie Valencia,2011-04-30,Ivan Menjivar,KO/TKO,0,0,0,0
Charlie Valencia,2007-06-03,Brian Bowles,Submission,0,0,0,0
Charlie Valencia,2009-01-25,Seth Dikun,Decision - Unanimous,80,21,0,101
Charlie Valencia,2008-02-13,Yoshiro Maeda,KO/TKO,0,0,0,0
Charlie Valencia,2007-03-24,Antonio Banuelos,KO/TKO,100,7,0,107
Charlie Valencia,2010-01-10,Akitoshi Tamura,Decision - Split,70,13,0,83
Jasmine Jasudavicius,2023-02-25,Gabriella Fernandes,Decision - Unanimous,80,0,0,80
Jasmine Jasudavicius,2024-11-02,Ariane da Silva,Submission,90,0,0,90
Jasmine Jasudavicius,2023-09-16,Tracy Cortez,Decision - Unanimous,0,0,0,0
Jasmine Jasudavicius,2021-09-14,Julia Polastri,Decision - Unanimous,80,5,0,85
Jasmine Jasudavicius,2024-01-20,Priscila Cachoeira,Submission,90,69,0,159
Jasmine Jasudavicius,2024-07-13,Fatima Kline,Decision - Unanimous,80,1,0,81
Jasmine Jasudavicius,2023-06-10,Miranda Maverick,Decision - Unanimous,80,4,0,84
Jasmine Jasudavicius,2022-06-18,Natalia Silva,Decision - Unanimous,0,0,0,0
Jasmine Jasudavicius,2022-01-22,Kay Hansen,Decision - Unanimous,80,6,0,86
Gabriella Fernandes,2023-02-25,Jasmine Jasudavicius,Decision - Unanimous,0,2,0,2
Gabriella Fernandes,2023-06-17,Tereza Bleda,Decision - Unanimous,0,0,0,0
Gabriella Fernandes,2024-11-23,Wang Cong,Submission,90,0,0,90
Gabriella Fernandes,2024-06-15,Carli Judice,Decision - Split,70,0,0,70
Ben Nguyen,2018-12-01,Wilson Reis,Decision - Unanimous,0,7,0,7
Ben Nguyen,2018-02-10,Jussier Formiga,Submission,0,0,0,0
Ben Nguyen,2016-07-13,Louis Smolka,KO/TKO,0,0,0,0
Ben Nguyen,2015-05-09,Alptekin Ozkilic,KO/TKO,100,12,0,112
Ben Nguyen,2017-06-10,Tim Elliott,Submission,90,2,0,92
Ben Nguyen,2016-11-26,Geane Herrera,Decision - Unanimous,80,83,0,163
Ben Nguyen,2015-11-14,Ryan Benoit,Submission,90,10,0,100
Cristiano Marcello,2012-06-01,Sam Sicilia,KO/TKO,0,6,0,6
Cristiano Marcello,2012-10-13,Reza Madadi,Decision - Split,70,0,0,70
Cristiano Marcello,2014-02-15,Joe Proctor,Decision - Unanimous,0,0,0,0
Cristiano Marcello,2006-08-27,Mitsuhiro Ishida,Decision - Unanimous,0,0,0,0
Cristiano Marcello,2013-03-02,Kazuki Tokudome,Decision - Unanimous,0,0,0,0
Austin Arnett,2018-01-27,Cory Sandhagen,KO/TKO,0,0,0,0
Austin Arnett,2018-11-17,Humberto Bandenay,Decision - Unanimous,80,44,0,124
Austin Arnett,2019-02-09,Shane Young,Decision - Unanimous,0,0,0,0
Austin Arnett,2017-08-01,Brandon Davis,Decision - Unanimous,0,0,0,0
Austin Arnett,2018-07-28,Hakeem Dawodu,Decision - Unanimous,0,0,0,0
Molly McCann,2019-06-22,Ariane da Silva,Decision - Unanimous,80,40,0,120
Molly McCann,2021-02-06,Lara Procopio,Decision - Unanimous,0,1,0,1
Molly McCann,2024-02-03,Diana Belbita,Submission,90,13,0,103
Molly McCann,2019-10-18,Diana Belbita,Decision - Unanimous,80,15,0,95
Molly McCann,2022-07-23,Hannah Goldy,KO/TKO,100,15,0,115
Molly McCann,2019-03-16,Priscila Cachoeira,Decision - Unanimous,80,32,0,112
Molly McCann,2022-11-12,Erin Blanchfield,Submission,0,0,0,0
Molly McCann,2023-07-22,Julija Stoliarenko,Submission,0,0,0,0
Molly McCann,2024-07-27,Bruna Brasil,Decision - Unanimous,0,0,0,0
Molly McCann,2022-03-19,Luana Carolina,KO/TKO,100,21,0,121
Molly McCann,2018-05-27,Gillian Robertson,Submission,0,0,0,0
Molly McCann,2020-07-15,Taila Santos,Decision - Unanimous,0,0,0,0
Molly McCann,2021-09-04,Ji Yeon Kim,Decision - Unanimous,80,5,0,85
Ariane da Silva,2019-06-22,Molly McCann,Decision - Unanimous,0,0,0,0
Ariane da Silva,2024-11-02,Jasmine Jasudavicius,Submission,0,6,0,6
Ariane da Silva,2023-07-01,Melissa Gatto,Decision - Split,70,0,0,70
Ariane da Silva,2021-09-18,Mandy Bohm,Decision - Unanimous,80,51,0,131
Ariane da Silva,2020-07-18,Luana Carolina,Submission,90,1,0,91
Ariane da Silva,2023-12-16,Casey O'Neill,Submission,90,33,0,123
Ariane da Silva,2022-08-13,Priscila Cachoeira,KO/TKO,0,0,0,0
Ariane da Silva,2020-11-21,Antonina Shevchenko,KO/TKO,0,0,0,0
Ariane da Silva,2023-03-11,JJ Aldrich,Decision - Unanimous,80,52,0,132
Ariane da Silva,2019-01-19,Joanne Wood,Decision - Unanimous,0,0,0,0
Ariane da Silva,2024-04-27,Karine Silva,Decision - Unanimous,0,15,0,15
Ariane da Silva,2021-06-05,Montana De La Rosa,KO/TKO,0,0,0,0
Ariane da Silva,2019-11-16,Isabela de Padua,Decision - Unanimous,80,16,0,96
Iuri Alcantara,2018-02-03,Joe Soto,KO/TKO,100,16,0,116
Iuri Alcantara,2012-06-23,Hacran Dias,Decision - Unanimous,0,0,0,0
Iuri Alcantara,2017-06-03,Brian Kelleher,Submission,0,8,0,8
Iuri Alcantara,2015-02-22,Frankie Saenz,Decision - Unanimous,0,0,0,0
Iuri Alcantara,2015-08-01,Leandro Issa,Decision - Unanimous,80,27,0,107
Iuri Alcantara,2013-08-17,Urijah Faber,Decision - Unanimous,0,0,0,0
Iuri Alcantara,2011-08-27,Felipe Arantes,Decision - Unanimous,80,0,0,80
Iuri Alcantara,2016-01-30,Jimmie Rivera,Decision - Unanimous,0,0,0,0
Iuri Alcantara,2017-03-04,Luke Sanders,Submission,90,0,0,90
Iuri Alcantara,2018-08-25,Cory Sandhagen,KO/TKO,0,0,0,0
Iuri Alcantara,2014-09-13,Russell Doane,Decision - Unanimous,80,13,0,93
Iuri Alcantara,2010-12-16,Ricardo Lamas,KO/TKO,100,4,0,104
Iuri Alcantara,2016-10-08,Brad Pickett,Submission,90,25,0,115
Iuri Alcantara,2014-05-31,Vaughan Lee,KO/TKO,100,1,0,101
Iuri Alcantara,2017-12-09,Alejandro Perez,Decision - Unanimous,0,3,0,3
Iuri Alcantara,2012-01-14,Michihiro Omigawa,Decision - Unanimous,80,36,0,116
Iuri Alcantara,2014-02-15,Wilson Reis,Decision - Split,70,19,0,89
Iuri Alcantara,2013-05-18,Iliarde Santos,KO/TKO,100,16,0,116
Joe Soto,2018-02-03,Iuri Alcantara,KO/TKO,0,0,0,0
Joe Soto,2014-08-30,TJ Dillashaw,KO/TKO,0,0,25,25
Joe Soto,2017-03-11,Rani Yahya,Decision - Unanimous,80,0,0,80
Joe Soto,2015-06-06,Anthony Birchak,KO/TKO,0,0,0,0
Joe Soto,2016-01-02,Michinori Tanaka,Decision - Split,0,14,0,14
Joe Soto,2016-11-05,Marco Beltran,Submission,90,0,0,90
Joe Soto,2016-06-18,Chris Beal,Submission,90,0,0,90
Joe Soto,2017-12-01,Brett Johns,Submission,0,0,0,0
Brendan Allen,2020-11-14,Sean Strickland,KO/TKO,0,0,0,0
Brendan Allen,2021-04-24,Karl Roberson,Submission,90,3,0,93
Brendan Allen,2020-02-29,Tom Breese,KO/TKO,100,16,0,116
Brendan Allen,2020-06-27,Kyle Daukaus,Decision - Unanimous,80,7,0,87
Brendan Allen,2021-12-04,Chris Curtis,KO/TKO,0,0,0,0
Brendan Allen,2023-06-24,Bruno Silva,Submission,90,10,0,100
Brendan Allen,2022-10-01,Krzysztof Jotko,Submission,90,0,0,90
Brendan Allen,2023-11-18,Paul Craig,Submission,90,26,25,141
Brendan Allen,2019-10-18,Kevin Holland,Submission,90,0,0,90
Brendan Allen,2024-09-28,Nassourdine Imavov,Decision - Unanimous,0,0,0,0
Brendan Allen,2019-07-16,Aaron Jeffery,Submission,90,0,0,90
Brendan Allen,2022-06-11,Jacob Malkoun,Decision - Unanimous,80,12,0,92
Brendan Allen,2021-07-24,Punahele Soriano,Decision - Unanimous,80,28,0,108
Brendan Allen,2024-04-06,Chris Curtis,Decision - Split,70,0,25,95
Brendan Allen,2023-02-25,Andre Muniz,Submission,90,0,0,90
Brendan Allen,2022-02-05,Sam Alvey,Submission,90,12,0,102
Bryan Caraway,2012-07-21,Mitch Gagnon,Submission,90,0,0,90
Bryan Caraway,2011-12-03,Dustin Neace,Submission,90,5,0,95
Bryan Caraway,2018-11-30,Pedro Munhoz,KO/TKO,0,0,0,0
Bryan Caraway,2010-08-18,Fredson Paixao,Decision - Split,0,0,0,0
Bryan Caraway,2013-03-02,Takeya Mizugaki,Decision - Split,0,0,0,0
Bryan Caraway,2016-05-29,Aljamain Sterling,Decision - Split,70,0,0,70
Bryan Caraway,2008-06-27,Alvin Cacdac,Submission,90,0,0,90
Bryan Caraway,2010-01-10,Mark Hominick,Submission,0,5,0,5
Bryan Caraway,2014-06-07,Erik Perez,Submission,90,0,0,90
Bryan Caraway,2013-04-27,Johnny Bedford,Submission,90,0,0,90
Bryan Caraway,2015-07-25,Eddie Wineland,Decision - Unanimous,80,9,0,89
Bryan Caraway,2018-03-03,Cody Stamann,Decision - Split,0,0,0,0
Bryan Caraway,2014-10-04,Raphael Assuncao,Decision - Unanimous,0,0,0,0
Mitch Gagnon,2012-07-21,Bryan Caraway,Submission,0,16,0,16
Mitch Gagnon,2014-04-16,Tim Gorman,Decision - Unanimous,80,32,0,112
Mitch Gagnon,2016-12-10,Matthew Lopez,Decision - Unanimous,0,1,0,1
Mitch Gagnon,2014-12-20,Renan Barao,Submission,0,0,0,0
Mitch Gagnon,2014-10-04,Roman Salazar,Submission,90,2,0,92
Mitch Gagnon,2012-09-22,Walel Watson,Submission,90,4,0,94
Mitch Gagnon,2019-05-04,Cole Smith,Decision - Unanimous,0,0,0,0
Mitch Gagnon,2013-09-21,Dustin Kimura,Submission,90,12,0,102
Rafael Natal,2015-01-31,Tom Watson,Decision - Unanimous,80,38,0,118
Rafael Natal,2010-09-15,Rich Attonito,Decision - Unanimous,0,3,0,3
Rafael Natal,2013-01-26,Sean Spencer,Submission,90,52,0,142
Rafael Natal,2013-09-04,Tor Troeng,Decision - Unanimous,80,30,0,110
Rafael Natal,2011-08-06,Paul Bradley,Decision - Unanimous,80,30,0,110
Rafael Natal,2016-04-23,Robert Whittaker,Decision - Unanimous,0,0,0,0
Rafael Natal,2015-05-23,Uriah Hall,Decision - Split,70,2,0,72
Rafael Natal,2014-09-05,Chris Camozzi,Decision - Split,70,0,0,70
Rafael Natal,2016-11-12,Tim Boetsch,KO/TKO,0,0,0,0
Rafael Natal,2017-07-22,Eryk Anders,KO/TKO,0,0,0,0
Rafael Natal,2016-01-30,Kevin Casey,KO/TKO,100,38,0,138
Rafael Natal,2013-05-18,Joao Zeferino,Decision - Unanimous,80,15,0,95
Rafael Natal,2012-02-04,Michael Kuiper,Decision - Unanimous,80,6,0,86
Rafael Natal,2014-05-10,Ed Herman,Decision - Unanimous,0,0,0,0
Rafael Natal,2013-11-06,Tim Kennedy,KO/TKO,0,0,25,25
Rafael Natal,2012-07-11,Andrew Craig,KO/TKO,0,50,0,50
Tom Watson,2015-01-31,Rafael Natal,Decision - Unanimous,0,0,0,0
Tom Watson,2012-09-29,Brad Tavares,Decision - Split,0,0,0,0
Tom Watson,2014-02-01,Nick Catone,Decision - Split,0,19,0,19
Tom Watson,2013-08-03,Thales Leites,Decision - Unanimous,0,0,0,0
Tom Watson,2014-08-16,Sam Alvey,Decision - Unanimous,80,3,0,83
Tom Watson,2013-02-16,Stanislav Nedkov,KO/TKO,100,17,0,117
Tom Watson,2015-08-08,Chris Camozzi,Decision - Unanimous,0,0,0,0
Dustin Ortiz,2016-01-30,Wilson Reis,Decision - Unanimous,0,0,0,0
Dustin Ortiz,2014-01-15,John Moraga,Decision - Split,0,0,0,0
Dustin Ortiz,2014-07-06,Justin Scoggins,Decision - Split,70,15,0,85
Dustin Ortiz,2016-12-10,Zach Makovsky,Decision - Split,70,13,0,83
Dustin Ortiz,2014-04-19,Ray Borg,Decision - Split,70,34,0,104
Dustin Ortiz,2015-08-08,Willie Gates,KO/TKO,100,79,0,179
Dustin Ortiz,2013-11-09,Jose Maria,KO/TKO,100,12,0,112
Dustin Ortiz,2019-01-19,Joseph Benavidez,Decision - Unanimous,0,28,0,28
Dustin Ortiz,2016-09-24,Jussier Formiga,Decision - Unanimous,0,5,0,5
Dustin Ortiz,2017-04-22,Brandon Moreno,Submission,0,0,0,0
Dustin Ortiz,2018-07-28,Matheus Nicolau,KO/TKO,100,1,0,101
Dustin Ortiz,2018-01-20,Alexandre Pantoja,Decision - Unanimous,80,17,0,97
Dustin Ortiz,2014-11-22,Joseph Benavidez,Decision - Unanimous,0,0,0,0
Dustin Ortiz,2017-08-05,Hector Sandoval,KO/TKO,100,7,0,107
Ross Pearson,2013-04-06,Ryan Couture,KO/TKO,100,0,0,100
Ross Pearson,2011-08-27,Edson Barboza,Decision - Split,0,5,0,5
Ross Pearson,2016-03-19,Chad Laprise,Decision - Split,70,0,0,70
Ross Pearson,2014-08-16,Gray Maynard,KO/TKO,100,11,0,111
Ross Pearson,2018-02-10,Mizuto Hirota,Decision - Unanimous,80,0,0,80
Ross Pearson,2012-12-14,George Sotiropoulos,KO/TKO,100,16,25,141
Ross Pearson,2017-06-10,Dan Hooker,KO/TKO,0,0,0,0
Ross Pearson,2016-01-17,Francisco Trinaldo,Decision - Unanimous,0,0,0,0
Ross Pearson,2019-03-30,Desmond Green,KO/TKO,0,0,0,0
Ross Pearson,2009-11-14,Aaron Riley,TKO - Doctor's Stoppage,0,44,0,44
Ross Pearson,2014-06-07,Diego Sanchez,Decision - Split,0,18,0,18
Ross Pearson,2016-07-30,Jorge Masvidal,Decision - Unanimous,0,0,0,0
Ross Pearson,2014-11-07,Al Iaquinta,KO/TKO,0,0,0,0
Ross Pearson,2011-02-26,Spencer Fisher,Decision - Unanimous,80,21,0,101
Ross Pearson,2016-11-19,Stevie Ray,Decision - Split,0,0,0,0
Ross Pearson,2011-12-30,Junior Assuncao,Decision - Unanimous,80,9,0,89
Ross Pearson,2012-06-22,Cub Swanson,KO/TKO,0,0,0,0
Ross Pearson,2018-07-28,John Makdessi,Decision - Unanimous,0,0,0,0
Ross Pearson,2010-09-15,Cole Miller,Submission,0,2,0,2
Ross Pearson,2010-03-31,Dennis Siver,Decision - Unanimous,80,15,0,95
Ross Pearson,2009-06-20,Andre Winner,Decision - Unanimous,80,28,0,108
Ross Pearson,2016-07-08,Will Brooks,Decision - Unanimous,0,0,0,0
Ross Pearson,2015-07-18,Evan Dunham,Decision - Unanimous,0,0,0,0
Ross Pearson,2015-09-05,Paul Felder,Decision - Split,70,2,0,72
Ross Pearson,2015-03-14,Sam Stout,KO/TKO,100,2,0,102
Brian Johnston,1996-12-07,Ken Shamrock,Submission,0,0,0,0
Brian Johnston,1996-07-12,Scott Fiedler,KO/TKO,100,0,0,100
Brian Johnston,1996-07-12,Don Frye,KO/TKO,0,0,0,0
Brian Johnston,1996-09-20,Mark Coleman,KO/TKO,0,0,0,0
Brian Johnston,1996-09-20,Reza Nasri,KO/TKO,100,6,0,106
Brian Johnston,1997-07-27,Dan Bobish,Submission,0,0,0,0
Bryce Mitchell,2019-12-07,Matt Sayles,Submission,90,4,0,94
Bryce Mitchell,2023-09-23,Dan Ige,Decision - Unanimous,80,5,0,85
Bryce Mitchell,2018-07-06,Tyler Diamond,Decision - Majority,75,0,0,75
Bryce Mitchell,2022-03-05,Edson Barboza,Decision - Unanimous,80,18,0,98
Bryce Mitchell,2020-10-31,Andre Fili,Decision - Unanimous,80,19,0,99
Bryce Mitchell,2019-03-23,Bobby Moffett,Decision - Unanimous,80,8,0,88
Bryce Mitchell,2022-12-10,Ilia Topuria,Submission,0,0,0,0
Bryce Mitchell,2023-12-16,Josh Emmett,KO/TKO,0,0,0,0
Bryce Mitchell,2020-05-09,Charles Rosa,Decision - Unanimous,80,35,0,115
Bryce Mitchell,2024-12-07,Kron Gracie,KO/TKO,100,20,0,120
Matt Sayles,2019-12-07,Bryce Mitchell,Submission,0,0,0,0
Matt Sayles,2021-12-18,Jordan Leavitt,Submission,0,4,0,4
Matt Sayles,2018-08-04,Sheymon Moraes,Decision - Unanimous,0,4,0,4
Matt Sayles,2019-05-04,Kyle Nelson,Submission,90,49,0,139
Matt Sayles,2018-06-19,Yazan Hajeh,KO/TKO,100,31,0,131
Edson Barboza,2011-08-27,Ross Pearson,Decision - Split,70,0,0,70
Edson Barboza,2018-04-21,Kevin Lee,TKO - Doctor's Stoppage,0,0,25,25
Edson Barboza,2020-10-10,Makwan Amirkhani,Decision - Unanimous,80,21,0,101
Edson Barboza,2015-02-22,Michael Johnson,Decision - Unanimous,0,0,0,0
Edson Barboza,2015-07-25,Paul Felder,Decision - Unanimous,80,17,0,97
Edson Barboza,2015-12-11,Tony Ferguson,Submission,0,0,0,0
Edson Barboza,2017-03-11,Beneil Dariush,KO/TKO,100,0,0,100
Edson Barboza,2019-03-30,Justin Gaethje,KO/TKO,0,0,25,25
Edson Barboza,2016-07-23,Gilbert Melendez,Decision - Unanimous,80,17,0,97
Edson Barboza,2022-03-05,Bryce Mitchell,Decision - Unanimous,0,0,0,0
Edson Barboza,2017-12-30,Khabib Nurmagomedov,Decision - Unanimous,0,0,0,0
Edson Barboza,2013-12-14,Danny Castillo,Decision - Majority,75,0,0,75
Edson Barboza,2012-05-26,Jamie Varner,KO/TKO,0,0,0,0
Edson Barboza,2018-12-15,Dan Hooker,KO/TKO,100,45,0,145
Edson Barboza,2010-11-20,Mike Lullo,KO/TKO,100,31,0,131
Edson Barboza,2016-04-23,Anthony Pettis,Decision - Unanimous,80,25,0,105
Edson Barboza,2023-04-15,Billy Quarantillo,KO/TKO,100,2,0,102
Edson Barboza,2023-10-14,Sodiq Yusuff,Decision - Unanimous,80,0,25,105
Edson Barboza,2021-05-15,Shane Burgos,KO/TKO,100,18,0,118
Edson Barboza,2021-08-28,Giga Chikadze,KO/TKO,0,0,25,25
Edson Barboza,2020-05-16,Dan Ige,Decision - Split,0,1,0,1
Edson Barboza,2014-07-16,Evan Dunham,KO/TKO,100,0,0,100
Edson Barboza,2014-04-19,Donald Cerrone,Submission,0,17,0,17
Edson Barboza,2013-01-19,Lucas Martins,KO/TKO,100,14,0,114
Edson Barboza,2011-03-19,Anthony Njokuani,Decision - Unanimous,80,0,0,80
Edson Barboza,2019-09-07,Paul Felder,Decision - Split,0,4,0,4
Edson Barboza,2014-11-22,Bobby Green,Decision - Unanimous,80,4,0,84
Edson Barboza,2024-05-18,Lerone Murphy,Decision - Unanimous,0,0,25,25
Edson Barboza,2012-01-14,Terry Etim,KO/TKO,100,21,0,121
Edson Barboza,2013-07-06,Rafaello Oliveira,KO/TKO,100,30,0,130
Jon Hess,1995-04-07,Andy Anderson,KO/TKO,100,15,0,115
Andy Anderson,1995-04-07,Jon Hess,KO/TKO,0,0,0,0
Chris Curtis,2021-11-06,Phil Hawes,KO/TKO,100,0,0,100
Chris Curtis,2023-04-08,Kelvin Gastelum,Decision - Unanimous,0,0,0,0
Chris Curtis,2024-01-20,Marc-Andre Barriault,Decision - Split,70,18,0,88
Chris Curtis,2022-12-10,Joaquin Buckley,KO/TKO,100,0,0,100
Chris Curtis,2018-06-12,Sean Lally,KO/TKO,100,22,0,122
Chris Curtis,2021-12-04,Brendan Allen,KO/TKO,100,18,0,118
Chris Curtis,2022-07-23,Jack Hermansson,Decision - Unanimous,0,0,0,0
Chris Curtis,2022-06-25,Rodolfo Vieira,Decision - Unanimous,80,23,0,103
Chris Curtis,2024-04-06,Brendan Allen,Decision - Split,0,12,25,37
Phil Hawes,2021-11-06,Chris Curtis,KO/TKO,0,27,0,27
Phil Hawes,2022-10-29,Roman Dolidze,KO/TKO,0,0,0,0
Phil Hawes,2023-05-06,Ikram Aliskerov,KO/TKO,0,0,0,0
Phil Hawes,2024-01-13,Brunno Ferreira,KO/TKO,0,0,0,0
Phil Hawes,2020-10-24,Jacob Malkoun,KO/TKO,100,7,0,107
Phil Hawes,2022-06-18,Deron Winn,KO/TKO,100,86,0,186
Phil Hawes,2020-09-08,Khadzhi Bestaev,KO/TKO,100,5,0,105
Phil Hawes,2017-08-01,Julian Marquez,KO/TKO,0,0,0,0
Phil Hawes,2021-02-20,Nassourdine Imavov,Decision - Majority,75,0,0,75
Phil Hawes,2021-05-08,Kyle Daukaus,Decision - Unanimous,80,38,0,118
Vitor Belfort,1997-02-07,Scott Ferrozzo,KO/TKO,100,9,0,109
Vitor Belfort,2009-09-19,Rich Franklin,KO/TKO,100,5,0,105
Vitor Belfort,2016-10-08,Gegard Mousasi,KO/TKO,0,0,0,0
Vitor Belfort,2011-08-06,Yoshihiro Akiyama,KO/TKO,100,11,0,111
Vitor Belfort,2007-09-22,James Zikic,Decision - Unanimous,80,3,0,83
Vitor Belfort,1997-10-17,Randy Couture,KO/TKO,0,0,0,0
Vitor Belfort,2013-01-19,Michael Bisping,KO/TKO,100,4,25,129
Vitor Belfort,1997-02-07,Tra Telligman,KO/TKO,100,16,0,116
Vitor Belfort,2006-07-01,Yoshiki Takahashi,KO/TKO,100,0,0,100
Vitor Belfort,2008-07-19,Terry Martin,KO/TKO,100,16,0,116
Vitor Belfort,2004-01-31,Randy Couture,TKO - Doctor's Stoppage,0,0,25,25
Vitor Belfort,2000-08-27,Daijiro Matsui,Decision,0,47,0,47
Vitor Belfort,2004-08-21,Randy Couture,TKO - Doctor's Stoppage,0,0,25,25
Vitor Belfort,2015-11-07,Dan Henderson,KO/TKO,100,3,25,128
Vitor Belfort,2006-10-21,Dan Henderson,Decision - Unanimous,0,0,0,0
Vitor Belfort,2005-04-23,Alistair Overeem,Submission,0,0,0,0
Vitor Belfort,2009-01-24,Matt Lindland,KO/TKO,100,5,0,105
Vitor Belfort,2012-09-22,Jon Jones,Submission,0,0,25,25
Vitor Belfort,2011-02-05,Anderson Silva,KO/TKO,0,0,25,25
Vitor Belfort,2006-06-09,Alistair Overeem,Decision - Unanimous,0,0,0,0
Vitor Belfort,2017-06-03,Nate Marquardt,Decision - Unanimous,80,0,0,80
Vitor Belfort,2016-05-14,Jacare Souza,KO/TKO,0,0,0,0
Vitor Belfort,2018-05-12,Lyoto Machida,KO/TKO,0,0,0,0
Vitor Belfort,1997-12-21,Joe Charles,Submission,90,0,0,90
Vitor Belfort,2000-06-04,Gilbert Yvel,Decision - Unanimous,80,16,0,96
Vitor Belfort,2001-05-27,Heath Herring,Decision - Unanimous,80,0,0,80
Vitor Belfort,2012-01-14,Anthony Johnson,Submission,90,10,0,100
Vitor Belfort,2005-02-05,Tito Ortiz,Decision - Split,0,0,0,0
Vitor Belfort,2001-03-25,Bobby Southworth,Submission,90,3,0,93
Vitor Belfort,1999-04-29,Kazushi Sakuraba,Decision - Unanimous,0,0,0,0
Vitor Belfort,2003-06-06,Marvin Eastman,KO/TKO,100,8,0,108
Vitor Belfort,2007-04-21,Ivan Serati,KO/TKO,100,15,0,115
Vitor Belfort,1998-10-16,Wanderlei Silva,KO/TKO,100,6,0,106
Vitor Belfort,2015-05-23,Chris Weidman,KO/TKO,0,0,25,25
Vitor Belfort,2002-06-22,Chuck Liddell,Decision - Unanimous,0,0,0,0
Vitor Belfort,2013-11-09,Dan Henderson,KO/TKO,100,11,25,136
Vitor Belfort,2013-05-18,Luke Rockhold,KO/TKO,100,3,25,128
Vitor Belfort,1997-05-30,David Abbott,KO/TKO,100,13,0,113
Scott Ferrozzo,1997-02-07,Vitor Belfort,KO/TKO,0,0,0,0
Scott Ferrozzo,1996-02-16,Jerry Bohlander,Submission,0,2,0,2
Scott Ferrozzo,1996-09-20,David Abbott,Decision - Unanimous,80,39,0,119
Scott Ferrozzo,1997-02-07,Jim Mullen,KO/TKO,100,27,0,127
Leonardo Santos,2015-12-12,Kevin Lee,KO/TKO,100,22,0,122
Leonardo Santos,2019-06-01,Stevie Ray,KO/TKO,100,10,0,110
Leonardo Santos,2013-06-08,William Macario,Submission,90,0,0,90
Leonardo Santos,2021-03-20,Grant Dawson,KO/TKO,0,0,0,0
Leonardo Santos,2016-10-08,Adriano Martins,Decision - Split,70,0,0,70
Leonardo Santos,2020-07-11,Roman Bogatov,Decision - Unanimous,80,16,0,96
Leonardo Santos,2014-09-13,Efrain Escudero,Decision - Unanimous,80,0,0,80
Leonardo Santos,2021-12-04,Clay Guida,Submission,0,23,0,23
Leonardo Santos,2015-03-21,Anthony Rocco Martin,Submission,90,0,0,90
Leonardo Santos,2022-08-20,Jared Gordon,Decision - Unanimous,0,0,0,0
Kevin Lee,2015-12-12,Leonardo Santos,KO/TKO,0,0,0,0
Kevin Lee,2020-03-14,Charles Oliveira,Submission,0,0,25,25
Kevin Lee,2015-02-14,Michel Prazeres,Decision - Unanimous,80,29,0,109
Kevin Lee,2018-04-21,Edson Barboza,TKO - Doctor's Stoppage,0,91,25,116
Kevin Lee,2016-11-19,Magomed Mustafaev,Submission,90,0,0,90
Kevin Lee,2019-11-02,Gregor Gillespie,KO/TKO,100,12,0,112
Kevin Lee,2019-05-18,Rafael Dos Anjos,Submission,0,0,25,25
Kevin Lee,2018-12-15,Al Iaquinta,Decision - Unanimous,0,0,25,25
Kevin Lee,2015-07-15,James Moontasri,Submission,90,3,0,93
Kevin Lee,2014-02-01,Al Iaquinta,Decision - Unanimous,0,0,0,0
Kevin Lee,2016-07-08,Jake Matthews,KO/TKO,100,19,0,119
Kevin Lee,2014-09-27,Jon Tuck,Decision - Unanimous,80,44,0,124
Kevin Lee,2023-07-01,Rinat Fakhretdinov,Submission,0,0,0,0
Kevin Lee,2014-07-06,Jesse Ronson,Decision - Split,70,1,0,71
Kevin Lee,2017-03-11,Francisco Trinaldo,Submission,90,0,0,90
Kevin Lee,2017-06-25,Michael Chiesa,Submission,90,18,25,133
Kevin Lee,2021-08-28,Daniel Rodriguez,Decision - Unanimous,0,0,0,0
Kevin Lee,2016-04-23,Efrain Escudero,Decision - Unanimous,80,0,0,80
Kevin Lee,2017-10-07,Tony Ferguson,Submission,0,1,25,26
Forrest Petz,2006-08-17,Sammy Morgan,Decision - Unanimous,80,37,0,117
Forrest Petz,2010-07-03,Daniel Roberts,Decision - Split,0,16,0,16
Forrest Petz,2006-10-10,Marcus Davis,Submission,0,0,0,0
Forrest Petz,2007-10-20,Joshua Burkman,Decision - Split,0,21,0,21
Forrest Petz,2010-09-15,Brian Foster,KO/TKO,0,0,0,0
Forrest Petz,2007-04-05,Kuniyoshi Hironaka,Decision - Unanimous,0,0,0,0
Forrest Petz,2007-06-12,Luigi Fioravanti,Decision - Unanimous,80,0,0,80
Sammy Morgan,2006-08-17,Forrest Petz,Decision - Unanimous,0,0,0,0
Sammy Morgan,2005-11-05,Joshua Burkman,KO/TKO,0,0,0,0
Sammy Morgan,2008-01-25,Paul Daley,KO/TKO,0,0,0,0
Sammy Morgan,2007-11-16,Cung Le,KO/TKO,0,0,0,0
Sammy Morgan,2008-10-03,Duane Ludwig,KO/TKO,0,0,0,0
Jessica Penne,2014-12-12,Randa Markos,Decision - Split,70,0,0,70
Jessica Penne,2021-08-07,Karolina Kowalkiewicz,Submission,90,4,0,94
Jessica Penne,2016-06-04,Jessica Andrade,KO/TKO,0,0,0,0
Jessica Penne,2013-04-05,Michelle Waterson-Gomez,Submission,0,0,25,25
Jessica Penne,2023-03-04,Tabatha Ricci,Submission,0,0,0,0
Jessica Penne,2017-04-22,Danielle Taylor,Decision - Unanimous,0,0,0,0
Jessica Penne,2022-07-16,Emily Ducote,Decision - Unanimous,0,0,0,0
Jessica Penne,2012-04-28,Lisa Ellis,KO/TKO,100,0,0,100
Jessica Penne,2012-10-06,Naho Sugiyuma,Submission,90,0,25,115
Jessica Penne,2024-10-19,Elise Reed,Decision - Unanimous,0,0,0,0
Jessica Penne,2013-07-13,Nicdali Rivera-Calanoc,Submission,90,3,0,93
Jessica Penne,2015-06-20,Joanna Jedrzejczyk,KO/TKO,0,0,25,25
Jessica Penne,2021-04-17,Loopy Godinez,Decision - Split,70,0,0,70
Randa Markos,2014-12-12,Jessica Penne,Decision - Split,0,16,0,16
Randa Markos,2016-08-20,Cortney Casey,Submission,0,0,0,0
Randa Markos,2020-03-14,Amanda Ribas,Decision - Unanimous,0,0,0,0
Randa Markos,2017-02-19,Carla Esparza,Decision - Split,70,16,0,86
Randa Markos,2017-08-05,Alexa Grasso,Decision - Split,0,0,0,0
Randa Markos,2018-07-28,Nina Nunes,Decision - Unanimous,0,0,0,0
Randa Markos,2021-05-01,Luana Pinheiro,DQ,0,0,0,0
Randa Markos,2016-06-18,Jocelyn Jones-Lybarger,Decision - Unanimous,80,7,0,87
Randa Markos,2015-04-25,Aisling Daly,Decision - Unanimous,80,0,0,80
Randa Markos,2015-12-19,Karolina Kowalkiewicz,Decision - Unanimous,0,0,0,0
Randa Markos,2020-09-19,Mackenzie Dern,Submission,0,0,0,0
Randa Markos,2019-07-06,Claudia Gadelha,Decision - Unanimous,0,0,0,0
Randa Markos,2021-10-23,Livinha Souza,Decision - Unanimous,80,54,0,134
Randa Markos,2018-01-27,Juliana Lima,Decision - Unanimous,80,28,0,108
Randa Markos,2020-11-14,Kanako Murata,Decision - Unanimous,0,0,0,0
Randa Markos,2019-10-26,Ashley Yoder,Decision - Split,70,34,0,104
Randa Markos,2019-03-23,Angela Hill,Submission,90,11,0,101
Chael Sonnen,2006-04-06,Trevor Prangley,Decision - Unanimous,80,18,0,98
Chael Sonnen,2008-03-26,Bryan Baker,Decision - Unanimous,80,64,0,144
Chael Sonnen,2006-05-27,Jeremy Horn,Submission,0,3,0,3
Chael Sonnen,2007-12-12,Paulo Filho,Submission,0,29,25,54
Chael Sonnen,2010-08-07,Anderson Silva,Submission,0,60,25,85
Chael Sonnen,2010-02-06,Nate Marquardt,Decision - Unanimous,80,28,0,108
Chael Sonnen,2009-02-21,Demian Maia,Submission,0,2,0,2
Chael Sonnen,2012-07-07,Anderson Silva,KO/TKO,0,7,25,32
Chael Sonnen,2012-01-28,Michael Bisping,Decision - Unanimous,80,10,0,90
Chael Sonnen,2013-04-27,Jon Jones,KO/TKO,0,0,25,25
Chael Sonnen,2005-10-07,Renato Sobral,Submission,0,1,0,1
Chael Sonnen,2011-10-08,Brian Stann,Submission,90,26,0,116
Chael Sonnen,2009-10-24,Yushin Okami,Decision - Unanimous,80,66,0,146
Chael Sonnen,2013-11-16,Rashad Evans,KO/TKO,0,0,0,0
Chael Sonnen,2009-05-23,Dan Miller,Decision - Unanimous,80,27,0,107
Chael Sonnen,2008-11-05,Paulo Filho,Decision - Unanimous,80,48,0,128
Chael Sonnen,2013-08-17,Mauricio Rua,Submission,90,5,25,120
Chael Sonnen,2003-09-06,Forrest Griffin,Submission,0,3,0,3
Guy Mezger,1995-04-07,John Dowdy,KO/TKO,100,12,0,112
Guy Mezger,2001-05-27,Chuck Liddell,KO/TKO,0,6,0,6
Guy Mezger,2001-03-25,Egan Inoue,KO/TKO,100,4,0,104
Guy Mezger,1999-03-05,Tito Ortiz,KO/TKO,0,0,0,0
Guy Mezger,2002-09-29,Yoshihisa Yamamoto,Decision - Unanimous,80,55,0,135
Guy Mezger,2000-08-27,Wanderlei Silva,KO/TKO,0,0,0,0
Guy Mezger,1994-12-16,Jason Fairn,KO/TKO,100,10,0,110
Guy Mezger,1997-05-30,Tito Ortiz,Submission,90,0,0,90
Guy Mezger,2000-12-09,Alexander Otsuka,KO/TKO,100,10,0,110
Guy Mezger,2000-05-01,Masaaki Satake,Decision - Unanimous,80,18,0,98
Guy Mezger,2000-01-30,Kazushi Sakuraba,Other,0,4,0,4
Guy Mezger,1997-05-30,Christophe Leninger,Decision - Unanimous,80,32,0,112
Guy Mezger,2002-12-23,Rogerio Nogueira,Decision - Split,0,8,0,8
Guy Mezger,1999-07-04,Akira Shoji,Decision - Split,0,16,0,16
Guy Mezger,2001-09-24,Ricardo Arona,Decision - Split,0,0,0,0
John Dowdy,1995-04-07,Guy Mezger,KO/TKO,0,0,0,0
Todd Duffee,2009-08-29,Tim Hague,KO/TKO,100,4,0,104
Todd Duffee,2012-12-29,Philip De Fries,KO/TKO,100,13,0,113
Todd Duffee,2014-12-06,Anthony Hamilton,KO/TKO,100,6,0,106
Todd Duffee,2015-07-15,Frank Mir,KO/TKO,0,0,25,25
Todd Duffee,2010-12-31,Alistair Overeem,KO/TKO,0,0,0,0
Todd Duffee,2010-05-29,Mike Russow,KO/TKO,0,37,0,37
Tim Hague,2009-08-29,Todd Duffee,KO/TKO,0,0,0,0
Tim Hague,2009-05-23,Pat Barry,Submission,90,0,0,90
Tim Hague,2010-05-08,Joey Beltran,Decision - Unanimous,0,0,0,0
Tim Hague,2011-01-22,Matt Mitrione,KO/TKO,0,0,0,0
Tim Hague,2010-02-06,Chris Tuchscherer,Decision - Majority,0,10,0,10
Anthony Pettis,2013-08-31,Benson Henderson,Submission,90,0,25,115
Anthony Pettis,2019-08-17,Nate Diaz,Decision - Unanimous,0,0,0,0
Anthony Pettis,2011-06-04,Clay Guida,Decision - Unanimous,0,0,0,0
Anthony Pettis,2018-07-07,Michael Chiesa,Submission,90,0,0,90
Anthony Pettis,2009-06-07,Mike Campbell,Submission,90,0,0,90
Anthony Pettis,2013-01-26,Donald Cerrone,KO/TKO,100,14,0,114
Anthony Pettis,2020-05-09,Donald Cerrone,Decision - Unanimous,80,1,0,81
Anthony Pettis,2017-11-11,Dustin Poirier,KO/TKO,0,0,25,25
Anthony Pettis,2012-02-25,Joe Lauzon,KO/TKO,100,9,0,109
Anthony Pettis,2016-12-10,Max Holloway,KO/TKO,0,0,25,25
Anthony Pettis,2014-12-06,Gilbert Melendez,Submission,90,3,25,118
Anthony Pettis,2018-10-06,Tony Ferguson,KO/TKO,0,0,0,0
Anthony Pettis,2016-04-23,Edson Barboza,Decision - Unanimous,0,0,0,0
Anthony Pettis,2019-03-23,Stephen Thompson,KO/TKO,100,0,25,125
Anthony Pettis,2016-08-27,Charles Oliveira,Submission,90,12,0,102
Anthony Pettis,2009-12-19,Bart Palaszewski,Decision - Split,0,10,0,10
Anthony Pettis,2010-04-24,Alex Karalexis,Submission,90,7,0,97
Anthony Pettis,2016-01-17,Eddie Alvarez,Decision - Split,0,14,0,14
Anthony Pettis,2015-03-14,Rafael Dos Anjos,Decision - Unanimous,0,0,25,25
Anthony Pettis,2020-01-18,Diego Ferreira,Submission,0,0,0,0
Anthony Pettis,2011-10-08,Jeremy Stephens,Decision - Split,70,4,0,74
Anthony Pettis,2017-07-08,Jim Miller,Decision - Unanimous,80,32,0,112
Anthony Pettis,2020-12-19,Alex Morono,Decision - Unanimous,80,19,0,99
Anthony Pettis,2010-03-06,Danny Castillo,KO/TKO,100,0,0,100
Anthony Pettis,2010-12-16,Benson Henderson,Decision - Unanimous,80,4,25,109
Anthony Pettis,2010-08-18,Shane Roller,Submission,90,21,0,111
Tiago dos Santos e Silva,2014-07-26,Akbarh Arreola,Decision - Unanimous,80,32,0,112
Tiago dos Santos e Silva,2015-02-22,Mike de la Torre,KO/TKO,0,0,0,0
Tiago dos Santos e Silva,2015-09-05,Clay Collard,Decision - Split,70,0,0,70
Tiago dos Santos e Silva,2016-12-09,Shane Burgos,Decision - Unanimous,0,0,0,0
Akbarh Arreola,2014-07-26,Tiago dos Santos e Silva,Decision - Unanimous,0,0,0,0
Akbarh Arreola,2014-11-22,Yves Edwards,Submission,90,7,0,97
Akbarh Arreola,2015-03-21,Francisco Trinaldo,Decision - Unanimous,0,0,0,0
Akbarh Arreola,2015-11-14,Jake Matthews,TKO - Doctor's Stoppage,0,0,0,0
Song Yadong,2023-12-09,Chris Gutierrez,Decision - Unanimous,80,0,25,105
Song Yadong,2022-09-17,Cory Sandhagen,TKO - Doctor's Stoppage,0,0,25,25
Song Yadong,2018-11-24,Vince Morales,Decision - Unanimous,80,5,0,85
Song Yadong,2017-11-25,Bharat Kandare,Submission,90,5,0,95
Song Yadong,2018-06-23,Felipe Arantes,KO/TKO,100,31,0,131
Song Yadong,2022-03-12,Marlon Moraes,KO/TKO,100,5,0,105
Song Yadong,2024-03-09,Petr Yan,Decision - Unanimous,0,0,0,0
Song Yadong,2021-08-07,Casey Kenney,Decision - Split,70,38,0,108
Song Yadong,2020-05-16,Marlon Vera,Decision - Unanimous,80,9,0,89
Song Yadong,2021-11-13,Julio Arce,KO/TKO,100,17,0,117
Song Yadong,2021-03-06,Kyler Phillips,Decision - Unanimous,0,8,0,8
Song Yadong,2023-04-29,Ricky Simon,KO/TKO,100,45,25,170
Song Yadong,2019-07-06,Alejandro Perez,KO/TKO,100,7,0,107
Chris Gutierrez,2023-12-09,Song Yadong,Decision - Unanimous,0,10,25,35
Chris Gutierrez,2021-02-13,Andre Ewell,Decision - Unanimous,80,10,0,90
Chris Gutierrez,2018-11-30,Raoni Barcelos,Submission,0,0,0,0
Chris Gutierrez,2023-04-15,Pedro Munhoz,Decision - Unanimous,0,17,0,17
Chris Gutierrez,2022-03-26,Batgerel Danaa,KO/TKO,100,11,0,111
Chris Gutierrez,2023-10-14,Alatengheili,Decision - Unanimous,80,72,0,152
Chris Gutierrez,2024-08-10,Quang Le,Decision - Unanimous,80,43,0,123
Chris Gutierrez,2021-10-09,Felipe Colares,Decision - Split,70,55,0,125
Chris Gutierrez,2019-08-10,Geraldo de Freitas,Decision - Split,70,8,0,78
Chris Gutierrez,2020-05-30,Vince Morales,KO/TKO,100,52,0,152
Chris Gutierrez,2022-11-12,Frankie Edgar,KO/TKO,100,8,0,108
Chris Gutierrez,2019-03-23,Ryan MacDonald,Decision - Unanimous,80,54,0,134
Jared Gordon,2017-10-28,Hacran Dias,Decision - Unanimous,80,69,0,149
Jared Gordon,2021-02-20,Danny Chavez,Decision - Unanimous,80,43,0,123
Jared Gordon,2018-12-15,Joaquim Silva,KO/TKO,0,21,0,21
Jared Gordon,2020-07-15,Chris Fishgold,Decision - Unanimous,80,24,0,104
Jared Gordon,2022-04-30,Grant Dawson,Submission,0,23,0,23
Jared Gordon,2019-11-16,Charles Oliveira,KO/TKO,0,0,0,0
Jared Gordon,2024-06-22,Nasrat Haqparast,Decision - Split,0,0,0,0
Jared Gordon,2023-11-11,Mark Madsen,KO/TKO,100,1,0,101
Jared Gordon,2019-06-29,Dan Moret,Decision - Unanimous,80,14,0,94
Jared Gordon,2021-10-02,Joe Solecki,Decision - Split,70,13,0,83
Jared Gordon,2017-06-25,Michel Quinones,KO/TKO,100,51,0,151
Jared Gordon,2022-12-10,Paddy Pimblett,Decision - Unanimous,0,0,0,0
Jared Gordon,2022-08-20,Leonardo Santos,Decision - Unanimous,80,80,0,160
Jared Gordon,2018-02-18,Diego Ferreira,KO/TKO,0,0,0,0
Hacran Dias,2017-10-28,Jared Gordon,Decision - Unanimous,0,0,0,0
Hacran Dias,2012-06-23,Iuri Alcantara,Decision - Unanimous,80,0,0,80
Hacran Dias,2013-05-18,Nik Lentz,Decision - Unanimous,0,0,0,0
Hacran Dias,2014-12-20,Darren Elkins,Decision - Unanimous,80,0,0,80
Hacran Dias,2015-06-27,Levan Makashvili,Decision - Split,70,0,0,70
Hacran Dias,2016-04-16,Cub Swanson,Decision - Unanimous,0,0,0,0
Hacran Dias,2014-06-28,Ricardo Lamas,Decision - Unanimous,0,0,0,0
Hacran Dias,2016-10-01,Andre Fili,Decision - Unanimous,0,0,0,0
Austen Lane,2023-09-09,Justin Tafa,KO/TKO,0,0,0,0
Austen Lane,2024-04-27,Jhonata Diniz,KO/TKO,0,0,0,0
Austen Lane,2022-09-20,Richard Jacobi,KO/TKO,100,14,0,114
Austen Lane,2018-06-12,Greg Hardy,KO/TKO,0,0,0,0
Austen Lane,2024-10-19,Robelis Despaigne,Decision - Unanimous,80,0,0,80
Ricardo Lamas,2018-11-17,Darren Elkins,KO/TKO,100,8,0,108
Ricardo Lamas,2009-08-09,Danny Castillo,KO/TKO,0,2,0,2
Ricardo Lamas,2016-11-05,Charles Oliveira,Submission,90,0,0,90
Ricardo Lamas,2017-07-29,Jason Knight,KO/TKO,100,34,0,134
Ricardo Lamas,2019-06-08,Calvin Kattar,KO/TKO,0,0,0,0
Ricardo Lamas,2015-04-04,Chad Mendes,KO/TKO,0,0,25,25
Ricardo Lamas,2014-02-01,Jose Aldo,Decision - Unanimous,0,0,25,25
Ricardo Lamas,2012-06-22,Hatsu Hioki,Decision - Unanimous,80,19,0,99
Ricardo Lamas,2010-03-06,Bendy Casimir,KO/TKO,100,5,0,105
Ricardo Lamas,2014-11-15,Dennis Bermudez,Submission,90,6,0,96
Ricardo Lamas,2009-11-18,James Krause,Decision - Unanimous,80,0,0,80
Ricardo Lamas,2017-12-16,Josh Emmett,KO/TKO,0,7,0,7
Ricardo Lamas,2010-08-18,Dave Jansen,Decision - Unanimous,80,0,0,80
Ricardo Lamas,2013-01-26,Erik Koch,KO/TKO,100,18,0,118
Ricardo Lamas,2009-03-01,Bart Palaszewski,Decision - Unanimous,80,12,0,92
Ricardo Lamas,2020-08-29,Bill Algeo,Decision - Unanimous,80,15,0,95
Ricardo Lamas,2015-11-21,Diego Sanchez,Decision - Unanimous,80,27,0,107
Ricardo Lamas,2016-06-04,Max Holloway,Decision - Unanimous,0,0,0,0
Ricardo Lamas,2010-12-16,Iuri Alcantara,KO/TKO,0,0,0,0
Ricardo Lamas,2018-06-09,Mirsad Bektic,Decision - Split,0,3,0,3
Ricardo Lamas,2014-06-28,Hacran Dias,Decision - Unanimous,80,2,0,82
Ricardo Lamas,2011-06-26,Matt Grice,KO/TKO,100,10,0,110
Ricardo Lamas,2011-11-12,Cub Swanson,Submission,90,0,0,90
Chidi Njokuani,2022-02-05,Marc-Andre Barriault,KO/TKO,100,9,0,109
Chidi Njokuani,2022-05-21,Dusko Todorovic,KO/TKO,100,9,0,109
Chidi Njokuani,2024-10-12,Jared Gooden,Decision - Unanimous,80,85,0,165
Chidi Njokuani,2024-03-30,Rhys McKee,Decision - Split,70,34,0,104
Chidi Njokuani,2022-09-17,Gregory Rodrigues,KO/TKO,0,0,0,0
Chidi Njokuani,2021-09-07,Mario Sousa,KO/TKO,100,52,0,152
Chidi Njokuani,2023-03-25,Albert Duraev,Decision - Split,0,0,0,0
Chidi Njokuani,2023-08-26,Michal Oleksiejczuk,KO/TKO,0,0,0,0
Marc-Andre Barriault,2022-02-05,Chidi Njokuani,KO/TKO,0,0,0,0
Marc-Andre Barriault,2019-07-27,Krzysztof Jotko,Decision - Split,0,0,0,0
Marc-Andre Barriault,2024-06-29,Joe Pyfer,KO/TKO,0,0,0,0
Marc-Andre Barriault,2022-09-17,Anthony Hernandez,Submission,0,0,0,0
Marc-Andre Barriault,2023-03-04,Julian Marquez,KO/TKO,100,27,0,127
Marc-Andre Barriault,2024-01-20,Chris Curtis,Decision - Split,0,0,0,0
Marc-Andre Barriault,2019-12-21,JunYong Park,Decision - Unanimous,0,0,0,0
Marc-Andre Barriault,2021-09-04,Dalcha Lungiambula,Decision - Unanimous,80,33,0,113
Marc-Andre Barriault,2019-05-04,Andrew Sanchez,Decision - Unanimous,0,0,0,0
Marc-Andre Barriault,2022-04-23,Jordan Wright,Submission,90,1,0,91
Marc-Andre Barriault,2024-11-02,Dustin Stoltzfus,KO/TKO,0,0,0,0
Marc-Andre Barriault,2023-06-10,Eryk Anders,Decision - Unanimous,80,12,0,92
Marc-Andre Barriault,2021-03-27,Abu Azaitar,KO/TKO,100,33,0,133
Jennifer Maia,2022-01-15,Katlyn Cerminara,Decision - Unanimous,0,0,0,0
Jennifer Maia,2023-03-18,Casey O'Neill,Decision - Unanimous,80,8,0,88
Jennifer Maia,2019-07-20,Roxanne Modafferi,Decision - Unanimous,80,54,0,134
Jennifer Maia,2018-07-14,Liz Carmouche,Decision - Unanimous,0,0,0,0
Jennifer Maia,2020-11-21,Valentina Shevchenko,Decision - Unanimous,0,0,25,25
Jennifer Maia,2019-03-23,Alexis Davis,Decision - Unanimous,80,0,0,80
Jennifer Maia,2023-10-14,Viviane Araujo,Decision - Unanimous,0,17,0,17
Jennifer Maia,2021-07-10,Jessica Eye,Decision - Unanimous,80,0,0,80
Jennifer Maia,2020-08-01,Joanne Wood,Submission,90,0,0,90
Jennifer Maia,2019-11-02,Katlyn Cerminara,Decision - Unanimous,0,0,0,0
Jennifer Maia,2022-03-26,Manon Fiorot,Decision - Unanimous,0,0,0,0
Jennifer Maia,2022-11-19,Maryna Moroz,Decision - Unanimous,80,29,0,109
Fabricio Werdum,2008-01-19,Gabriel Gonzaga,KO/TKO,100,27,0,127
Fabricio Werdum,2020-07-25,Alexander Gustafsson,Submission,90,0,0,90
Fabricio Werdum,2006-02-26,Jon Olav Einemo,Decision - Unanimous,80,28,0,108
Fabricio Werdum,2018-03-17,Alexander Volkov,KO/TKO,0,0,25,25
Fabricio Werdum,2016-05-14,Stipe Miocic,KO/TKO,0,0,25,25
Fabricio Werdum,2003-03-22,Kristof Midoux,Submission,90,0,0,90
Fabricio Werdum,2006-11-12,Aleksander Emelianenko,Submission,90,4,0,94
Fabricio Werdum,2005-10-23,Sergei Kharitonov,Decision - Split,0,2,0,2
Fabricio Werdum,2005-02-20,Tom Erikson,Submission,90,11,0,101
Fabricio Werdum,2017-07-08,Alistair Overeem,Decision - Majority,0,28,0,28
Fabricio Werdum,2008-10-25,Junior Dos Santos,KO/TKO,0,0,0,0
Fabricio Werdum,2014-04-19,Travis Browne,Decision - Unanimous,80,61,25,166
Fabricio Werdum,2009-08-15,Mike Kyle,Submission,90,1,0,91
Fabricio Werdum,2015-06-13,Cain Velasquez,Submission,90,8,25,123
Fabricio Werdum,2004-05-15,Ebenezer Fontes Braga,KO/TKO,100,0,0,100
Fabricio Werdum,2013-06-08,Antonio Rodrigo Nogueira,Submission,90,18,25,133
Fabricio Werdum,2011-06-18,Alistair Overeem,Decision - Unanimous,0,11,0,11
Fabricio Werdum,2012-02-04,Roy Nelson,Decision - Unanimous,80,65,0,145
Fabricio Werdum,2005-08-28,Roman Zentsov,Submission,90,0,0,90
Fabricio Werdum,2020-05-09,Aleksei Oleinik,Decision - Split,0,0,0,0
Fabricio Werdum,2007-04-21,Andrei Arlovski,Decision - Unanimous,0,0,0,0
Fabricio Werdum,2009-11-07,Antonio Silva,Decision - Unanimous,80,4,0,84
Fabricio Werdum,2017-10-07,Walt Harris,Submission,90,0,0,90
Fabricio Werdum,2017-11-18,Marcin Tybura,Decision - Unanimous,80,28,25,133
Fabricio Werdum,2016-09-10,Travis Browne,Decision - Unanimous,80,47,0,127
Fabricio Werdum,2010-06-26,Fedor Emelianenko,Submission,90,0,0,90
Fabricio Werdum,2003-09-13,Gabriel Gonzaga,KO/TKO,100,44,0,144
Fabricio Werdum,2006-05-05,Alistair Overeem,Submission,90,0,0,90
Fabricio Werdum,2006-07-01,Antonio Rodrigo Nogueira,Decision - Unanimous,0,0,0,0
Fabricio Werdum,2008-06-07,Brandon Vera,KO/TKO,100,0,0,100
Fabricio Werdum,2014-11-15,Mark Hunt,KO/TKO,100,11,25,136
Fabricio Werdum,2012-06-23,Mike Russow,KO/TKO,100,28,0,128
Gabriel Gonzaga,2008-01-19,Fabricio Werdum,KO/TKO,0,0,0,0
Gabriel Gonzaga,2016-04-10,Derrick Lewis,KO/TKO,0,0,0,0
Gabriel Gonzaga,2013-10-19,Shawn Jordan,KO/TKO,100,6,0,106
Gabriel Gonzaga,2008-11-15,Josh Hendricks,KO/TKO,100,11,0,111
Gabriel Gonzaga,2007-04-21,Mirko Filipovic,KO/TKO,100,18,0,118
Gabriel Gonzaga,2013-07-06,Dave Herman,KO/TKO,100,0,0,100
Gabriel Gonzaga,2008-07-05,Justin McCully,Submission,90,4,0,94
Gabriel Gonzaga,2015-12-11,Konstantin Erokhin,Decision - Unanimous,80,5,0,85
Gabriel Gonzaga,2010-10-23,Brendan Schaub,Decision - Unanimous,0,0,0,0
Gabriel Gonzaga,2010-03-21,Junior Dos Santos,KO/TKO,0,0,0,0
Gabriel Gonzaga,2014-01-25,Stipe Miocic,Decision - Unanimous,0,0,0,0
Gabriel Gonzaga,2015-04-11,Mirko Filipovic,KO/TKO,0,0,25,25
Gabriel Gonzaga,2005-11-19,Kevin Jordan,KO/TKO,100,5,0,105
Gabriel Gonzaga,2013-04-13,Travis Browne,KO/TKO,0,0,0,0
Gabriel Gonzaga,2014-12-13,Matt Mitrione,KO/TKO,0,0,0,0
Gabriel Gonzaga,2009-08-29,Chris Tuchscherer,KO/TKO,100,22,0,122
Gabriel Gonzaga,2006-05-27,Fabiano Scherner,KO/TKO,100,8,0,108
Gabriel Gonzaga,2007-08-25,Randy Couture,KO/TKO,0,0,25,25
Gabriel Gonzaga,2013-01-19,Ben Rothwell,Submission,90,5,0,95
Gabriel Gonzaga,2006-12-30,Carmelo Marrero,Submission,90,3,0,93
Gabriel Gonzaga,2003-09-13,Fabricio Werdum,KO/TKO,0,0,0,0
Gabriel Gonzaga,2012-01-14,Ednaldo Oliveira,Submission,90,2,0,92
Gabriel Gonzaga,2009-03-07,Shane Carwin,KO/TKO,0,1,0,1
Takeya Mizugaki,2014-05-24,Francisco Rivera,Decision - Unanimous,80,0,0,80
Takeya Mizugaki,2011-09-24,Cole Escovedo,KO/TKO,100,41,0,141
Takeya Mizugaki,2012-11-10,Jeff Hougland,Decision - Unanimous,80,49,0,129
Takeya Mizugaki,2015-09-26,George Roop,Decision - Unanimous,80,23,0,103
Takeya Mizugaki,2016-08-20,Cody Garbrandt,KO/TKO,0,0,0,0
Takeya Mizugaki,2011-03-03,Reuben Duran,Decision - Split,70,0,0,70
Takeya Mizugaki,2010-11-11,Urijah Faber,Submission,0,0,0,0
Takeya Mizugaki,2016-12-17,Eddie Wineland,KO/TKO,0,4,0,4
Takeya Mizugaki,2009-08-09,Jeff Curran,Decision - Split,70,0,0,70
Takeya Mizugaki,2013-12-06,Nam Phan,Decision - Unanimous,80,52,0,132
Takeya Mizugaki,2011-07-02,Brian Bowles,Decision - Unanimous,0,0,0,0
Takeya Mizugaki,2013-03-02,Bryan Caraway,Decision - Split,70,30,0,100
Takeya Mizugaki,2010-04-24,Rani Yahya,Decision - Unanimous,80,23,0,103
Takeya Mizugaki,2014-09-27,Dominick Cruz,KO/TKO,0,0,0,0
Takeya Mizugaki,2009-04-05,Miguel Torres,Decision - Unanimous,0,0,25,25
Takeya Mizugaki,2013-08-28,Erik Perez,Decision - Split,70,2,0,72
Takeya Mizugaki,2012-02-25,Chris Cariaso,Decision - Unanimous,0,0,0,0
Takeya Mizugaki,2015-04-18,Aljamain Sterling,Submission,0,0,0,0
Takeya Mizugaki,2009-12-19,Scott Jorgensen,Decision - Unanimous,0,0,0,0
Francisco Rivera,2014-05-24,Takeya Mizugaki,Decision - Unanimous,0,6,0,6
Francisco Rivera,2013-11-06,George Roop,KO/TKO,100,4,0,104
Francisco Rivera,2015-06-06,Alex Caceres,KO/TKO,100,5,0,105
Francisco Rivera,2014-12-06,Urijah Faber,Submission,0,0,0,0
Francisco Rivera,2012-05-15,Alex Soto,Decision - Unanimous,80,27,0,107
Francisco Rivera,2010-11-11,Erik Koch,KO/TKO,0,0,0,0
Francisco Rivera,2016-02-27,Brad Pickett,Decision - Split,0,30,0,30
Francisco Rivera,2015-09-05,John Lineker,Submission,0,0,0,0
Francisco Rivera,2013-02-02,Edwin Figueroa,KO/TKO,100,27,0,127
Francisco Rivera,2016-07-30,Erik Perez,Decision - Unanimous,0,1,0,1
Francisco Rivera,2011-06-04,Reuben Duran,Submission,0,0,0,0
Jeka Saragih,2022-06-09,Pawan Maan,KO/TKO,100,26,0,126
Jeka Saragih,2023-11-18,Lucas Alexander,KO/TKO,100,0,0,100
Jeka Saragih,2024-06-15,Westin Wilson,Submission,0,4,0,4
Jeka Saragih,2023-02-04,Anshul Jubli,KO/TKO,0,0,0,0
Jeka Saragih,2022-10-23,WonBin Ki,KO/TKO,100,3,0,103
Pawan Maan,2022-06-09,Jeka Saragih,KO/TKO,0,0,0,0
Cory Hendricks,2016-07-08,Josh Stansbury,Decision - Majority,0,0,0,0
Gregory Rodrigues,2023-08-19,Denis Tiuliulin,KO/TKO,100,3,0,103
Gregory Rodrigues,2024-07-27,Christian Leroy Duncan,Decision - Unanimous,80,16,0,96
Gregory Rodrigues,2024-02-10,Brad Tavares,KO/TKO,100,34,0,134
Gregory Rodrigues,2022-09-17,Chidi Njokuani,KO/TKO,100,4,0,104
Gregory Rodrigues,2021-06-05,Dusko Todorovic,Decision - Unanimous,80,34,0,114
Gregory Rodrigues,2021-10-23,JunYong Park,KO/TKO,100,12,0,112
Gregory Rodrigues,2022-02-26,Armen Petrosyan,Decision - Split,0,0,0,0
Gregory Rodrigues,2023-01-21,Brunno Ferreira,KO/TKO,0,0,0,0
Gregory Rodrigues,2022-06-18,Julian Marquez,KO/TKO,100,36,0,136
Gregory Rodrigues,2020-09-15,Jordan Williams,KO/TKO,0,0,0,0
Denis Tiuliulin,2023-08-19,Gregory Rodrigues,KO/TKO,0,0,0,0
Denis Tiuliulin,2024-08-03,Sedriques Dumas,Decision - Unanimous,0,0,0,0
Denis Tiuliulin,2023-02-04,JunYong Park,Submission,0,0,0,0
Denis Tiuliulin,2022-09-10,Jamie Pickett,KO/TKO,100,13,0,113
Denis Tiuliulin,2022-03-26,Aliaskhab Khizriev,Submission,0,0,0,0
Denis Tiuliulin,2023-11-18,Christian Leroy Duncan,KO/TKO,0,0,0,0
Lina Lansberg,2019-06-01,Tonya Evinger,Decision - Unanimous,80,44,0,124
Lina Lansberg,2017-10-21,Aspen Ladd,KO/TKO,0,15,0,15
Lina Lansberg,2023-02-18,Mayra Bueno Silva,Submission,0,0,0,0
Lina Lansberg,2022-04-16,Pannie Kianzad,Decision - Unanimous,0,0,0,0
Lina Lansberg,2018-05-27,Gina Mazany,Decision - Unanimous,80,2,0,82
Lina Lansberg,2020-01-25,Sara McMann,Decision - Unanimous,0,0,0,0
Lina Lansberg,2016-09-24,Cristiane Justino,KO/TKO,0,0,25,25
Lina Lansberg,2022-10-22,Karol Rosa,Decision - Majority,0,0,0,0
Lina Lansberg,2018-10-06,Yana Santos,Decision - Unanimous,0,0,0,0
Lina Lansberg,2017-03-18,Lucie Pudilova,Decision - Unanimous,80,0,0,80
Lina Lansberg,2019-09-28,Macy Chiasson,Decision - Unanimous,80,0,0,80
Tonya Evinger,2019-06-01,Lina Lansberg,Decision - Unanimous,0,0,0,0
Tonya Evinger,2018-10-06,Aspen Ladd,KO/TKO,0,0,0,0
Tonya Evinger,2017-07-29,Cristiane Justino,KO/TKO,0,0,25,25
Tonya Evinger,2007-09-15,Gina Carano,Submission,0,0,0,0
Tonya Evinger,2011-07-29,Sara McMann,Decision - Unanimous,0,0,0,0
Timothy Johnson,2017-03-18,Daniel Omielanczuk,Decision - Split,70,0,0,70
Timothy Johnson,2015-04-04,Shamil Abdurakhimov,KO/TKO,100,13,0,113
Timothy Johnson,2016-04-10,Marcin Tybura,Decision - Unanimous,80,0,0,80
Timothy Johnson,2017-07-22,Junior Albini,KO/TKO,0,0,0,0
Timothy Johnson,2015-08-08,Jared Rosholt,Decision - Unanimous,0,7,0,7
Timothy Johnson,2016-11-19,Alexander Volkov,Decision - Split,0,0,0,0
Timothy Johnson,2018-02-03,Marcelo Golm,Decision - Unanimous,80,18,0,98
Daniel Omielanczuk,2017-03-18,Timothy Johnson,Decision - Split,0,2,0,2
Daniel Omielanczuk,2014-04-11,Jared Rosholt,Decision - Unanimous,0,0,0,0
Daniel Omielanczuk,2017-07-08,Curtis Blaydes,Decision - Unanimous,0,0,0,0
Daniel Omielanczuk,2013-09-21,Nandor Guelmino,KO/TKO,100,0,0,100
Daniel Omielanczuk,2016-02-27,Jarjis Danho,Decision - Majority,75,39,0,114
Daniel Omielanczuk,2015-04-11,Anthony Hamilton,Decision - Unanimous,0,0,0,0
Daniel Omielanczuk,2015-07-18,Chris de la Rocha,KO/TKO,100,14,0,114
Daniel Omielanczuk,2016-10-08,Stefan Struve,Submission,0,5,0,5
Daniel Omielanczuk,2016-07-13,Aleksei Oleinik,Decision - Majority,75,18,0,93
Andre Ewell,2021-02-13,Chris Gutierrez,Decision - Unanimous,0,0,0,0
Andre Ewell,2018-09-22,Renan Barao,Decision - Split,70,9,0,79
Andre Ewell,2021-07-24,Julio Arce,KO/TKO,0,0,0,0
Andre Ewell,2021-12-18,Charles Jourdain,Decision - Unanimous,0,0,0,0
Andre Ewell,2019-06-22,Anderson Dos Santos,Decision - Unanimous,80,38,0,118
Andre Ewell,2019-10-12,Marlon Vera,KO/TKO,0,0,0,0
Andre Ewell,2018-12-29,Nathaniel Wood,Submission,0,0,0,0
Andre Ewell,2020-09-19,Irwin Rivera,Decision - Split,70,42,0,112
Andre Ewell,2020-02-08,Jonathan Martinez,Decision - Split,70,14,0,84
Steve Vigneault,2006-03-04,Mike Swick,Submission,0,0,0,0
Steve Vigneault,2003-11-29,Patrick Cote,KO/TKO,0,0,0,0
Christina Marks,2017-12-01,Montana De La Rosa,Submission,0,4,0,4
Tatsuya Kawajiri,2008-05-11,Luiz Firmino,Decision - Unanimous,80,25,0,105
Tatsuya Kawajiri,2011-09-24,Joachim Hansen,Submission,90,0,0,90
Tatsuya Kawajiri,2011-12-31,Kazuyuki Miyata,Submission,90,2,0,92
Tatsuya Kawajiri,2015-12-11,Jason Knight,Decision - Unanimous,80,0,0,80
Tatsuya Kawajiri,2005-05-22,Kim In Seok,KO/TKO,100,15,0,115
Tatsuya Kawajiri,2015-06-20,Dennis Siver,Decision - Unanimous,80,0,0,80
Tatsuya Kawajiri,2009-03-08,Ross Ebanez,Submission,90,0,0,90
Tatsuya Kawajiri,2006-12-31,Gilbert Melendez,Decision - Unanimous,0,0,0,0
Tatsuya Kawajiri,2005-07-17,Luiz Firmino,Decision - Unanimous,80,8,0,88
Tatsuya Kawajiri,2014-04-11,Clay Guida,Decision - Unanimous,0,0,0,0
Tatsuya Kawajiri,2007-12-31,Luiz Azeredo,Decision - Unanimous,80,56,0,136
Tatsuya Kawajiri,2006-08-27,Chris Brennan,KO/TKO,100,7,0,107
Tatsuya Kawajiri,2011-04-09,Gilbert Melendez,KO/TKO,0,0,25,25
Tatsuya Kawajiri,2005-09-25,Takanori Gomi,Submission,0,0,0,0
Tatsuya Kawajiri,2006-06-04,Charles Bennett,Submission,90,0,0,90
Tatsuya Kawajiri,2009-12-31,Kazunori Yokota,Decision - Unanimous,80,7,0,87
Tatsuya Kawajiri,2010-07-10,Shinya Aoki,Submission,0,2,0,2
Tatsuya Kawajiri,2016-08-06,Cub Swanson,Decision - Unanimous,0,0,0,0
Tatsuya Kawajiri,2010-12-31,Josh Thomson,Decision - Unanimous,80,4,0,84
Tatsuya Kawajiri,2012-03-31,Donald Sanchez,Submission,90,2,0,92
Tatsuya Kawajiri,2009-10-06,Melchor Manibusan,KO/TKO,100,16,0,116
Tatsuya Kawajiri,2008-07-21,Eddie Alvarez,KO/TKO,0,0,0,0
Tatsuya Kawajiri,2016-02-21,Dennis Bermudez,Decision - Unanimous,0,0,0,0
Tatsuya Kawajiri,2012-12-31,Michihiro Omigawa,Decision - Unanimous,80,13,0,93
Tatsuya Kawajiri,2008-03-15,Kultar Gill,Decision - Unanimous,80,0,0,80
Tatsuya Kawajiri,2011-07-16,Drew Fickett,KO/TKO,100,13,0,113
Tatsuya Kawajiri,2009-05-26,Gesias Cavalcante,Decision - Unanimous,80,36,0,116
Tatsuya Kawajiri,2014-01-04,Sean Soriano,Submission,90,13,0,103
Luiz Firmino,2008-05-11,Tatsuya Kawajiri,Decision - Unanimous,0,0,0,0
Luiz Firmino,2005-04-03,Luiz Azeredo,Decision - Split,0,0,0,0
Luiz Firmino,2005-07-17,Tatsuya Kawajiri,Decision - Unanimous,0,0,0,0
Luiz Firmino,2008-03-15,Kazuyuki Miyata,Submission,90,8,0,98
Luiz Firmino,2004-10-14,Masakazu Imanari,Decision - Unanimous,80,14,0,94
Luiz Firmino,2004-07-19,Hiroyuki Abe,Submission,90,7,0,97
Luiz Firmino,2006-11-05,Nobuhiro Obiya,Decision - Unanimous,80,12,0,92
Scott Holtzman,2019-02-17,Nik Lentz,Decision - Unanimous,0,0,0,0
Scott Holtzman,2020-02-15,Jim Miller,Decision - Unanimous,80,30,0,110
Scott Holtzman,2020-08-08,Beneil Dariush,KO/TKO,0,0,0,0
Scott Holtzman,2017-04-22,Michael McBride,Decision - Unanimous,80,21,0,101
Scott Holtzman,2018-10-06,Alan Patrick,KO/TKO,100,48,0,148
Scott Holtzman,2016-01-02,Drew Dober,Decision - Unanimous,0,2,0,2
Scott Holtzman,2021-04-10,Mateusz Gamrot,KO/TKO,0,0,0,0
Scott Holtzman,2022-12-03,Clay Guida,Decision - Split,0,0,0,0
Scott Holtzman,2016-12-17,Josh Emmett,Decision - Unanimous,0,0,0,0
Scott Holtzman,2017-12-09,Darrell Horcher,Decision - Unanimous,80,13,0,93
Scott Holtzman,2016-07-13,Cody Pfister,Decision - Unanimous,80,25,0,105
Scott Holtzman,2015-08-08,Anthony Christodoulou,Submission,90,40,0,130
Scott Holtzman,2019-08-03,Dong Hyun Ma,TKO - Doctor's Stoppage,0,28,0,28
TJ Dillashaw,2015-07-25,Renan Barao,KO/TKO,100,55,25,180
TJ Dillashaw,2014-05-24,Renan Barao,KO/TKO,100,76,25,201
TJ Dillashaw,2014-08-30,Joe Soto,KO/TKO,100,89,25,214
TJ Dillashaw,2018-08-04,Cody Garbrandt,KO/TKO,100,28,25,153
TJ Dillashaw,2016-01-17,Dominick Cruz,Decision - Split,0,0,25,25
TJ Dillashaw,2016-07-09,Raphael Assuncao,Decision - Unanimous,80,15,0,95
TJ Dillashaw,2017-11-04,Cody Garbrandt,KO/TKO,100,2,25,127
TJ Dillashaw,2013-04-20,Hugo Viana,KO/TKO,100,10,0,110
TJ Dillashaw,2013-03-16,Issei Tamura,KO/TKO,100,19,0,119
TJ Dillashaw,2013-10-09,Raphael Assuncao,Decision - Split,0,0,0,0
TJ Dillashaw,2011-12-03,John Dodson,KO/TKO,0,0,0,0
TJ Dillashaw,2019-01-19,Henry Cejudo,KO/TKO,0,0,25,25
TJ Dillashaw,2016-12-30,John Lineker,Decision - Unanimous,80,33,0,113
TJ Dillashaw,2012-07-11,Vaughan Lee,Submission,90,0,0,90
TJ Dillashaw,2012-02-15,Walel Watson,Decision - Unanimous,80,74,0,154
TJ Dillashaw,2014-01-15,Mike Easton,Decision - Unanimous,80,71,0,151
TJ Dillashaw,2021-07-24,Cory Sandhagen,Decision - Split,70,0,25,95
TJ Dillashaw,2022-10-22,Aljamain Sterling,KO/TKO,0,0,25,25
Renan Barao,2015-07-25,TJ Dillashaw,KO/TKO,0,0,25,25
Renan Barao,2018-09-22,Andre Ewell,Decision - Split,0,0,0,0
Renan Barao,2014-05-24,TJ Dillashaw,KO/TKO,0,0,25,25
Renan Barao,2018-02-24,Brian Kelleher,Decision - Unanimous,0,22,0,22
Renan Barao,2016-05-29,Jeremy Stephens,Decision - Unanimous,0,0,0,0
Renan Barao,2017-07-29,Aljamain Sterling,Decision - Unanimous,0,0,0,0
Renan Barao,2019-11-16,Douglas Silva de Andrade,Decision - Unanimous,0,0,0,0
Renan Barao,2019-02-17,Luke Sanders,KO/TKO,0,1,0,1
Renan Barao,2012-02-04,Scott Jorgensen,Decision - Unanimous,80,31,0,111
Renan Barao,2014-12-20,Mitch Gagnon,Submission,90,1,0,91
Renan Barao,2012-07-21,Urijah Faber,Decision - Unanimous,80,25,25,130
Renan Barao,2016-09-24,Phillipe Nover,Decision - Unanimous,80,25,0,105
Renan Barao,2011-05-28,Cole Escovedo,Decision - Unanimous,80,17,0,97
Renan Barao,2014-02-01,Urijah Faber,KO/TKO,100,9,25,134
Renan Barao,2013-02-16,Michael McDonald,Submission,90,10,25,125
Renan Barao,2011-11-05,Brad Pickett,Submission,90,27,0,117
Renan Barao,2010-06-20,Anthony Leone,Submission,90,6,0,96
Renan Barao,2013-09-21,Eddie Wineland,KO/TKO,100,17,25,142
Renan Barao,2010-12-16,Chris Cariaso,Submission,90,0,0,90
Lyoto Machida,2014-07-05,Chris Weidman,Decision - Unanimous,0,0,25,25
Lyoto Machida,2006-04-29,Dimitiri Wanderley,KO/TKO,100,44,0,144
Lyoto Machida,2006-07-22,Vernon White,Decision - Unanimous,80,12,0,92
Lyoto Machida,2011-04-30,Randy Couture,KO/TKO,100,10,0,110
Lyoto Machida,2013-02-23,Dan Henderson,Decision - Split,70,7,0,77
Lyoto Machida,2009-10-24,Mauricio Rua,Decision - Unanimous,80,0,25,105
Lyoto Machida,2008-05-24,Tito Ortiz,Decision - Unanimous,80,25,0,105
Lyoto Machida,2003-05-02,Kengo Watanabe,Decision - Unanimous,80,42,0,122
Lyoto Machida,2014-12-20,CB Dollaway,KO/TKO,100,12,25,137
Lyoto Machida,2014-02-15,Gegard Mousasi,Decision - Unanimous,80,0,25,105
Lyoto Machida,2004-03-14,Michael McDonald,Submission,90,1,0,91
Lyoto Machida,2003-09-13,Stephan Bonnar,TKO - Doctor's Stoppage,0,9,0,9
Lyoto Machida,2013-08-03,Phil Davis,Decision - Unanimous,0,6,0,6
Lyoto Machida,2012-08-04,Ryan Bader,KO/TKO,100,14,0,114
Lyoto Machida,2007-09-22,Kazuhiro Nakamura,Decision - Unanimous,80,55,0,135
Lyoto Machida,2005-03-26,BJ Penn,Decision - Unanimous,80,21,0,101
Lyoto Machida,2007-04-21,David Heath,Decision - Unanimous,80,59,0,139
Lyoto Machida,2011-12-10,Jon Jones,Submission,0,0,25,25
Lyoto Machida,2007-02-03,Sam Hoger,Decision - Unanimous,80,51,0,131
Lyoto Machida,2018-05-12,Vitor Belfort,KO/TKO,100,9,0,109
Lyoto Machida,2004-05-22,Sam Greco,Decision - Split,70,0,0,70
Lyoto Machida,2015-04-18,Luke Rockhold,Submission,0,0,25,25
Lyoto Machida,2003-12-31,Rich Franklin,KO/TKO,100,15,0,115
Lyoto Machida,2013-10-26,Mark Munoz,KO/TKO,100,5,25,130
Lyoto Machida,2010-11-20,Quinton Jackson,Decision - Split,0,17,0,17
Lyoto Machida,2015-06-27,Yoel Romero,KO/TKO,0,0,25,25
Lyoto Machida,2018-02-03,Eryk Anders,Decision - Split,70,30,25,125
Lyoto Machida,2009-01-31,Thiago Silva,KO/TKO,100,22,0,122
Lyoto Machida,2017-10-28,Derek Brunson,KO/TKO,0,0,25,25
Lyoto Machida,2007-12-29,Rameau Thierry Sokoudjou,Submission,90,15,0,105
Lyoto Machida,2010-05-08,Mauricio Rua,KO/TKO,0,0,25,25
Lyoto Machida,2009-05-23,Rashad Evans,KO/TKO,100,24,25,149
Murilo Rua,2003-12-31,Akira Shoji,KO/TKO,100,9,0,109
Murilo Rua,2005-10-23,Murad Chunkaiev,Submission,90,9,0,99
Murilo Rua,2002-04-28,Mario Sperry,Decision - Unanimous,80,27,0,107
Murilo Rua,2006-04-02,Paulo Filho,Decision - Unanimous,0,0,0,0
Murilo Rua,2001-12-23,Alex Andrade,Decision - Unanimous,80,48,0,128
Murilo Rua,2009-04-05,Riki Fukuda,Decision - Unanimous,0,12,0,12
Murilo Rua,2002-12-23,Kevin Randleman,TKO - Doctor's Stoppage,0,0,0,0
Murilo Rua,2005-02-20,Quinton Jackson,Decision - Split,0,0,0,0
Murilo Rua,2001-11-03,Dan Henderson,Decision - Split,0,22,0,22
Murilo Rua,2006-06-04,Denis Kang,KO/TKO,0,0,0,0
Murilo Rua,2004-04-25,Sergei Kharitonov,KO/TKO,0,0,0,0
Murilo Rua,2002-11-24,Ricardo Arona,Decision - Unanimous,0,0,0,0
Murilo Rua,2008-10-04,Benji Radach,KO/TKO,0,0,0,0
Murilo Rua,2007-09-15,Robbie Lawler,KO/TKO,0,0,25,25
Murilo Rua,2004-02-01,Alexander Otsuka,Submission,90,12,0,102
Murilo Rua,2001-09-24,Daijiro Matsui,KO/TKO,100,31,0,131
Murilo Rua,2008-06-14,Tony Bonello,KO/TKO,100,39,0,139
Murilo Rua,2007-06-22,Joey Villasenor,KO/TKO,100,4,25,129
Akira Shoji,2003-12-31,Murilo Rua,KO/TKO,0,0,0,0
Akira Shoji,2004-07-19,Paulo Filho,Decision - Split,0,0,0,0
Akira Shoji,2000-06-04,John Renken,Submission,90,6,0,96
Akira Shoji,2004-05-23,Tsuyoshi Tamakairiki,KO/TKO,100,8,0,108
Akira Shoji,2005-04-03,Dean Lister,Submission,0,0,0,0
Akira Shoji,2000-01-30,Ebenezer Fontes Braga,Decision - Unanimous,80,0,0,80
Akira Shoji,2003-10-05,Mauricio Rua,KO/TKO,0,0,0,0
Akira Shoji,2000-10-31,Herman Renting,Submission,90,2,0,92
Akira Shoji,1998-10-11,Wallid Ismail,KO/TKO,100,9,0,109
Akira Shoji,1998-03-05,Juan Mott,Submission,90,7,0,97
Akira Shoji,2001-05-27,Dan Henderson,KO/TKO,0,0,0,0
Akira Shoji,2000-12-09,Ricardo Almeida,Decision - Unanimous,0,0,0,0
Akira Shoji,2002-09-29,Paulo Filho,Submission,0,0,0,0
Akira Shoji,2007-04-08,Gilbert Yvel,KO/TKO,0,0,0,0
Akira Shoji,1999-09-12,Larry Parker,Decision - Unanimous,80,14,0,94
Akira Shoji,1999-04-29,Igor Vovchanchyn,Decision - Unanimous,0,0,0,0
Akira Shoji,2001-12-23,Jeremy Horn,Decision - Unanimous,0,0,0,0
Akira Shoji,1999-07-04,Guy Mezger,Decision - Split,70,0,0,70
Akira Shoji,2003-03-16,Alex Stiebling,Decision - Split,70,0,0,70
Akira Shoji,2001-09-24,Semmy Schilt,KO/TKO,0,0,0,0
Akira Shoji,2000-05-01,Mark Coleman,Decision - Unanimous,0,0,0,0
Davi Ramos,2017-12-09,Chris Gruetzemacher,Submission,90,9,0,99
Davi Ramos,2017-03-11,Sergio Moraes,Decision - Unanimous,0,0,0,0
Davi Ramos,2020-07-18,Arman Tsarukyan,Decision - Unanimous,0,0,0,0
Davi Ramos,2018-11-10,John Gunther,Submission,90,3,0,93
Davi Ramos,2019-09-07,Islam Makhachev,Decision - Unanimous,0,0,0,0
Davi Ramos,2019-05-18,Austin Hubbard,Decision - Unanimous,80,19,0,99
Davi Ramos,2018-05-12,Nick Hein,Submission,90,5,0,95
Chris Gruetzemacher,2017-12-09,Davi Ramos,Submission,0,0,0,0
Chris Gruetzemacher,2021-12-04,Claudio Puelles,Submission,0,0,0,0
Chris Gruetzemacher,2018-04-07,Joe Lauzon,KO/TKO,100,80,0,180
Chris Gruetzemacher,2015-12-11,Abner Lloveras,Decision - Unanimous,80,9,0,89
Chris Gruetzemacher,2020-10-31,Alexander Hernandez,KO/TKO,0,0,0,0
Chris Gruetzemacher,2017-02-04,Chas Skelly,Submission,0,7,0,7
Chris Gruetzemacher,2021-07-31,Rafa Garcia,Decision - Unanimous,80,28,0,108
Serhiy Sidey,2024-11-02,Garrett Armfield,Decision - Split,70,0,0,70
Serhiy Sidey,2024-01-20,Ramon Taveras,Decision - Split,0,17,0,17
Serhiy Sidey,2023-09-05,Ramon Taveras,KO/TKO,100,0,0,100
Kyung Ho Kang,2019-12-21,Pingyuan Liu,Decision - Split,70,0,0,70
Kyung Ho Kang,2019-02-09,Teruto Ishihara,Submission,90,9,0,99
Kyung Ho Kang,2014-09-20,Michinori Tanaka,Decision - Split,70,0,0,70
Kyung Ho Kang,2024-06-22,Muin Gafurov,Decision - Unanimous,0,0,0,0
Kyung Ho Kang,2023-06-17,Cristian Quinonez,Submission,90,9,0,99
Kyung Ho Kang,2013-08-31,Chico Camus,Decision - Unanimous,0,0,0,0
Kyung Ho Kang,2018-08-04,Ricardo Ramos,Decision - Split,0,11,0,11
Kyung Ho Kang,2023-11-11,John Castaneda,Decision - Unanimous,0,0,0,0
Kyung Ho Kang,2019-08-17,Brandon Davis,Decision - Split,70,0,0,70
Kyung Ho Kang,2014-01-04,Shunichi Shimizu,Submission,90,63,0,153
Kyung Ho Kang,2021-11-20,Rani Yahya,Decision - Unanimous,0,16,0,16
Kyung Ho Kang,2018-01-14,Guido Cannetti,Submission,90,0,0,90
Kyung Ho Kang,2022-06-11,Batgerel Danaa,Decision - Unanimous,80,0,0,80
Pingyuan Liu,2019-12-21,Kyung Ho Kang,Decision - Split,0,5,0,5
Pingyuan Liu,2019-07-13,Jonathan Martinez,KO/TKO,0,0,0,0
Pingyuan Liu,2018-11-24,Martin Day,Decision - Split,70,0,0,70
Pingyuan Liu,2018-07-22,Damian Stasiak,Decision - Unanimous,80,8,0,88
Katsunori Kikuno,2010-03-22,Kuniyoshi Hironaka,KO/TKO,100,6,0,106
Katsunori Kikuno,2009-07-20,Andre Amado,KO/TKO,100,20,0,120
Katsunori Kikuno,2014-01-04,Quinn Mulhern,Decision - Unanimous,80,7,0,87
Katsunori Kikuno,2010-07-10,Gesias Cavalcante,Decision - Split,0,8,0,8
Katsunori Kikuno,2014-09-20,Sam Sicilia,Submission,90,0,0,90
Katsunori Kikuno,2015-03-21,Edimilson Souza,KO/TKO,0,0,0,0
Katsunori Kikuno,2009-10-25,Eddie Alvarez,Submission,0,0,0,0
Katsunori Kikuno,2015-09-26,Diego Brandao,KO/TKO,0,0,0,0
Katsunori Kikuno,2011-05-29,Daisuke Nakamura,Decision - Unanimous,80,14,0,94
Katsunori Kikuno,2014-05-24,Tony Ferguson,KO/TKO,0,0,0,0
Kuniyoshi Hironaka,2010-03-22,Katsunori Kikuno,KO/TKO,0,0,0,0
Kuniyoshi Hironaka,2005-11-06,Shinya Aoki,TKO - Doctor's Stoppage,0,0,0,0
Kuniyoshi Hironaka,2007-09-19,Thiago Alves,KO/TKO,0,0,0,0
Kuniyoshi Hironaka,2008-04-19,Jonathan Goulet,KO/TKO,0,0,0,0
Kuniyoshi Hironaka,2008-07-21,Motoki Miyazawa,TKO - Doctor's Stoppage,0,24,0,24
Kuniyoshi Hironaka,2007-04-05,Forrest Petz,Decision - Unanimous,80,19,0,99
Kuniyoshi Hironaka,2008-09-23,Hayato Sakurai,Decision - Unanimous,0,0,0,0
Kuniyoshi Hironaka,2009-10-25,Won Sik Park,KO/TKO,100,0,0,100
Kuniyoshi Hironaka,2006-10-14,Jon Fitch,Decision - Unanimous,0,0,0,0
Randy Couture,2010-02-06,Mark Coleman,Submission,90,34,0,124
Randy Couture,2011-04-30,Lyoto Machida,KO/TKO,0,0,0,0
Randy Couture,2002-09-27,Ricco Rodriguez,KO/TKO,0,0,25,25
Randy Couture,2003-06-06,Chuck Liddell,KO/TKO,100,24,25,149
Randy Couture,2010-08-28,James Toney,Submission,90,8,0,98
Randy Couture,2001-11-02,Pedro Rizzo,KO/TKO,100,28,25,153
Randy Couture,1997-10-17,Vitor Belfort,KO/TKO,100,28,0,128
Randy Couture,2004-01-31,Vitor Belfort,TKO - Doctor's Stoppage,0,0,25,25
Randy Couture,2004-08-21,Vitor Belfort,TKO - Doctor's Stoppage,0,47,25,72
Randy Couture,2009-11-14,Brandon Vera,Decision - Unanimous,80,12,0,92
Randy Couture,1997-05-30,Tony Halme,Submission,90,1,0,91
Randy Couture,2008-11-15,Brock Lesnar,KO/TKO,0,0,25,25
Randy Couture,1997-12-21,Maurice Smith,Decision - Majority,75,10,0,85
Randy Couture,2007-03-03,Tim Sylvia,Decision - Unanimous,80,48,25,153
Randy Couture,2001-05-04,Pedro Rizzo,Decision - Unanimous,80,27,25,132
Randy Couture,2003-09-26,Tito Ortiz,Decision - Unanimous,80,72,25,177
Randy Couture,1997-05-30,Steven Graham,KO/TKO,100,16,0,116
Randy Couture,2002-03-22,Josh Barnett,KO/TKO,0,0,25,25
Randy Couture,1998-10-25,Enson Inoue,Submission,0,0,0,0
Randy Couture,2007-08-25,Gabriel Gonzaga,KO/TKO,100,52,25,177
Randy Couture,2005-04-16,Chuck Liddell,KO/TKO,0,0,25,25
Randy Couture,2009-08-29,Antonio Rodrigo Nogueira,Decision - Unanimous,0,15,0,15
Randy Couture,2000-11-17,Kevin Randleman,KO/TKO,100,13,25,138
Randy Couture,2006-02-04,Chuck Liddell,KO/TKO,0,0,25,25
Randy Couture,2005-08-20,Mike van Arsdale,Submission,90,19,0,109
Irina Alekseeva,2023-04-29,Stephanie Egger,Submission,90,9,0,99
Irina Alekseeva,2023-10-14,Melissa Mullins,Decision - Unanimous,0,0,0,0
Stephanie Egger,2023-04-29,Irina Alekseeva,Submission,0,0,0,0
Stephanie Egger,2022-02-19,Jessica-Rose Clark,Submission,90,3,0,93
Stephanie Egger,2022-09-03,Ailin Perez,Submission,90,0,0,90
Stephanie Egger,2021-10-02,Shanna Young,KO/TKO,100,7,0,107
Stephanie Egger,2022-08-06,Mayra Bueno Silva,Submission,0,4,0,4
Stephanie Egger,2020-10-10,Tracy Cortez,Decision - Unanimous,0,0,0,0
Stephanie Egger,2023-12-09,Luana Santos,Decision - Unanimous,0,0,0,0
Dustin Poirier,2015-06-06,Yancy Medeiros,KO/TKO,100,21,0,121
Dustin Poirier,2020-06-27,Dan Hooker,Decision - Unanimous,80,0,25,105
Dustin Poirier,2012-12-15,Jonathan Brookins,Submission,90,9,0,99
Dustin Poirier,2016-06-04,Bobby Green,KO/TKO,100,20,0,120
Dustin Poirier,2011-11-12,Pablo Garza,Submission,90,3,0,93
Dustin Poirier,2023-07-29,Justin Gaethje,KO/TKO,0,0,25,25
Dustin Poirier,2018-04-14,Justin Gaethje,KO/TKO,100,59,25,184
Dustin Poirier,2010-08-18,Danny Castillo,Decision - Unanimous,0,0,0,0
Dustin Poirier,2018-07-28,Eddie Alvarez,KO/TKO,100,28,25,153
Dustin Poirier,2017-11-11,Anthony Pettis,KO/TKO,100,19,25,144
Dustin Poirier,2011-06-11,Jason Young,Decision - Unanimous,80,20,0,100
Dustin Poirier,2021-12-11,Charles Oliveira,Submission,0,0,25,25
Dustin Poirier,2011-01-01,Josh Grispi,Decision - Unanimous,80,61,0,141
Dustin Poirier,2013-08-31,Erik Koch,Decision - Unanimous,80,22,0,102
Dustin Poirier,2012-05-15,Chan Sung Jung,Submission,0,0,25,25
Dustin Poirier,2017-02-11,Jim Miller,Decision - Majority,75,26,0,101
Dustin Poirier,2019-04-13,Max Holloway,Decision - Unanimous,80,0,25,105
Dustin Poirier,2021-07-10,Conor McGregor,TKO - Doctor's Stoppage,0,9,25,34
Dustin Poirier,2024-03-09,Benoit Saint Denis,KO/TKO,100,0,25,125
Dustin Poirier,2014-09-27,Conor McGregor,KO/TKO,0,1,0,1
Dustin Poirier,2016-09-17,Michael Johnson,KO/TKO,0,0,25,25
Dustin Poirier,2013-12-28,Diego Brandao,KO/TKO,100,28,0,128
Dustin Poirier,2010-11-11,Zachary Micklewright,KO/TKO,100,32,0,132
Dustin Poirier,2016-01-02,Joe Duffy,Decision - Unanimous,80,35,0,115
Dustin Poirier,2022-11-12,Michael Chandler,Submission,90,0,0,90
Dustin Poirier,2013-02-16,Cub Swanson,Decision - Unanimous,0,0,0,0
Dustin Poirier,2014-04-16,Akira Corassani,KO/TKO,100,21,0,121
Dustin Poirier,2021-01-23,Conor McGregor,KO/TKO,100,19,25,144
Dustin Poirier,2024-06-01,Islam Makhachev,Submission,0,0,25,25
Dustin Poirier,2015-04-04,Diego Ferreira,KO/TKO,100,4,0,104
Dustin Poirier,2012-02-04,Max Holloway,Submission,90,0,0,90
Dustin Poirier,2019-09-07,Khabib Nurmagomedov,Submission,0,0,25,25
Yancy Medeiros,2015-06-06,Dustin Poirier,KO/TKO,0,0,0,0
Yancy Medeiros,2020-02-15,Lando Vannata,Decision - Unanimous,0,0,0,0
Yancy Medeiros,2014-12-12,Joe Proctor,Submission,90,10,0,100
Yancy Medeiros,2018-02-18,Donald Cerrone,KO/TKO,0,0,25,25
Yancy Medeiros,2014-08-30,Damon Jackson,Submission,90,9,0,99
Yancy Medeiros,2017-06-03,Erick Silva,KO/TKO,100,4,0,104
Yancy Medeiros,2016-05-14,Francisco Trinaldo,Decision - Unanimous,0,0,0,0
Yancy Medeiros,2013-04-27,Rustam Khabilov,TKO - Doctor's Stoppage,0,1,0,1
Yancy Medeiros,2017-12-02,Alex Oliveira,KO/TKO,100,0,0,100
Yancy Medeiros,2014-04-26,Jim Miller,Submission,0,4,0,4
Yancy Medeiros,2021-06-26,Damir Hadzovic,Decision - Unanimous,0,0,0,0
Yancy Medeiros,2016-09-10,Sean Spencer,Submission,90,0,0,90
Yancy Medeiros,2015-12-12,John Makdessi,Decision - Split,70,0,0,70
Yancy Medeiros,2019-01-19,Gregor Gillespie,KO/TKO,0,0,0,0
Yancy Medeiros,2010-02-26,Raul Castillo,Decision - Unanimous,80,27,0,107
Abdul Razak Alhassan,2018-01-20,Sabah Homasi,KO/TKO,100,5,0,105
Abdul Razak Alhassan,2018-09-08,Niko Price,KO/TKO,100,11,0,111
Abdul Razak Alhassan,2023-10-07,Joe Pyfer,Submission,0,0,0,0
Abdul Razak Alhassan,2021-08-28,Alessio Di Chirico,KO/TKO,100,0,0,100
Abdul Razak Alhassan,2016-11-19,Charlie Ward,KO/TKO,100,10,0,110
Abdul Razak Alhassan,2021-04-17,Jacob Malkoun,Decision - Unanimous,0,0,0,0
Abdul Razak Alhassan,2017-05-28,Omari Akhmedov,Decision - Split,0,0,0,0
Abdul Razak Alhassan,2017-12-02,Sabah Homasi,KO/TKO,100,0,0,100
Abdul Razak Alhassan,2023-01-14,Claudio Ribeiro,KO/TKO,100,0,0,100
Abdul Razak Alhassan,2020-07-15,Mounir Lazzez,Decision - Unanimous,0,0,0,0
Abdul Razak Alhassan,2020-11-14,Khaos Williams,KO/TKO,0,0,0,0
Abdul Razak Alhassan,2022-02-19,Joaquin Buckley,Decision - Split,0,0,0,0
Sabah Homasi,2018-01-20,Abdul Razak Alhassan,KO/TKO,0,0,0,0
Sabah Homasi,2016-08-20,Tim Means,KO/TKO,0,0,0,0
Sabah Homasi,2017-12-02,Abdul Razak Alhassan,KO/TKO,0,12,0,12
Anthony Johnson,2011-10-01,Charlie Brenneman,KO/TKO,100,15,0,115
Anthony Johnson,2008-12-13,Kevin Burns,KO/TKO,100,18,0,118
Anthony Johnson,2015-01-24,Alexander Gustafsson,KO/TKO,100,20,25,145
Anthony Johnson,2017-04-08,Daniel Cormier,Submission,0,0,25,25
Anthony Johnson,2015-09-05,Jimi Manuwa,KO/TKO,100,17,0,117
Anthony Johnson,2016-08-20,Glover Teixeira,KO/TKO,100,3,0,103
Anthony Johnson,2014-04-26,Phil Davis,Decision - Unanimous,80,24,0,104
Anthony Johnson,2009-02-07,Luigi Fioravanti,KO/TKO,100,9,0,109
Anthony Johnson,2009-10-24,Yoshiyuki Yoshida,KO/TKO,100,10,0,110
Anthony Johnson,2007-06-12,Chad Reiner,KO/TKO,100,1,0,101
Anthony Johnson,2011-03-26,Dan Hardy,Decision - Unanimous,80,18,0,98
Anthony Johnson,2015-05-23,Daniel Cormier,Submission,0,0,25,25
Anthony Johnson,2008-07-19,Kevin Burns,KO/TKO,0,14,0,14
Anthony Johnson,2012-01-14,Vitor Belfort,Submission,0,0,0,0
Anthony Johnson,2016-01-30,Ryan Bader,KO/TKO,100,11,25,136
Anthony Johnson,2007-09-22,Rich Clementi,Submission,0,10,0,10
Anthony Johnson,2009-11-21,Josh Koscheck,Submission,0,0,0,0
Anthony Johnson,2008-04-02,Tommy Speer,KO/TKO,100,15,0,115
Anthony Johnson,2014-07-26,Rogerio Nogueira,KO/TKO,100,8,0,108
Charlie Brenneman,2011-10-01,Anthony Johnson,KO/TKO,0,0,0,0
Charlie Brenneman,2014-04-26,Danny Castillo,KO/TKO,0,0,0,0
Charlie Brenneman,2012-01-20,Daniel Roberts,Decision - Unanimous,80,21,0,101
Charlie Brenneman,2011-01-22,Amilcar Alves,Decision - Unanimous,80,16,0,96
Charlie Brenneman,2010-03-31,Jason High,Decision - Unanimous,80,21,0,101
Charlie Brenneman,2012-09-22,Kyle Noke,KO/TKO,0,0,0,0
Charlie Brenneman,2012-06-08,Erick Silva,Submission,0,0,0,0
Charlie Brenneman,2014-01-15,Beneil Dariush,Submission,0,0,0,0
Charlie Brenneman,2010-08-07,Johny Hendricks,KO/TKO,0,0,0,0
Charlie Brenneman,2014-11-08,Leandro Silva,Submission,0,0,0,0
Charlie Brenneman,2011-06-26,Rick Story,Decision - Unanimous,80,0,0,80
Demian Maia,2014-05-31,Alexander Yakovlev,Decision - Unanimous,80,7,0,87
Demian Maia,2016-08-27,Carlos Condit,Submission,90,0,25,115
Demian Maia,2010-12-04,Kendall Grove,Decision - Unanimous,80,24,0,104
Demian Maia,2019-02-02,Lyman Good,Submission,90,0,0,90
Demian Maia,2008-11-15,Nate Quarry,Submission,90,2,0,92
Demian Maia,2015-03-21,Ryan LaFlare,Decision - Unanimous,80,11,25,116
Demian Maia,2012-01-28,Chris Weidman,Decision - Unanimous,0,0,0,0
Demian Maia,2008-04-19,Ed Herman,Submission,90,0,0,90
Demian Maia,2013-10-09,Jake Shields,Decision - Split,0,0,25,25
Demian Maia,2009-02-21,Chael Sonnen,Submission,90,0,0,90
Demian Maia,2016-05-14,Matt Brown,Submission,90,7,0,97
Demian Maia,2015-12-12,Gunnar Nelson,Decision - Unanimous,80,45,0,125
Demian Maia,2010-02-06,Dan Miller,Decision - Unanimous,80,10,0,90
Demian Maia,2017-10-28,Colby Covington,Decision - Unanimous,0,0,0,0
Demian Maia,2017-05-13,Jorge Masvidal,Decision - Split,70,0,0,70
Demian Maia,2011-06-11,Mark Munoz,Decision - Unanimous,0,0,0,0
Demian Maia,2010-04-10,Anderson Silva,Decision - Unanimous,0,0,25,25
Demian Maia,2012-07-07,Dong Hyun Kim,KO/TKO,100,0,0,100
Demian Maia,2019-06-29,Anthony Rocco Martin,Decision - Majority,75,0,0,75
Demian Maia,2011-10-08,Jorge Santiago,Decision - Unanimous,80,6,0,86
Demian Maia,2020-03-14,Gilbert Burns,KO/TKO,0,0,0,0
Demian Maia,2007-10-20,Ryan Jensen,Submission,90,1,0,91
Demian Maia,2010-08-28,Mario Miranda,Decision - Unanimous,80,16,0,96
Demian Maia,2018-05-19,Kamaru Usman,Decision - Unanimous,0,0,25,25
Demian Maia,2021-06-12,Belal Muhammad,Decision - Unanimous,0,0,0,0
Demian Maia,2009-08-29,Nate Marquardt,KO/TKO,0,0,0,0
Demian Maia,2008-08-09,Jason MacDonald,Submission,90,23,0,113
Demian Maia,2017-07-29,Tyron Woodley,Decision - Unanimous,0,0,25,25
Demian Maia,2014-02-22,Rory MacDonald,Decision - Unanimous,0,0,0,0
Demian Maia,2019-10-26,Ben Askren,Submission,90,6,25,121
Demian Maia,2012-10-13,Rick Story,Submission,90,2,0,92
Demian Maia,2015-08-01,Neil Magny,Submission,90,13,0,103
Demian Maia,2013-02-02,Jon Fitch,Decision - Unanimous,80,6,0,86
Alexander Yakovlev,2014-05-31,Demian Maia,Decision - Unanimous,0,0,0,0
Alexander Yakovlev,2016-07-23,Kamaru Usman,Decision - Unanimous,0,0,0,0
Alexander Yakovlev,2019-04-20,Alex Da Silva,Submission,90,6,0,96
Alexander Yakovlev,2019-11-09,Roosevelt Roberts,Decision - Unanimous,0,0,0,0
Alexander Yakovlev,2015-04-04,Gray Maynard,Decision - Unanimous,80,10,0,90
Alexander Yakovlev,2016-01-30,George Sullivan,KO/TKO,100,1,0,101
Alexander Yakovlev,2014-10-04,Nicholas Musoke,Decision - Unanimous,0,0,0,0
Alexander Yakovlev,2020-10-24,Joel Alvarez,Submission,0,0,0,0
Alexander Yakovlev,2016-11-19,Zak Cummings,Submission,0,0,0,0
Jussier Formiga,2018-02-10,Ben Nguyen,Submission,90,6,0,96
Jussier Formiga,2019-03-23,Deiveson Figueiredo,Decision - Unanimous,80,12,0,92
Jussier Formiga,2015-11-21,Henry Cejudo,Decision - Split,0,0,0,0
Jussier Formiga,2020-06-06,Alex Perez,KO/TKO,0,0,0,0
Jussier Formiga,2012-10-05,John Dodson,KO/TKO,0,0,0,0
Jussier Formiga,2015-05-30,Wilson Reis,Decision - Unanimous,80,0,0,80
Jussier Formiga,2013-05-18,Chris Cariaso,Decision - Unanimous,80,0,0,80
Jussier Formiga,2013-09-04,Joseph Benavidez,KO/TKO,0,0,0,0
Jussier Formiga,2020-03-14,Brandon Moreno,Decision - Unanimous,0,0,0,0
Jussier Formiga,2014-03-23,Scott Jorgensen,Submission,90,3,0,93
Jussier Formiga,2014-08-16,Zach Makovsky,Decision - Unanimous,80,0,0,80
Jussier Formiga,2018-10-06,Sergio Pettis,Decision - Unanimous,80,0,0,80
Jussier Formiga,2017-03-11,Ray Borg,Decision - Unanimous,0,0,0,0
Jussier Formiga,2017-09-22,Yuta Sasaki,Submission,90,0,0,90
Jussier Formiga,2016-09-24,Dustin Ortiz,Decision - Unanimous,80,0,0,80
Jussier Formiga,2019-06-29,Joseph Benavidez,KO/TKO,0,0,0,0
Kevin Burns,2008-06-07,Roan Carneiro,Submission,90,0,0,90
Kevin Burns,2008-12-13,Anthony Johnson,KO/TKO,0,0,0,0
Kevin Burns,2009-12-12,TJ Grant,KO/TKO,0,0,0,0
Kevin Burns,2008-07-19,Anthony Johnson,KO/TKO,100,0,0,100
Kevin Burns,2009-06-20,Chris Lytle,Decision - Unanimous,0,0,0,0
Charles Byrd,2018-03-17,John Phillips,Submission,90,11,0,101
Charles Byrd,2017-08-15,Randall Wallace,Submission,90,21,0,111
Charles Byrd,2019-03-02,Edmen Shahbazyan,KO/TKO,0,0,0,0
Charles Byrd,2018-09-08,Darren Stewart,KO/TKO,0,14,0,14
Charles Byrd,2020-06-06,Maki Pitolo,KO/TKO,0,0,0,0
Charles Byrd,2017-07-11,Jamie Pickett,Submission,90,8,0,98
John Phillips,2018-03-17,Charles Byrd,Submission,0,0,0,0
John Phillips,2019-09-28,Alen Amedovski,KO/TKO,100,3,0,103
John Phillips,2020-07-15,Khamzat Chimaev,Submission,0,0,0,0
John Phillips,2020-10-17,JunYong Park,Decision - Unanimous,0,0,0,0
John Phillips,2019-03-16,Jack Marshman,Decision - Split,0,1,0,1
John Phillips,2018-11-24,Kevin Holland,Submission,0,0,0,0
Martin Kampmann,2006-11-11,Thales Leites,Decision - Unanimous,80,55,0,135
Martin Kampmann,2009-01-17,Alexandre Barros,KO/TKO,100,25,0,125
Martin Kampmann,2013-08-28,Carlos Condit,KO/TKO,0,0,25,25
Martin Kampmann,2008-09-06,Nate Marquardt,KO/TKO,0,0,0,0
Martin Kampmann,2012-03-02,Thiago Alves,Submission,90,0,0,90
Martin Kampmann,2009-04-01,Carlos Condit,Decision - Split,70,0,0,70
Martin Kampmann,2009-09-19,Paul Daley,KO/TKO,0,0,0,0
Martin Kampmann,2011-11-19,Rick Story,Decision - Split,70,0,0,70
Martin Kampmann,2012-06-01,Jake Ellenberger,KO/TKO,100,0,25,125
Martin Kampmann,2010-01-02,Jacob Volkmann,Submission,90,1,0,91
Martin Kampmann,2008-06-07,Jorge Rivera,Submission,90,2,0,92
Martin Kampmann,2012-11-17,Johny Hendricks,KO/TKO,0,0,0,0
Martin Kampmann,2011-03-03,Diego Sanchez,Decision - Unanimous,0,26,0,26
Martin Kampmann,2006-08-17,Crafton Wallace,Submission,90,18,0,108
Martin Kampmann,2010-10-23,Jake Shields,Decision - Split,0,10,0,10
Martin Kampmann,2010-06-12,Paulo Thiago,Decision - Unanimous,80,11,0,91
Martin Kampmann,2007-03-03,Drew McFedries,Submission,90,0,0,90
Garreth McLellan,2016-08-27,Alessio Di Chirico,Decision - Split,0,0,0,0
Garreth McLellan,2015-04-11,Bartosz Fabinski,Decision - Unanimous,0,0,0,0
Garreth McLellan,2016-05-08,Magnus Cedenblad,KO/TKO,0,0,0,0
Garreth McLellan,2015-10-24,Bubba Bush,KO/TKO,100,89,0,189
Garreth McLellan,2017-03-11,Paulo Costa,KO/TKO,0,0,0,0
Dan Hooker,2020-06-27,Dustin Poirier,Decision - Unanimous,0,2,25,27
Dan Hooker,2014-06-28,Ian Entwistle,KO/TKO,100,11,0,111
Dan Hooker,2016-03-19,Mark Eddiva,Submission,90,1,0,91
Dan Hooker,2017-06-10,Ross Pearson,KO/TKO,100,31,0,131
Dan Hooker,2022-03-19,Arnold Allen,KO/TKO,0,0,0,0
Dan Hooker,2018-07-07,Gilbert Burns,KO/TKO,100,9,0,109
Dan Hooker,2023-07-08,Jalin Turner,Decision - Split,70,25,0,95
Dan Hooker,2021-09-25,Nasrat Haqparast,Decision - Unanimous,80,46,0,126
Dan Hooker,2021-01-23,Michael Chandler,KO/TKO,0,0,0,0
Dan Hooker,2019-07-20,James Vick,KO/TKO,100,15,0,115
Dan Hooker,2018-12-15,Edson Barboza,KO/TKO,0,0,0,0
Dan Hooker,2015-10-03,Yair Rodriguez,Decision - Unanimous,0,0,0,0
Dan Hooker,2022-11-12,Claudio Puelles,KO/TKO,100,24,0,124
Dan Hooker,2020-02-22,Paul Felder,Decision - Split,70,12,25,107
Dan Hooker,2021-10-30,Islam Makhachev,Submission,0,2,0,2
Dan Hooker,2015-05-09,Hatsu Hioki,KO/TKO,100,0,0,100
Dan Hooker,2016-11-26,Jason Knight,Decision - Unanimous,0,0,0,0
Dan Hooker,2017-12-30,Marc Diakiese,Submission,90,0,0,90
Dan Hooker,2014-09-20,Maximo Blanco,Decision - Unanimous,0,0,0,0
Dan Hooker,2018-04-21,Jim Miller,KO/TKO,100,14,0,114
Dan Hooker,2019-10-05,Al Iaquinta,Decision - Unanimous,80,61,0,141
Dan Hooker,2024-08-17,Mateusz Gamrot,Decision - Split,70,1,0,71
Matt Brown,2014-05-10,Erick Silva,KO/TKO,100,93,25,218
Matt Brown,2022-03-26,Bryan Barberena,Decision - Split,0,0,0,0
Matt Brown,2023-05-13,Court McGee,KO/TKO,100,3,0,103
Matt Brown,2008-09-06,Dong Hyun Kim,Decision - Split,0,36,0,36
Matt Brown,2015-07-11,Tim Means,Submission,90,9,0,99
Matt Brown,2012-04-21,Stephen Thompson,Decision - Unanimous,80,0,0,80
Matt Brown,2012-02-04,Chris Cope,KO/TKO,100,28,0,128
Matt Brown,2017-11-11,Diego Sanchez,KO/TKO,100,6,0,106
Matt Brown,2008-11-15,Ryan Thomas,Submission,90,0,0,90
Matt Brown,2020-05-16,Miguel Baeza,KO/TKO,0,0,0,0
Matt Brown,2012-06-22,Luis Ramos,KO/TKO,100,32,0,132
Matt Brown,2019-12-14,Ben Saunders,KO/TKO,100,18,0,118
Matt Brown,2016-12-10,Donald Cerrone,KO/TKO,0,7,0,7
Matt Brown,2016-05-14,Demian Maia,Submission,0,0,0,0
Matt Brown,2013-08-17,Mike Pyle,KO/TKO,100,10,0,110
Matt Brown,2016-07-30,Jake Ellenberger,KO/TKO,0,0,0,0
Matt Brown,2021-01-16,Carlos Condit,Decision - Unanimous,0,0,0,0
Matt Brown,2008-06-21,Matt Arroyo,KO/TKO,100,6,0,106
Matt Brown,2014-07-26,Robbie Lawler,Decision - Unanimous,0,2,25,27
Matt Brown,2015-03-14,Johny Hendricks,Decision - Unanimous,0,0,0,0
Matt Brown,2011-06-26,John Howard,Decision - Unanimous,80,18,0,98
Matt Brown,2010-07-03,Chris Lytle,Submission,0,6,0,6
Matt Brown,2011-11-19,Seth Baczynski,Submission,0,2,0,2
Matt Brown,2012-12-08,Mike Swick,KO/TKO,100,16,0,116
Matt Brown,2009-11-14,James Wilks,KO/TKO,100,26,0,126
Matt Brown,2021-06-19,Dhiego Lima,KO/TKO,100,4,0,104
Matt Brown,2009-03-07,Pete Sell,KO/TKO,100,24,0,124
Matt Brown,2010-11-20,Brian Foster,Submission,0,0,0,0
Matt Brown,2010-03-27,Ricardo Almeida,Submission,0,0,0,0
Matt Brown,2013-04-20,Jordan Mein,KO/TKO,100,16,0,116
Erick Silva,2014-05-10,Matt Brown,KO/TKO,0,0,25,25
Erick Silva,2014-02-15,Takenori Sato,KO/TKO,100,18,0,118
Erick Silva,2012-01-14,Carlo Prater,DQ,0,8,0,8
Erick Silva,2017-12-16,Jordan Mein,Decision - Unanimous,0,0,0,0
Erick Silva,2011-08-27,Luis Ramos,KO/TKO,100,0,0,100
Erick Silva,2016-03-05,Nordine Taleb,KO/TKO,0,0,0,0
Erick Silva,2012-06-08,Charlie Brenneman,Submission,90,7,0,97
Erick Silva,2017-06-03,Yancy Medeiros,KO/TKO,0,0,0,0
Erick Silva,2014-12-20,Mike Rhodes,Submission,90,0,0,90
Erick Silva,2013-10-09,Dong Hyun Kim,KO/TKO,0,17,0,17
Erick Silva,2015-08-23,Neil Magny,Decision - Split,0,0,0,0
Erick Silva,2015-03-21,Josh Koscheck,Submission,90,10,0,100
Erick Silva,2016-09-24,Luan Chagas,Submission,90,14,0,104
Erick Silva,2013-06-08,Jason High,Submission,90,0,0,90
Erick Silva,2012-10-13,Jon Fitch,Decision - Unanimous,0,0,0,0
Jorge Masvidal,2014-04-19,Pat Healy,Decision - Unanimous,80,37,0,117
Jorge Masvidal,2011-03-05,Billy Evangelista,Decision - Unanimous,80,25,0,105
Jorge Masvidal,2013-11-06,Rustam Khabilov,Decision - Unanimous,0,6,0,6
Jorge Masvidal,2020-07-11,Kamaru Usman,Decision - Unanimous,0,0,25,25
Jorge Masvidal,2022-03-05,Colby Covington,Decision - Unanimous,0,0,25,25
Jorge Masvidal,2007-09-29,Matt Lee,KO/TKO,100,15,0,115
Jorge Masvidal,2019-03-16,Darren Till,KO/TKO,100,14,25,139
Jorge Masvidal,2017-01-28,Donald Cerrone,KO/TKO,100,28,0,128
Jorge Masvidal,2019-11-02,Nate Diaz,TKO - Doctor's Stoppage,0,69,25,94
Jorge Masvidal,2012-07-14,Justin Wilcox,Decision - Split,70,34,0,104
Jorge Masvidal,2011-06-18,KJ Noons,Decision - Unanimous,80,35,0,115
Jorge Masvidal,2015-11-28,Benson Henderson,Decision - Split,0,0,25,25
Jorge Masvidal,2013-07-27,Michael Chiesa,Submission,90,0,0,90
Jorge Masvidal,2016-05-29,Lorenz Larkin,Decision - Split,0,4,0,4
Jorge Masvidal,2016-07-30,Ross Pearson,Decision - Unanimous,80,61,0,141
Jorge Masvidal,2017-11-04,Stephen Thompson,Decision - Unanimous,0,0,0,0
Jorge Masvidal,2013-04-20,Tim Means,Decision - Unanimous,80,7,0,87
Jorge Masvidal,2008-02-23,Ryan Healy,Decision - Unanimous,80,20,0,100
Jorge Masvidal,2023-04-08,Gilbert Burns,Decision - Unanimous,0,0,0,0
Jorge Masvidal,2019-07-06,Ben Askren,KO/TKO,100,3,0,103
Jorge Masvidal,2011-12-17,Gilbert Melendez,Decision - Unanimous,0,0,25,25
Jorge Masvidal,2017-05-13,Demian Maia,Decision - Split,0,16,0,16
Jorge Masvidal,2021-04-24,Kamaru Usman,KO/TKO,0,10,25,35
Jorge Masvidal,2014-09-27,James Krause,Decision - Unanimous,80,11,0,91
Jorge Masvidal,2015-04-04,Al Iaquinta,Decision - Split,0,28,0,28
Jorge Masvidal,2016-12-03,Jake Ellenberger,KO/TKO,100,33,0,133
Jorge Masvidal,2014-07-26,Daron Cruickshank,Decision - Unanimous,80,32,0,112
Jorge Masvidal,2015-07-12,Cezar Ferreira,KO/TKO,100,5,0,105
Jessica Eye,2018-01-14,Kalindra Faria,Decision - Split,70,0,0,70
Jessica Eye,2016-09-10,Bethe Correia,Decision - Split,0,3,0,3
Jessica Eye,2021-01-23,Joanne Wood,Decision - Unanimous,0,0,0,0
Jessica Eye,2015-10-03,Julianna Pena,Decision - Unanimous,0,0,0,0
Jessica Eye,2020-06-13,Cynthia Calvillo,Decision - Unanimous,0,0,25,25
Jessica Eye,2016-05-29,Sara McMann,Decision - Unanimous,0,0,0,0
Jessica Eye,2021-07-10,Jennifer Maia,Decision - Unanimous,0,2,0,2
Jessica Eye,2019-06-08,Valentina Shevchenko,KO/TKO,0,0,25,25
Jessica Eye,2014-02-22,Alexis Davis,Decision - Split,0,0,0,0
Jessica Eye,2019-12-14,Viviane Araujo,Decision - Unanimous,80,42,0,122
Jessica Eye,2018-06-23,Jessica-Rose Clark,Decision - Unanimous,80,16,0,96
Jessica Eye,2022-07-02,Maycee Barber,Decision - Unanimous,0,0,0,0
Jessica Eye,2014-11-15,Leslie Smith,TKO - Doctor's Stoppage,0,52,0,52
Jessica Eye,2015-07-25,Miesha Tate,Decision - Unanimous,0,0,0,0
Jessica Eye,2018-12-08,Katlyn Cerminara,Decision - Split,70,16,0,86
Kalindra Faria,2018-01-14,Jessica Eye,Decision - Split,0,13,0,13
Kalindra Faria,2018-08-25,Joanne Wood,Submission,0,8,0,8
Kalindra Faria,2017-10-07,Mara Romero Borella,Submission,0,0,0,0
Amanda Cooper,2016-07-08,Tatiana Suarez,Submission,0,0,0,0
Amanda Cooper,2018-11-10,Ashley Yoder,Decision - Split,0,13,0,13
Amanda Cooper,2018-05-12,Mackenzie Dern,Submission,0,0,0,0
Amanda Cooper,2017-12-02,Angela Magana,KO/TKO,100,28,0,128
Amanda Cooper,2017-03-04,Cynthia Calvillo,Submission,0,0,0,0
Amanda Cooper,2016-11-19,Anna Elmose,Decision - Unanimous,80,6,0,86
Bart Palaszewski,2010-03-06,Karen Darabedyan,Submission,90,0,0,90
Bart Palaszewski,2010-12-16,Kamal Shalorus,Decision - Split,0,0,0,0
Bart Palaszewski,2010-08-18,Zachary Micklewright,KO/TKO,100,0,0,100
Bart Palaszewski,2007-11-03,Chris Horodecki,Decision - Split,0,0,0,0
Bart Palaszewski,2012-10-05,Diego Nunes,Decision - Unanimous,0,0,0,0
Bart Palaszewski,2011-10-29,Tyson Griffin,KO/TKO,100,11,0,111
Bart Palaszewski,2008-12-03,Alex Karalexis,KO/TKO,100,3,0,103
Bart Palaszewski,2012-02-25,Hatsu Hioki,Decision - Unanimous,0,0,0,0
Bart Palaszewski,2013-04-13,Cole Miller,Submission,0,13,0,13
Bart Palaszewski,2009-12-19,Anthony Pettis,Decision - Split,70,0,0,70
Bart Palaszewski,2009-03-01,Ricardo Lamas,Decision - Unanimous,0,0,0,0
Bart Palaszewski,2009-04-05,Anthony Njokuani,KO/TKO,0,0,0,0
Karen Darabedyan,2010-03-06,Bart Palaszewski,Submission,0,15,0,15
Karen Darabedyan,2010-06-20,Will Kerr,Submission,0,0,0,0
Karen Darabedyan,2009-11-18,Rob McCullough,Decision - Split,70,4,0,74
Roger Gracie,2013-01-12,Anthony Smith,Submission,90,0,0,90
Roger Gracie,2010-05-15,Kevin Randleman,Submission,90,8,0,98
Roger Gracie,2012-07-14,Keith Jardine,Decision - Unanimous,80,28,0,108
Roger Gracie,2011-01-29,Trevor Prangley,Submission,90,9,0,99
Roger Gracie,2013-07-06,Tim Kennedy,Decision - Unanimous,0,0,0,0
Roger Gracie,2011-09-10,Muhammed Lawal,KO/TKO,0,0,0,0
Ali Bagautinov,2016-06-18,Geane Herrera,Decision - Unanimous,80,77,0,157
Ali Bagautinov,2015-10-03,Joseph Benavidez,Decision - Unanimous,0,0,0,0
Ali Bagautinov,2016-11-19,Kyoji Horiguchi,Decision - Unanimous,0,0,0,0
Ali Bagautinov,2014-02-01,John Lineker,Decision - Unanimous,80,22,0,102
Ali Bagautinov,2014-06-14,Demetrious Johnson,Decision - Unanimous,0,0,25,25
Ali Bagautinov,2013-09-04,Marcos Vinicius,KO/TKO,100,11,0,111
Ali Bagautinov,2013-11-16,Tim Elliott,Decision - Unanimous,80,0,0,80
Geane Herrera,2016-06-18,Ali Bagautinov,Decision - Unanimous,0,0,0,0
Geane Herrera,2015-08-08,Ray Borg,Decision - Unanimous,0,0,0,0
Geane Herrera,2015-12-11,Joby Sanchez,KO/TKO,100,0,0,100
Geane Herrera,2016-11-26,Ben Nguyen,Decision - Unanimous,0,0,0,0
Ed Herman,2016-01-17,Tim Boetsch,KO/TKO,100,20,0,120
Ed Herman,2019-05-18,Patrick Cummins,KO/TKO,100,0,0,100
Ed Herman,2013-11-16,Thales Leites,Decision - Unanimous,0,0,0,0
Ed Herman,2021-08-07,Alonzo Menifield,Decision - Unanimous,0,0,0,0
Ed Herman,2013-07-27,Trevor Smith,Decision - Split,70,0,0,70
Ed Herman,2007-11-17,Joe Doerksen,KO/TKO,100,34,0,134
Ed Herman,2015-01-31,Derek Brunson,KO/TKO,0,0,0,0
Ed Herman,2008-04-19,Demian Maia,Submission,0,0,0,0
Ed Herman,2016-07-30,Nikita Krylov,KO/TKO,0,0,0,0
Ed Herman,2011-06-04,Tim Credeur,KO/TKO,100,0,0,100
Ed Herman,2013-01-12,Jacare Souza,Submission,0,0,0,0
Ed Herman,2007-06-16,Scott Smith,Submission,90,21,0,111
Ed Herman,2017-07-07,CB Dollaway,Decision - Unanimous,0,0,0,0
Ed Herman,2012-02-04,Clifford Starks,Submission,90,12,0,102
Ed Herman,2018-10-27,Gian Villante,Decision - Split,0,3,0,3
Ed Herman,2023-04-15,Zak Cummings,KO/TKO,0,0,0,0
Ed Herman,2019-11-09,Khadis Ibragimov,Decision - Unanimous,80,28,0,108
Ed Herman,2020-09-12,Mike Rodriguez,Submission,90,0,0,90
Ed Herman,2008-09-17,Alan Belcher,Decision - Split,0,0,0,0
Ed Herman,2006-06-24,Kendall Grove,Decision - Unanimous,0,8,0,8
Ed Herman,2014-05-10,Rafael Natal,Decision - Unanimous,80,16,0,96
Ed Herman,2006-10-10,Jason MacDonald,Submission,0,0,0,0
Ed Herman,2009-08-29,Aaron Simpson,KO/TKO,0,0,0,0
Ed Herman,2011-08-14,Kyle Noke,Submission,90,0,0,90
Ed Herman,2007-01-25,Chris Price,Submission,90,0,0,90
Ed Herman,2009-04-18,David Loiseau,Decision - Unanimous,80,65,0,145
Nate Loughran,2008-07-19,Johnny Rees,Submission,90,0,0,90
Nate Loughran,2008-12-10,Tim Credeur,KO/TKO,0,0,0,0
Johnny Rees,2008-07-19,Nate Loughran,Submission,0,6,0,6
Johnny Rees,2008-12-10,Steve Bruno,Submission,0,26,0,26
Branden Lee Hinkle,2005-10-07,Sean Gannon,KO/TKO,100,27,0,127
Branden Lee Hinkle,2006-02-04,Jeff Monson,Submission,0,0,0,0
Branden Lee Hinkle,2006-06-28,Jason Lambert,KO/TKO,0,0,0,0
Sean Gannon,2005-10-07,Branden Lee Hinkle,KO/TKO,0,0,0,0
Robbie Lawler,2012-01-07,Adlan Amagov,KO/TKO,100,5,0,105
Robbie Lawler,2013-07-27,Bobby Voelker,KO/TKO,100,18,0,118
Robbie Lawler,2016-01-02,Carlos Condit,Decision - Split,70,0,25,95
Robbie Lawler,2015-07-11,Rory MacDonald,KO/TKO,100,0,25,125
Robbie Lawler,2019-08-03,Colby Covington,Decision - Unanimous,0,0,25,25
Robbie Lawler,2017-12-16,Rafael Dos Anjos,Decision - Unanimous,0,0,25,25
Robbie Lawler,2008-07-26,Scott Smith,KO/TKO,100,25,25,150
Robbie Lawler,2014-03-15,Johny Hendricks,Decision - Unanimous,0,0,25,25
Robbie Lawler,2016-07-30,Tyron Woodley,KO/TKO,0,0,25,25
Robbie Lawler,2014-05-24,Jake Ellenberger,KO/TKO,100,39,0,139
Robbie Lawler,2010-06-16,Renato Sobral,Decision - Unanimous,0,0,0,0
Robbie Lawler,2009-06-06,Jake Shields,Submission,0,0,0,0
Robbie Lawler,2017-07-29,Donald Cerrone,Decision - Unanimous,80,0,0,80
Robbie Lawler,2012-07-14,Lorenz Larkin,Decision - Unanimous,0,0,0,0
Robbie Lawler,2013-02-23,Josh Koscheck,KO/TKO,100,7,0,107
Robbie Lawler,2019-03-02,Ben Askren,Submission,0,26,0,26
Robbie Lawler,2021-09-25,Nick Diaz,KO/TKO,100,0,25,125
Robbie Lawler,2004-10-22,Evan Tanner,Submission,0,0,0,0
Robbie Lawler,2020-08-29,Neil Magny,Decision - Unanimous,0,0,0,0
Robbie Lawler,2003-04-25,Pete Spratt,Submission,0,0,0,0
Robbie Lawler,2003-11-21,Chris Lytle,Decision - Unanimous,80,0,0,80
Robbie Lawler,2010-01-30,Melvin Manhoef,KO/TKO,100,0,0,100
Robbie Lawler,2013-11-16,Rory MacDonald,Decision - Split,70,7,0,77
Robbie Lawler,2002-11-22,Tiki Ghosn,KO/TKO,100,0,0,100
Robbie Lawler,2014-07-26,Matt Brown,Decision - Unanimous,80,0,25,105
Robbie Lawler,2011-07-30,Tim Kennedy,Decision - Unanimous,0,0,0,0
Robbie Lawler,2011-01-29,Jacare Souza,Submission,0,2,25,27
Robbie Lawler,2010-12-04,Matt Lindland,KO/TKO,100,4,0,104
Robbie Lawler,2006-10-21,Joey Villasenor,KO/TKO,100,3,0,103
Robbie Lawler,2002-05-10,Aaron Riley,Decision - Unanimous,80,9,0,89
Robbie Lawler,2007-09-15,Murilo Rua,KO/TKO,100,2,25,127
Robbie Lawler,2014-12-06,Johny Hendricks,Decision - Split,70,5,25,100
Robbie Lawler,2002-06-22,Steve Berger,KO/TKO,100,17,0,117
Robbie Lawler,2023-07-08,Niko Price,KO/TKO,100,6,0,106
Robbie Lawler,2022-07-02,Bryan Barberena,KO/TKO,0,0,0,0
Robbie Lawler,2004-04-02,Nick Diaz,KO/TKO,0,0,0,0
Adlan Amagov,2012-01-07,Robbie Lawler,KO/TKO,0,0,0,0
Adlan Amagov,2011-11-18,Anthony Smith,KO/TKO,100,12,0,112
Adlan Amagov,2013-04-06,Chris Spang,Decision - Unanimous,80,33,0,113
Adlan Amagov,2012-08-18,Keith Berry,KO/TKO,100,6,0,106
Adlan Amagov,2013-10-19,TJ Waldburger,KO/TKO,100,11,0,111
Michael Bisping,2010-05-29,Dan Miller,Decision - Unanimous,80,26,0,106
Michael Bisping,2011-12-03,Jason Miller,KO/TKO,100,75,25,200
Michael Bisping,2016-10-08,Dan Henderson,Decision - Unanimous,80,38,25,143
Michael Bisping,2006-12-30,Eric Schafer,KO/TKO,100,16,0,116
Michael Bisping,2017-11-04,Georges St-Pierre,Submission,0,0,25,25
Michael Bisping,2015-04-25,CB Dollaway,Decision - Unanimous,80,28,0,108
Michael Bisping,2012-09-22,Brian Stann,Decision - Unanimous,80,7,0,87
Michael Bisping,2005-10-01,Jakob Lovstad,KO/TKO,100,11,25,136
Michael Bisping,2013-01-19,Vitor Belfort,KO/TKO,0,0,25,25
Michael Bisping,2006-06-24,Josh Haynes,KO/TKO,100,33,0,133
Michael Bisping,2009-11-14,Denis Kang,KO/TKO,100,18,0,118
Michael Bisping,2005-11-26,Ross Pointon,Submission,90,4,25,119
Michael Bisping,2010-10-16,Yoshihiro Akiyama,Decision - Unanimous,80,68,0,148
Michael Bisping,2014-08-23,Cung Le,KO/TKO,100,54,25,179
Michael Bisping,2012-01-28,Chael Sonnen,Decision - Unanimous,0,0,0,0
Michael Bisping,2008-04-19,Charles McCarthy,KO/TKO,100,38,0,138
Michael Bisping,2016-06-04,Luke Rockhold,KO/TKO,100,4,25,129
Michael Bisping,2008-06-07,Jason Day,KO/TKO,100,18,0,118
Michael Bisping,2009-07-11,Dan Henderson,KO/TKO,0,0,0,0
Michael Bisping,2007-09-08,Matt Hamill,Decision - Split,70,0,0,70
Michael Bisping,2005-07-16,Miika Mehmet,KO/TKO,100,21,25,146
Michael Bisping,2014-11-07,Luke Rockhold,Submission,0,0,25,25
Michael Bisping,2014-04-16,Tim Kennedy,Decision - Unanimous,0,0,25,25
Michael Bisping,2017-11-25,Kelvin Gastelum,KO/TKO,0,0,25,25
Michael Bisping,2015-07-18,Thales Leites,Decision - Split,70,36,25,131
Michael Bisping,2010-02-20,Wanderlei Silva,Decision - Unanimous,0,0,0,0
Michael Bisping,2013-04-27,Alan Belcher,Decision - Unanimous,80,64,0,144
Michael Bisping,2008-10-18,Chris Leben,Decision - Unanimous,80,19,0,99
Michael Bisping,2011-02-26,Jorge Rivera,KO/TKO,100,42,0,142
Michael Bisping,2016-02-27,Anderson Silva,Decision - Unanimous,80,33,25,138
Michael Bisping,2007-11-17,Rashad Evans,Decision - Split,0,17,0,17
Michael Bisping,2007-04-21,Elvis Sinosic,KO/TKO,100,28,0,128
Dan Miller,2010-05-29,Michael Bisping,Decision - Unanimous,0,0,0,0
Dan Miller,2010-12-11,Joe Doerksen,Decision - Split,70,6,0,76
Dan Miller,2012-06-22,Ricardo Funch,Submission,90,0,0,90
Dan Miller,2008-05-16,Ryan McGivern,Submission,90,0,25,115
Dan Miller,2013-03-16,Jordan Mein,KO/TKO,0,0,0,0
Dan Miller,2010-02-06,Demian Maia,Decision - Unanimous,0,0,0,0
Dan Miller,2007-08-02,Dave Phillips,Submission,90,3,0,93
Dan Miller,2015-07-12,Trevor Smith,Decision - Unanimous,0,0,0,0
Dan Miller,2011-03-19,Nate Marquardt,Decision - Unanimous,0,0,0,0
Dan Miller,2008-10-25,Matt Horwich,Decision - Unanimous,80,16,0,96
Dan Miller,2009-05-23,Chael Sonnen,Decision - Unanimous,0,0,0,0
Dan Miller,2008-09-17,Rob Kimmons,Submission,90,0,0,90
Dan Miller,2010-08-28,John Salter,Submission,90,2,0,92
Dan Miller,2011-08-27,Rousimar Palhares,Decision - Unanimous,0,0,0,0
Dan Miller,2009-02-07,Jake Rosholt,Submission,90,0,0,90
Tom Lawlor,2009-07-11,CB Dollaway,Submission,90,0,0,90
Tom Lawlor,2011-11-19,Chris Weidman,Submission,0,0,0,0
Tom Lawlor,2015-07-25,Gian Villante,KO/TKO,100,0,0,100
Tom Lawlor,2010-01-11,Aaron Simpson,Decision - Split,0,16,0,16
Tom Lawlor,2010-10-23,Patrick Cote,Decision - Unanimous,80,43,0,123
Tom Lawlor,2012-05-15,Jason MacDonald,KO/TKO,100,4,0,104
Tom Lawlor,2012-11-17,Francis Carmont,Decision - Split,0,0,0,0
Tom Lawlor,2013-04-06,Michael Kuiper,Submission,90,0,0,90
Tom Lawlor,2010-05-08,Joe Doerksen,Submission,0,0,0,0
Tom Lawlor,2016-03-05,Corey Anderson,Decision - Unanimous,0,0,0,0
Tom Lawlor,2008-12-13,Kyle Kingsbury,Decision - Unanimous,80,4,0,84
Cody Garbrandt,2023-12-16,Brian Kelleher,KO/TKO,100,3,0,103
Cody Garbrandt,2023-03-04,Trevin Jones,Decision - Unanimous,80,6,0,86
Cody Garbrandt,2018-08-04,TJ Dillashaw,KO/TKO,0,0,25,25
Cody Garbrandt,2016-08-20,Takeya Mizugaki,KO/TKO,100,8,0,108
Cody Garbrandt,2021-05-22,Rob Font,Decision - Unanimous,0,0,25,25
Cody Garbrandt,2017-11-04,TJ Dillashaw,KO/TKO,0,0,25,25
Cody Garbrandt,2016-05-29,Thomas Almeida,KO/TKO,100,11,25,136
Cody Garbrandt,2015-07-11,Henry Briones,Decision - Unanimous,80,29,0,109
Cody Garbrandt,2021-12-11,Kai Kara-France,KO/TKO,0,0,0,0
Cody Garbrandt,2024-04-13,Deiveson Figueiredo,Submission,0,3,0,3
Cody Garbrandt,2019-03-02,Pedro Munhoz,KO/TKO,0,0,0,0
Cody Garbrandt,2016-02-21,Augusto Mendes,KO/TKO,100,0,0,100
Cody Garbrandt,2016-12-30,Dominick Cruz,Decision - Unanimous,80,0,25,105
Cody Garbrandt,2015-01-03,Marcus Brimage,KO/TKO,100,6,0,106
Cody Garbrandt,2020-06-06,Raphael Assuncao,KO/TKO,100,2,0,102
Brian Kelleher,2023-12-16,Cody Garbrandt,KO/TKO,0,0,0,0
Brian Kelleher,2018-02-24,Renan Barao,Decision - Unanimous,80,0,0,80
Brian Kelleher,2017-06-03,Iuri Alcantara,Submission,90,0,0,90
Brian Kelleher,2020-06-06,Cody Stamann,Decision - Unanimous,0,0,0,0
Brian Kelleher,2021-08-21,Domingo Pilarte,Decision - Unanimous,80,25,0,105
Brian Kelleher,2018-05-12,John Lineker,KO/TKO,0,0,0,0
Brian Kelleher,2018-12-29,Montel Jackson,Submission,0,0,0,0
Brian Kelleher,2022-01-15,Kevin Croom,Decision - Unanimous,80,0,0,80
Brian Kelleher,2020-09-05,Ray Rodriguez,Submission,90,0,0,90
Brian Kelleher,2022-03-05,Umar Nurmagomedov,Submission,0,0,0,0
Brian Kelleher,2017-07-22,Marlon Vera,Submission,0,3,0,3
Brian Kelleher,2021-02-13,Ricky Simon,Decision - Unanimous,0,0,0,0
Brian Kelleher,2020-01-18,Ode Osbourne,Submission,90,0,0,90
Brian Kelleher,2017-10-21,Damian Stasiak,KO/TKO,100,36,0,136
Brian Kelleher,2024-07-20,Cody Gibson,Submission,0,0,0,0
Brian Kelleher,2020-05-13,Hunter Azure,KO/TKO,100,0,0,100
Brian Kelleher,2022-06-25,Mario Bautista,Submission,0,0,0,0
Stephan Bonnar,2009-07-11,Mark Coleman,Decision - Unanimous,0,6,0,6
Stephan Bonnar,2007-10-20,Eric Schafer,KO/TKO,100,17,0,117
Stephan Bonnar,2006-06-28,Rashad Evans,Decision - Majority,0,0,0,0
Stephan Bonnar,2006-04-06,Keith Jardine,Decision - Unanimous,80,0,0,80
Stephan Bonnar,2006-08-26,Forrest Griffin,Decision - Unanimous,0,0,0,0
Stephan Bonnar,2006-01-16,James Irvin,Submission,90,0,0,90
Stephan Bonnar,2009-01-31,Jon Jones,Decision - Unanimous,0,0,0,0
Stephan Bonnar,2003-09-13,Lyoto Machida,TKO - Doctor's Stoppage,0,0,0,0
Stephan Bonnar,2010-12-04,Igor Pokrajac,Decision - Unanimous,80,21,0,101
Stephan Bonnar,2005-08-06,Sam Hoger,Decision - Unanimous,80,32,0,112
Stephan Bonnar,2010-07-03,Krzysztof Soszynski,KO/TKO,100,16,0,116
Stephan Bonnar,2012-10-13,Anderson Silva,KO/TKO,0,0,0,0
Stephan Bonnar,2011-11-19,Kyle Kingsbury,Decision - Unanimous,80,5,0,85
Stephan Bonnar,2005-04-09,Forrest Griffin,Decision - Unanimous,0,0,0,0
Stephan Bonnar,2007-07-07,Mike Nickels,Submission,90,0,0,90
Stephan Bonnar,2010-02-20,Krzysztof Soszynski,TKO - Doctor's Stoppage,0,0,0,0
Neil Seery,2015-01-24,Chris Beal,Decision - Unanimous,80,17,0,97
Neil Seery,2016-05-08,Kyoji Horiguchi,Decision - Unanimous,0,0,0,0
Neil Seery,2014-03-08,Brad Pickett,Decision - Unanimous,0,0,0,0
Neil Seery,2014-07-19,Phil Harris,Decision - Unanimous,80,20,0,100
Neil Seery,2015-10-24,Jon Delos Reyes,Submission,90,13,0,103
Neil Seery,2015-07-11,Louis Smolka,Decision - Unanimous,0,0,0,0
Neil Seery,2017-07-16,Alexandre Pantoja,Submission,0,0,0,0
Chris Beal,2015-01-24,Neil Seery,Decision - Unanimous,0,0,0,0
Chris Beal,2014-04-26,Patrick Williams,KO/TKO,100,5,0,105
Chris Beal,2015-08-23,Chris Kelades,Decision - Split,0,0,0,0
Chris Beal,2014-09-05,Tateki Matsuda,Decision - Unanimous,80,4,0,84
Chris Beal,2016-06-18,Joe Soto,Submission,0,29,0,29
KJ Noons,2008-06-14,Yves Edwards,KO/TKO,100,5,25,130
KJ Noons,2007-11-10,Nick Diaz,TKO - Doctor's Stoppage,0,6,25,31
KJ Noons,2013-10-19,George Sotiropoulos,Decision - Unanimous,80,6,0,86
KJ Noons,2012-03-03,Josh Thomson,Decision - Unanimous,0,0,0,0
KJ Noons,2013-01-12,Ryan Couture,Decision - Split,0,8,0,8
KJ Noons,2016-02-06,Joshua Burkman,Decision - Unanimous,0,0,0,0
KJ Noons,2007-07-27,Edson Berto,KO/TKO,100,32,0,132
KJ Noons,2010-06-16,Conor Heun,Decision - Split,70,8,0,78
KJ Noons,2015-05-30,Alex Oliveira,Submission,0,4,0,4
KJ Noons,2011-06-18,Jorge Masvidal,Decision - Unanimous,0,0,0,0
KJ Noons,2007-02-10,Charles Bennett,KO/TKO,0,0,0,0
KJ Noons,2011-12-17,Billy Evangelista,Decision - Unanimous,80,0,0,80
KJ Noons,2010-03-22,Andre Amado,Decision - Unanimous,80,41,0,121
KJ Noons,2013-05-25,Donald Cerrone,Decision - Unanimous,0,0,0,0
KJ Noons,2014-04-16,Sam Stout,KO/TKO,100,2,0,102
KJ Noons,2010-10-09,Nick Diaz,Decision - Unanimous,0,0,25,25
KJ Noons,2010-08-21,Jorge Gurgel,KO/TKO,100,9,0,109
Yves Edwards,2008-06-14,KJ Noons,KO/TKO,0,0,25,25
Yves Edwards,2005-09-25,Joachim Hansen,Decision - Split,0,15,0,15
Yves Edwards,2013-07-27,Daron Cruickshank,Decision - Split,0,4,0,4
Yves Edwards,2005-05-22,Dokonjonosuke Mishima,Submission,90,1,0,91
Yves Edwards,2004-08-21,Josh Thomson,KO/TKO,100,3,0,103
Yves Edwards,2003-06-06,Eddie Ruiz,Decision - Unanimous,80,18,0,98
Yves Edwards,2011-01-22,Cody McKenzie,Submission,90,17,0,107
Yves Edwards,2004-01-16,Deshaun Johnson,Decision - Unanimous,80,66,0,146
Yves Edwards,2012-12-08,Jeremy Stephens,KO/TKO,100,3,0,103
Yves Edwards,2003-11-21,Nick Agallar,KO/TKO,100,28,0,128
Yves Edwards,2008-11-21,Duane Ludwig,Decision - Unanimous,0,0,0,0
Yves Edwards,2011-10-01,Rafaello Oliveira,KO/TKO,100,20,0,120
Yves Edwards,2014-06-07,Piotr Hallmann,Submission,0,0,0,0
Yves Edwards,2008-02-16,Edson Berto,KO/TKO,100,16,0,116
Yves Edwards,2014-11-22,Akbarh Arreola,Submission,0,0,0,0
Yves Edwards,2002-06-22,Joao Pierini,KO/TKO,100,5,0,105
Yves Edwards,2013-02-02,Isaac Vallie-Flagg,Decision - Split,0,0,0,0
Yves Edwards,2011-06-11,Sam Stout,KO/TKO,0,1,0,1
Yves Edwards,2006-07-08,Joe Stevenson,TKO - Doctor's Stoppage,0,0,0,0
Yves Edwards,2006-04-02,Seichi Ikemoto,Decision - Unanimous,80,19,0,99
Yves Edwards,2001-09-28,Matt Serra,Decision - Majority,0,0,0,0
Yves Edwards,2011-12-03,Tony Ferguson,Decision - Unanimous,0,0,0,0
Yves Edwards,2004-04-02,Hermes Franca,Decision - Split,70,13,0,83
Yves Edwards,2010-09-15,John Gunderson,Decision - Unanimous,80,39,0,119
Yves Edwards,2002-05-10,Caol Uno,Decision - Unanimous,0,0,0,0
Yves Edwards,2003-02-28,Rich Clementi,Submission,90,20,0,110
Yves Edwards,2006-03-04,Mark Hominick,Submission,0,0,0,0
Tito Ortiz,2001-02-23,Evan Tanner,KO/TKO,100,7,25,132
Tito Ortiz,2006-12-30,Chuck Liddell,KO/TKO,0,0,25,25
Tito Ortiz,1997-05-30,Wes Albritton,KO/TKO,100,21,0,121
Tito Ortiz,2006-07-08,Ken Shamrock,KO/TKO,100,11,0,111
Tito Ortiz,2010-10-23,Matt Hamill,Decision - Unanimous,0,0,0,0
Tito Ortiz,2001-09-28,Vladimir Matyushenko,Decision - Unanimous,80,45,25,150
Tito Ortiz,2012-07-07,Forrest Griffin,Decision - Unanimous,0,0,0,0
Tito Ortiz,1999-03-05,Guy Mezger,KO/TKO,100,24,0,124
Tito Ortiz,2008-05-24,Lyoto Machida,Decision - Unanimous,0,0,0,0
Tito Ortiz,1999-09-24,Frank Shamrock,KO/TKO,0,0,25,25
Tito Ortiz,2009-11-21,Forrest Griffin,Decision - Split,0,0,0,0
Tito Ortiz,2002-11-22,Ken Shamrock,KO/TKO,100,62,25,187
Tito Ortiz,2004-10-22,Patrick Cote,Decision - Unanimous,80,34,0,114
Tito Ortiz,1997-05-30,Guy Mezger,Submission,0,5,0,5
Tito Ortiz,2003-09-26,Randy Couture,Decision - Unanimous,0,0,25,25
Tito Ortiz,1999-01-08,Jerry Bohlander,TKO - Doctor's Stoppage,0,28,0,28
Tito Ortiz,2011-12-10,Rogerio Nogueira,KO/TKO,0,0,0,0
Tito Ortiz,2011-08-06,Rashad Evans,KO/TKO,0,0,0,0
Tito Ortiz,2006-04-15,Forrest Griffin,Decision - Split,70,3,0,73
Tito Ortiz,2005-02-05,Vitor Belfort,Decision - Split,70,8,0,78
Tito Ortiz,2001-06-29,Elvis Sinosic,KO/TKO,100,32,25,157
Tito Ortiz,2011-07-02,Ryan Bader,Submission,90,2,0,92
Tito Ortiz,2004-04-02,Chuck Liddell,KO/TKO,0,0,0,0
Tito Ortiz,2006-10-10,Ken Shamrock,KO/TKO,100,18,0,118
Tito Ortiz,2000-12-16,Yuki Kondo,Submission,90,14,25,129
Tito Ortiz,2000-04-14,Wanderlei Silva,Decision - Unanimous,80,10,25,115
James Lee,2007-02-24,Travis Wiuff,Submission,90,3,0,93
James Lee,2008-01-19,Alessio Sakara,KO/TKO,0,0,0,0
Travis Wiuff,2007-02-24,James Lee,Submission,0,0,0,0
Travis Wiuff,2005-04-16,Renato Sobral,Submission,0,0,0,0
Travis Wiuff,2008-09-28,Muhammed Lawal,KO/TKO,0,0,0,0
Travis Wiuff,2002-11-22,Vladimir Matyushenko,KO/TKO,0,0,0,0
Zubaira Tukhugov,2020-02-22,Kevin Aguilar,KO/TKO,100,19,0,119
Zubaira Tukhugov,2015-12-10,Phillipe Nover,Decision - Split,70,1,0,71
Zubaira Tukhugov,2016-05-14,Renato Moicano,Decision - Split,0,0,0,0
Zubaira Tukhugov,2014-02-15,Douglas Silva de Andrade,Decision - Unanimous,80,8,0,88
Zubaira Tukhugov,2014-10-04,Ernest Chavez,KO/TKO,100,28,0,128
Zubaira Tukhugov,2020-09-26,Hakeem Dawodu,Decision - Split,0,0,0,0
Zubaira Tukhugov,2021-10-30,Ricardo Ramos,Decision - Unanimous,80,9,0,89
Zubaira Tukhugov,2023-02-11,Elves Brener,Decision - Split,0,1,0,1
Kevin Aguilar,2020-02-22,Zubaira Tukhugov,KO/TKO,0,0,0,0
Kevin Aguilar,2019-06-22,Dan Ige,Decision - Unanimous,0,0,0,0
Kevin Aguilar,2018-07-10,Joey Gomez,Decision - Split,70,0,0,70
Kevin Aguilar,2019-03-30,Enrique Barzola,Decision - Unanimous,80,6,0,86
Kevin Aguilar,2018-11-30,Ricky Glenn,Decision - Unanimous,80,12,0,92
Kevin Aguilar,2021-05-15,Tucker Lutz,Decision - Unanimous,0,0,0,0
Kevin Aguilar,2020-06-13,Charles Rosa,Decision - Split,0,0,0,0
Manel Kape,2022-12-17,David Dvorak,Decision - Unanimous,80,25,0,105
Manel Kape,2024-07-27,Muhammad Mokaev,Decision - Unanimous,0,0,0,0
Manel Kape,2021-08-07,Ode Osbourne,KO/TKO,100,1,0,101
Manel Kape,2021-12-04,Zhalgas Zhumagulov,KO/TKO,100,22,0,122
Manel Kape,2021-02-06,Alexandre Pantoja,Decision - Unanimous,0,0,0,0
Manel Kape,2023-09-09,Felipe dos Santos,Decision - Unanimous,80,13,0,93
Manel Kape,2024-12-14,Bruno Silva,KO/TKO,100,54,0,154
Manel Kape,2021-03-13,Matheus Nicolau,Decision - Split,0,6,0,6
David Dvorak,2022-12-17,Manel Kape,Decision - Unanimous,0,0,0,0
David Dvorak,2021-05-22,Juancamilo Ronderos,Submission,90,0,0,90
David Dvorak,2023-06-10,Steve Erceg,Decision - Unanimous,0,0,0,0
David Dvorak,2022-03-26,Matheus Nicolau,Decision - Unanimous,0,3,0,3
David Dvorak,2020-09-19,Jordan Espinosa,Decision - Unanimous,80,18,0,98
David Dvorak,2020-03-14,Bruno Silva,Decision - Unanimous,80,22,0,102
Anthony Hernandez,2024-02-17,Roman Kopylov,Submission,90,0,0,90
Anthony Hernandez,2019-02-02,Markus Perez,Submission,0,1,0,1
Anthony Hernandez,2022-09-17,Marc-Andre Barriault,Submission,90,14,0,104
Anthony Hernandez,2024-10-19,Michel Pereira,KO/TKO,100,128,25,253
Anthony Hernandez,2021-02-13,Rodolfo Vieira,Submission,90,23,0,113
Anthony Hernandez,2019-08-31,JunYong Park,Submission,90,0,0,90
Anthony Hernandez,2022-04-09,Josh Fremd,Decision - Unanimous,80,17,0,97
Anthony Hernandez,2020-05-16,Kevin Holland,KO/TKO,0,0,0,0
Anthony Hernandez,2023-05-20,Edmen Shahbazyan,KO/TKO,100,33,0,133
Roman Kopylov,2024-02-17,Anthony Hernandez,Submission,0,1,0,1
Roman Kopylov,2024-06-01,Cesar Almeida,Decision - Split,70,0,0,70
Roman Kopylov,2023-01-14,Punahele Soriano,KO/TKO,100,43,0,143
Roman Kopylov,2023-09-16,Josh Fremd,KO/TKO,100,11,0,111
Roman Kopylov,2021-10-30,Albert Duraev,Decision - Unanimous,0,0,0,0
Roman Kopylov,2023-07-29,Claudio Ribeiro,KO/TKO,100,0,0,100
Roman Kopylov,2019-11-09,Karl Roberson,Submission,0,0,0,0
Roman Kopylov,2022-09-03,Alessio Di Chirico,KO/TKO,100,20,0,120
Antonio Arroyo,2018-08-10,Diego Henrique da Silva,Decision - Unanimous,80,11,0,91
Antonio Arroyo,2020-12-19,Deron Winn,Decision - Unanimous,0,25,0,25
Antonio Arroyo,2019-07-16,Stephen Regman,Submission,90,30,0,120
Antonio Arroyo,2019-11-16,Andre Muniz,Decision - Unanimous,0,7,0,7
Antonio Arroyo,2021-09-18,Joaquin Buckley,KO/TKO,0,0,0,0
Diego Henrique da Silva,2018-08-10,Antonio Arroyo,Decision - Unanimous,0,0,0,0
Pedro Rizzo,1998-10-16,David Abbott,KO/TKO,100,8,0,108
Pedro Rizzo,2002-03-22,Andrei Arlovski,KO/TKO,100,0,0,100
Pedro Rizzo,2012-06-21,Fedor Emelianenko,KO/TKO,0,0,0,0
Pedro Rizzo,2000-06-09,Kevin Randleman,Decision - Unanimous,0,0,25,25
Pedro Rizzo,1999-11-19,Tsuyoshi Kohsaka,KO/TKO,100,0,0,100
Pedro Rizzo,2001-11-02,Randy Couture,KO/TKO,0,0,25,25
Pedro Rizzo,2003-06-06,Tra Telligman,TKO - Doctor's Stoppage,0,6,0,6
Pedro Rizzo,1999-05-07,Tra Telligman,KO/TKO,100,0,0,100
Pedro Rizzo,2003-11-21,Ricco Rodriguez,Decision - Unanimous,80,15,0,95
Pedro Rizzo,2008-07-19,Josh Barnett,KO/TKO,0,0,0,0
Pedro Rizzo,1999-01-08,Mark Coleman,Decision - Split,70,0,0,70
Pedro Rizzo,2005-06-26,Sergei Kharitonov,KO/TKO,0,0,0,0
Pedro Rizzo,2000-09-22,Dan Severn,KO/TKO,100,2,0,102
Pedro Rizzo,2001-02-23,Josh Barnett,KO/TKO,100,0,0,100
Pedro Rizzo,2001-05-04,Randy Couture,Decision - Unanimous,0,0,25,25
Pedro Rizzo,2002-09-27,Gan McGee,KO/TKO,0,0,0,0
Pedro Rizzo,2003-02-28,Vladimir Matyushenko,Decision - Unanimous,0,0,0,0
Pedro Rizzo,2006-02-26,Roman Zentsov,KO/TKO,0,0,0,0
Hideo Tokoro,2011-05-29,Yoshiro Maeda,KO/TKO,100,0,0,100
Hideo Tokoro,2009-12-31,Jong Man Kim,Decision - Unanimous,80,25,0,105
Hideo Tokoro,2011-12-31,Yusup Saadulaev,KO/TKO,0,0,0,0
Hideo Tokoro,2008-09-23,Atsushi Yamamoto,Decision - Unanimous,0,0,0,0
Hideo Tokoro,2011-05-29,Atsushi Yamamoto,Decision - Split,70,9,0,79
Hideo Tokoro,2008-06-15,Darren Uyenoyama,Decision - Unanimous,80,12,0,92
Hideo Tokoro,2011-09-24,Antonio Banuelos,Decision - Split,0,0,0,0
Hideo Tokoro,2009-05-26,Abel Cullum,Submission,90,5,0,95
Hideo Tokoro,2011-07-16,Masakazu Imanari,Decision - Unanimous,80,18,0,98
Hideo Tokoro,2010-12-31,Kazuhisa Watanabe,Submission,90,4,0,94
Hideo Tokoro,2009-10-06,Hiroyuki Takaya,KO/TKO,0,0,0,0
Hideo Tokoro,2008-07-21,Takeshi Yamazaki,Decision - Unanimous,80,13,0,93
Hideo Tokoro,2009-04-05,Daiki Hata,Decision - Unanimous,0,0,0,0
Hideo Tokoro,2010-05-29,Akiyo Nishiura,KO/TKO,0,0,0,0
Hideo Tokoro,2008-12-31,Daisuke Nakamura,Submission,0,0,0,0
Hideo Tokoro,2010-09-25,Joachim Hansen,Submission,0,0,0,0
Yoshiro Maeda,2011-05-29,Hideo Tokoro,KO/TKO,0,7,0,7
Yoshiro Maeda,2009-05-26,Hiroyuki Takaya,KO/TKO,0,7,0,7
Yoshiro Maeda,2006-11-05,Joe Pearson,Submission,0,0,0,0
Yoshiro Maeda,2008-11-05,Rani Yahya,Submission,0,1,0,1
Yoshiro Maeda,2005-05-22,Charles Bennett,KO/TKO,0,0,0,0
Yoshiro Maeda,2010-03-22,Cole Escovedo,KO/TKO,0,1,0,1
Yoshiro Maeda,2012-12-31,Bibiano Fernandes,Submission,0,0,0,0
Yoshiro Maeda,2010-05-29,Kenji Osawa,Decision - Split,0,0,0,0
Yoshiro Maeda,2008-02-13,Charlie Valencia,KO/TKO,100,4,0,104
Yoshiro Maeda,2009-10-25,Chase Beebe,Submission,90,12,0,102
Yoshiro Maeda,2008-06-01,Miguel Torres,TKO - Doctor's Stoppage,0,0,25,25
Yoshiro Maeda,2009-03-08,Micah Miller,Decision - Unanimous,80,22,0,102
Cal Worsham,1996-12-07,David Abbott,KO/TKO,0,1,0,1
Cal Worsham,1995-07-14,Paul Varelans,KO/TKO,0,1,0,1
Cal Worsham,1996-05-17,Zane Frazier,KO/TKO,100,8,0,108
Saimon Oliveira,2021-09-07,Jose Alday,Decision - Split,70,0,0,70
Saimon Oliveira,2022-01-22,Tony Gravely,Decision - Unanimous,0,0,0,0
Saimon Oliveira,2023-01-21,Daniel Marcos,KO/TKO,0,0,0,0
Jose Alday,2021-09-07,Saimon Oliveira,Decision - Split,0,0,0,0
Gabriel Benitez,2022-08-13,Charlie Ontiveros,KO/TKO,100,15,0,115
Gabriel Benitez,2015-11-21,Andre Fili,KO/TKO,0,0,0,0
Gabriel Benitez,2019-08-17,Sodiq Yusuff,KO/TKO,0,0,0,0
Gabriel Benitez,2021-07-17,Billy Quarantillo,KO/TKO,0,0,0,0
Gabriel Benitez,2020-05-13,Omar Morales,Decision - Unanimous,0,0,0,0
Gabriel Benitez,2018-05-19,Humberto Bandenay,KO/TKO,100,7,0,107
Gabriel Benitez,2017-05-13,Enrique Barzola,Decision - Unanimous,0,5,0,5
Gabriel Benitez,2024-01-13,Jim Miller,Submission,0,0,0,0
Gabriel Benitez,2016-09-17,Sam Sicilia,Submission,90,20,0,110
Gabriel Benitez,2020-12-05,Justin Jaynes,KO/TKO,100,16,0,116
Gabriel Benitez,2014-11-15,Humberto Brown Morrison,Submission,90,5,0,95
Gabriel Benitez,2022-02-19,David Onama,KO/TKO,0,10,0,10
Gabriel Benitez,2017-12-09,Jason Knight,Decision - Unanimous,80,49,0,129
Gabriel Benitez,2024-04-27,Maheshate,Decision - Split,0,24,0,24
Gabriel Benitez,2015-06-13,Clay Collard,Decision - Unanimous,80,26,0,106
Charlie Ontiveros,2022-08-13,Gabriel Benitez,KO/TKO,0,0,0,0
Charlie Ontiveros,2021-10-09,Steve Garcia,KO/TKO,0,0,0,0
Charlie Ontiveros,2020-10-31,Kevin Holland,Submission,0,0,0,0
Yoel Romero,2015-12-12,Jacare Souza,Decision - Split,70,16,0,86
Yoel Romero,2014-04-19,Brad Tavares,Decision - Unanimous,80,10,0,90
Yoel Romero,2016-11-12,Chris Weidman,KO/TKO,100,6,0,106
Yoel Romero,2011-09-10,Rafael Cavalcante,KO/TKO,0,9,0,9
Yoel Romero,2013-04-20,Clifford Starks,KO/TKO,100,9,0,109
Yoel Romero,2020-03-07,Israel Adesanya,Decision - Unanimous,0,0,25,25
Yoel Romero,2013-11-06,Ronny Markes,KO/TKO,100,32,0,132
Yoel Romero,2018-02-10,Luke Rockhold,KO/TKO,100,0,25,125
Yoel Romero,2014-01-15,Derek Brunson,KO/TKO,100,22,0,122
Yoel Romero,2018-06-09,Robert Whittaker,Decision - Split,0,0,25,25
Yoel Romero,2015-06-27,Lyoto Machida,KO/TKO,100,11,25,136
Yoel Romero,2014-09-27,Tim Kennedy,KO/TKO,100,9,0,109
Yoel Romero,2019-08-17,Paulo Costa,Decision - Unanimous,0,7,0,7
Yoel Romero,2017-07-08,Robert Whittaker,Decision - Unanimous,0,0,25,25
Mike Wilkinson,2012-12-14,Brendan Loughnane,Decision - Unanimous,80,0,0,80
Mike Wilkinson,2016-02-27,Makwan Amirkhani,Decision - Unanimous,0,0,0,0
Mike Wilkinson,2013-06-08,Rony Jason,Submission,0,0,0,0
Mike Wilkinson,2014-10-04,Niklas Backstrom,KO/TKO,100,0,0,100
Brendan Loughnane,2012-12-14,Mike Wilkinson,Decision - Unanimous,0,21,0,21
Brendan Loughnane,2019-06-18,Bill Algeo,Decision - Unanimous,80,0,0,80
Jonathan Pearce,2019-07-09,Jacob Rosales,KO/TKO,100,62,0,162
Jonathan Pearce,2022-12-03,Darren Elkins,Decision - Unanimous,80,53,0,133
Jonathan Pearce,2024-04-27,David Onama,Decision - Unanimous,0,0,0,0
Jonathan Pearce,2021-09-25,Omar Morales,Submission,90,0,0,90
Jonathan Pearce,2024-10-12,Pat Sabatini,Submission,0,0,0,0
Jonathan Pearce,2023-11-18,Joanderson Brito,Submission,0,6,0,6
Jonathan Pearce,2019-10-18,Joe Lauzon,KO/TKO,0,0,0,0
Jonathan Pearce,2022-02-19,Christian Rodriguez,Decision - Unanimous,80,0,0,80
Jonathan Pearce,2020-11-28,Kai Kamaka,KO/TKO,100,4,0,104
Jonathan Pearce,2022-07-23,Makwan Amirkhani,KO/TKO,100,79,0,179
Jacob Rosales,2019-07-09,Jonathan Pearce,KO/TKO,0,0,0,0
Jacob Rosales,2021-09-21,Victor Martinez,Decision - Unanimous,0,0,0,0
Deron Winn,2019-06-22,Eric Spicely,Decision - Unanimous,80,61,0,141
Deron Winn,2020-12-19,Antonio Arroyo,Decision - Unanimous,80,0,0,80
Deron Winn,2020-03-07,Gerald Meerschaert,Submission,0,0,0,0
Deron Winn,2019-10-18,Darren Stewart,Decision - Split,0,0,0,0
Deron Winn,2022-06-18,Phil Hawes,KO/TKO,0,0,0,0
Eric Spicely,2019-06-22,Deron Winn,Decision - Unanimous,0,0,0,0
Eric Spicely,2016-09-24,Thiago Santos,Submission,90,3,0,93
Eric Spicely,2017-12-01,Gerald Meerschaert,KO/TKO,0,0,0,0
Eric Spicely,2017-01-28,Alessio Di Chirico,Submission,90,0,0,90
Eric Spicely,2017-06-03,Antonio Carlos Junior,Submission,0,5,0,5
Eric Spicely,2016-07-13,Sam Alvey,Submission,0,0,0,0
Eric Spicely,2018-05-27,Darren Stewart,KO/TKO,0,0,0,0
Shamil Gamzatov,2019-11-09,Klidson Abreu,Decision - Split,70,32,0,102
Shamil Gamzatov,2021-10-30,Michal Oleksiejczuk,KO/TKO,0,3,0,3
Klidson Abreu,2019-11-09,Shamil Gamzatov,Decision - Split,0,0,0,0
Klidson Abreu,2019-07-20,Sam Alvey,Decision - Unanimous,80,8,0,88
Klidson Abreu,2019-02-23,Magomed Ankalaev,Decision - Unanimous,0,0,0,0
Kyoji Horiguchi,2015-01-03,Louis Gaudinot,Decision - Unanimous,80,21,0,101
Kyoji Horiguchi,2013-10-19,Dustin Pague,KO/TKO,100,21,0,121
Kyoji Horiguchi,2016-05-08,Neil Seery,Decision - Unanimous,80,32,0,112
Kyoji Horiguchi,2014-09-20,Jon Delos Reyes,KO/TKO,100,18,0,118
Kyoji Horiguchi,2016-11-19,Ali Bagautinov,Decision - Unanimous,80,19,0,99
Kyoji Horiguchi,2014-05-10,Darrell Montague,Decision - Unanimous,80,39,0,119
Kyoji Horiguchi,2015-04-25,Demetrious Johnson,Submission,0,0,25,25
Kyoji Horiguchi,2015-09-26,Chico Camus,Decision - Unanimous,80,15,0,95
Louis Gaudinot,2015-01-03,Kyoji Horiguchi,Decision - Unanimous,0,0,0,0
Louis Gaudinot,2012-05-05,John Lineker,Submission,90,0,0,90
Louis Gaudinot,2013-08-31,Tim Elliott,Decision - Unanimous,0,0,0,0
Louis Gaudinot,2011-12-03,Johnny Bedford,KO/TKO,0,0,0,0
Sam Hughes,2024-08-03,Viktoriia Dudakova,Decision - Split,70,36,0,106
Sam Hughes,2021-05-01,Loma Lookboonmee,Decision - Unanimous,0,0,0,0
Sam Hughes,2022-05-21,Elise Reed,KO/TKO,100,26,0,126
Sam Hughes,2021-11-20,Luana Pinheiro,Decision - Unanimous,0,0,0,0
Sam Hughes,2024-02-24,Yazmin Jauregui,Decision - Unanimous,0,0,0,0
Sam Hughes,2022-10-15,Piera Rodriguez,Decision - Unanimous,0,0,0,0
Sam Hughes,2020-12-12,Tecia Pennington,TKO - Doctor's Stoppage,0,0,0,0
Sam Hughes,2023-04-08,Jaqueline Amorim,Decision - Unanimous,80,34,0,114
Sam Hughes,2022-04-16,Istela Nunes,Decision - Majority,75,0,0,75
Viktoriia Dudakova,2024-08-03,Sam Hughes,Decision - Split,0,0,0,0
Viktoriia Dudakova,2023-07-15,Istela Nunes,KO/TKO,100,1,0,101
Viktoriia Dudakova,2022-08-30,Maria Silva,Decision - Unanimous,80,0,0,80
Viktoriia Dudakova,2023-10-21,Jinh Yu Frey,Decision - Unanimous,80,27,0,107
Chris Camozzi,2010-10-23,Dongi Yang,Decision - Split,70,23,0,93
Chris Camozzi,2012-06-22,Nick Catone,TKO - Doctor's Stoppage,0,20,0,20
Chris Camozzi,2015-04-18,Jacare Souza,Submission,0,1,0,1
Chris Camozzi,2011-10-29,Francis Carmont,Decision - Unanimous,0,0,0,0
Chris Camozzi,2013-11-06,Lorenz Larkin,Decision - Unanimous,0,18,0,18
Chris Camozzi,2012-10-13,Luiz Cane,Decision - Unanimous,80,42,0,122
Chris Camozzi,2010-06-19,James Hammortree,Decision - Unanimous,80,33,0,113
Chris Camozzi,2017-05-28,Trevor Smith,Decision - Unanimous,0,0,0,0
Chris Camozzi,2013-05-18,Jacare Souza,Submission,0,0,0,0
Chris Camozzi,2016-02-21,Joe Riggs,KO/TKO,100,11,0,111
Chris Camozzi,2014-09-05,Rafael Natal,Decision - Split,0,31,0,31
Chris Camozzi,2012-01-28,Dustin Jacoby,Submission,90,14,0,104
Chris Camozzi,2013-03-16,Nick Ring,Decision - Split,70,0,0,70
Chris Camozzi,2016-08-06,Thales Leites,Submission,0,0,0,0
Chris Camozzi,2011-02-26,Kyle Noke,Submission,0,0,0,0
Chris Camozzi,2016-11-26,Daniel Kelly,Decision - Unanimous,0,17,0,17
Chris Camozzi,2016-05-29,Vitor Miranda,Decision - Unanimous,80,16,0,96
Chris Camozzi,2014-07-05,Bruno Santos,Decision - Split,0,17,0,17
Chris Camozzi,2015-08-08,Tom Watson,Decision - Unanimous,80,5,0,85
Dongi Yang,2010-10-23,Chris Camozzi,Decision - Split,0,0,0,0
Dongi Yang,2011-03-03,Rob Kimmons,KO/TKO,100,56,0,156
Dongi Yang,2012-05-15,Brad Tavares,Decision - Unanimous,0,0,0,0
Dongi Yang,2015-11-28,Jake Collier,KO/TKO,100,7,0,107
Dongi Yang,2011-09-17,Court McGee,Decision - Unanimous,0,0,0,0
Guido Cannetti,2015-08-01,Hugo Viana,Decision - Unanimous,80,19,0,99
Guido Cannetti,2018-05-19,Diego Rivas,Decision - Unanimous,80,3,0,83
Guido Cannetti,2021-08-28,Mana Martinez,Decision - Split,0,0,0,0
Guido Cannetti,2018-11-17,Marlon Vera,Submission,0,0,0,0
Guido Cannetti,2022-03-12,Kris Moutinho,KO/TKO,100,17,0,117
Guido Cannetti,2014-11-15,Henry Briones,Submission,0,3,0,3
Guido Cannetti,2022-10-01,Randy Costa,Submission,90,6,0,96
Guido Cannetti,2020-03-07,Batgerel Danaa,KO/TKO,0,0,0,0
Guido Cannetti,2023-03-11,Mario Bautista,Submission,0,0,0,0
Guido Cannetti,2018-01-14,Kyung Ho Kang,Submission,0,16,0,16
Hugo Viana,2015-08-01,Guido Cannetti,Decision - Unanimous,0,0,0,0
Hugo Viana,2014-01-25,Ramiro Hernandez,Decision - Unanimous,80,39,0,119
Hugo Viana,2013-04-20,TJ Dillashaw,KO/TKO,0,0,0,0
Hugo Viana,2012-12-15,Reuben Duran,KO/TKO,100,14,0,114
Hugo Viana,2014-07-16,Aljamain Sterling,KO/TKO,0,0,0,0
Hugo Viana,2012-06-23,John Teixeira,Decision - Split,70,13,0,83
Luis Henrique,2015-12-19,Francis Ngannou,KO/TKO,0,0,0,0
Luis Henrique,2016-11-19,Christian Colombo,Submission,90,28,0,118
Luis Henrique,2017-09-09,Arjan Bhullar,Decision - Unanimous,0,8,0,8
Luis Henrique,2016-07-23,Dmitrii Smoliakov,Submission,90,6,0,96
Luis Henrique,2017-03-04,Marcin Tybura,KO/TKO,0,0,0,0
Luis Henrique,2018-09-22,Ryan Spann,Decision - Unanimous,0,0,0,0
Dimitiri Wanderley,2006-04-29,Lyoto Machida,KO/TKO,0,0,0,0
Jim Alers,2014-04-11,Alan Omer,Decision - Split,70,0,0,70
Jim Alers,2015-02-14,Chas Skelly,KO/TKO,0,0,0,0
Jim Alers,2016-07-23,Jason Knight,Decision - Split,0,0,0,0
Alan Omer,2014-04-11,Jim Alers,Decision - Split,0,22,0,22
Alan Omer,2015-06-20,Arnold Allen,Submission,0,12,0,12
Daniel Roberts,2010-10-23,Mike Guymon,Submission,90,2,0,92
Daniel Roberts,2010-03-21,John Howard,KO/TKO,0,1,0,1
Daniel Roberts,2011-04-30,Claude Patrick,Decision - Unanimous,0,0,0,0
Daniel Roberts,2012-01-20,Charlie Brenneman,Decision - Unanimous,0,0,0,0
Daniel Roberts,2010-07-03,Forrest Petz,Decision - Split,70,0,0,70
Daniel Roberts,2011-06-26,Rich Attonito,Decision - Unanimous,0,0,0,0
Daniel Roberts,2011-01-01,Greg Soto,Submission,90,0,0,90
Mike Guymon,2010-10-23,Daniel Roberts,Submission,0,0,0,0
Mike Guymon,2011-01-22,DaMarques Johnson,Submission,0,0,0,0
Mike Guymon,2010-01-11,Rory MacDonald,Submission,0,0,0,0
Mike Guymon,2010-05-08,Yoshiyuki Yoshida,Decision - Unanimous,80,52,0,132
Carl Seumanutafa,2009-05-15,Lavar Johnson,KO/TKO,0,0,0,0
Chad Laprise,2016-03-19,Ross Pearson,Decision - Split,0,26,0,26
Chad Laprise,2018-12-08,Dhiego Lima,KO/TKO,0,3,0,3
Chad Laprise,2015-08-23,Francisco Trinaldo,KO/TKO,0,0,0,0
Chad Laprise,2017-12-16,Galore Bofando,KO/TKO,100,7,0,107
Chad Laprise,2015-04-25,Bryan Barberena,Decision - Unanimous,80,0,0,80
Chad Laprise,2018-05-19,Vicente Luque,KO/TKO,0,0,0,0
Chad Laprise,2014-10-04,Yosdenis Cedeno,Decision - Unanimous,80,18,0,98
Chad Laprise,2017-07-08,Brian Camozzi,KO/TKO,100,29,0,129
Chad Laprise,2014-04-16,Olivier Aubin-Mercier,Decision - Split,70,26,0,96
Chad Laprise,2016-08-27,Thibault Gouti,KO/TKO,100,13,0,113
Ikuhisa Minowa,2008-12-31,Errol Zimmerman,Submission,90,0,0,90
Ikuhisa Minowa,2003-12-31,Quinton Jackson,KO/TKO,0,0,0,0
Ikuhisa Minowa,2006-04-02,Paulo Cesar Silva,KO/TKO,100,6,0,106
Ikuhisa Minowa,2009-12-31,Rameau Thierry Sokoudjou,KO/TKO,100,0,0,100
Ikuhisa Minowa,2010-03-22,Jimmy Ambriz,Submission,90,2,0,92
Ikuhisa Minowa,2005-05-22,Phil Baroni,KO/TKO,0,0,0,0
Ikuhisa Minowa,2008-09-23,Masakatsu Funaki,Submission,0,0,0,0
Ikuhisa Minowa,2010-09-25,Satoshi Ishii,Decision - Unanimous,0,3,0,3
Ikuhisa Minowa,2010-12-31,Hiroshi Izumi,KO/TKO,0,0,0,0
Ikuhisa Minowa,2005-09-25,Murilo Bustamante,KO/TKO,0,0,0,0
Ikuhisa Minowa,2010-05-29,Imani Lee,Submission,90,4,0,94
Ikuhisa Minowa,2004-12-31,Stefan Leko,Submission,90,0,0,90
Ikuhisa Minowa,2005-09-25,Phil Baroni,Decision - Unanimous,80,0,0,80
Ikuhisa Minowa,2005-07-17,Kimo Leopoldo,Submission,90,2,0,92
Ikuhisa Minowa,2011-09-24,Baru Harn,Submission,90,0,0,90
Ikuhisa Minowa,2000-04-14,Joe Slick,TKO - Doctor's Stoppage,0,0,0,0
Ikuhisa Minowa,2006-12-31,Kiyoshi Tamura,KO/TKO,0,1,0,1
Ikuhisa Minowa,2008-03-15,Lee Kwan Bum,Submission,90,0,0,90
Ikuhisa Minowa,2009-10-06,Hong Man Choi,Submission,90,1,0,91
Ikuhisa Minowa,2004-02-15,Wanderlei Silva,KO/TKO,0,0,0,0
Ikuhisa Minowa,2006-05-05,Mirko Filipovic,KO/TKO,0,0,0,0
Ikuhisa Minowa,2004-05-23,Ryan Gracie,Decision - Split,0,3,0,3
Ikuhisa Minowa,2005-12-31,Kazushi Sakuraba,Submission,0,0,0,0
Ikuhisa Minowa,2005-04-03,Gilbert Yvel,Submission,90,0,0,90
Ikuhisa Minowa,2006-08-27,Eric Esch,Submission,90,6,0,96
Ikuhisa Minowa,2004-07-19,Kenichi Yamamoto,KO/TKO,100,16,0,116
Ikuhisa Minowa,2006-11-05,Mike Polchlopek,Decision - Unanimous,80,0,0,80
Ikuhisa Minowa,2008-04-29,Taiei Kin,Decision - Unanimous,0,0,0,0
Ikuhisa Minowa,2009-04-05,Katsuyori Shibata,Decision - Unanimous,0,0,0,0
Ikuhisa Minowa,2004-10-14,Ryuki Ueyama,Decision - Split,70,17,0,87
Ikuhisa Minowa,2009-05-26,Bob Sapp,Submission,90,0,0,90
Errol Zimmerman,2008-12-31,Ikuhisa Minowa,Submission,0,3,0,3
Volkan Oezdemir,2019-08-10,Ilir Latifi,KO/TKO,100,46,0,146
Volkan Oezdemir,2022-10-22,Nikita Krylov,Decision - Unanimous,0,0,0,0
Volkan Oezdemir,2020-07-11,Jiri Prochazka,KO/TKO,0,8,0,8
Volkan Oezdemir,2018-01-20,Daniel Cormier,KO/TKO,0,6,25,31
Volkan Oezdemir,2024-06-22,Johnny Walker,KO/TKO,100,22,0,122
Volkan Oezdemir,2018-10-27,Anthony Smith,Submission,0,14,25,39
Volkan Oezdemir,2019-03-16,Dominick Reyes,Decision - Split,0,0,0,0
Volkan Oezdemir,2017-05-28,Misha Cirkunov,KO/TKO,100,0,0,100
Volkan Oezdemir,2021-10-30,Magomed Ankalaev,Decision - Unanimous,0,0,0,0
Volkan Oezdemir,2023-09-02,Bogdan Guskov,Submission,90,18,0,108
Volkan Oezdemir,2017-07-29,Jimi Manuwa,KO/TKO,100,10,0,110
Volkan Oezdemir,2022-07-23,Paul Craig,Decision - Unanimous,80,39,0,119
Volkan Oezdemir,2017-02-04,Ovince Saint Preux,Decision - Split,70,6,0,76
Volkan Oezdemir,2019-12-21,Aleksandar Rakic,Decision - Split,70,0,0,70
Volkan Oezdemir,2024-11-23,Carlos Ulberg,Decision - Unanimous,0,0,0,0
Russell Doane,2014-01-04,Leandro Issa,Submission,90,26,0,116
Russell Doane,2015-07-12,Jerrod Sanders,Decision - Unanimous,0,0,0,0
Russell Doane,2018-02-24,Rani Yahya,Submission,0,0,0,0
Russell Doane,2016-07-07,Pedro Munhoz,Submission,0,4,0,4
Russell Doane,2014-07-05,Marcus Brimage,Decision - Split,70,0,0,70
Russell Doane,2014-09-13,Iuri Alcantara,Decision - Unanimous,0,0,0,0
Russell Doane,2017-06-17,Kwan Ho Kwak,KO/TKO,100,7,0,107
Russell Doane,2016-10-08,Mirsad Bektic,Submission,0,2,0,2
Junior Tafa,2023-08-26,Parker Porter,KO/TKO,100,6,0,106
Junior Tafa,2024-08-17,Valter Walker,Submission,0,1,0,1
Junior Tafa,2023-04-22,Mohammed Usman,Decision - Unanimous,0,15,0,15
Junior Tafa,2024-10-12,Sean Sharaf,KO/TKO,100,18,0,118
Junior Tafa,2024-02-17,Marcos Rogerio de Lima,KO/TKO,0,0,0,0
Parker Porter,2023-08-26,Junior Tafa,KO/TKO,0,0,0,0
Parker Porter,2023-02-11,Justin Tafa,KO/TKO,0,0,0,0
Parker Porter,2022-02-19,Alan Baudot,Decision - Unanimous,80,0,0,80
Parker Porter,2021-08-21,Chase Sherman,Decision - Unanimous,80,32,0,112
Parker Porter,2020-11-28,Josh Parisian,Decision - Unanimous,80,12,0,92
Parker Porter,2020-08-15,Chris Daukaus,KO/TKO,0,0,0,0
Parker Porter,2023-05-06,Braxton Smith,KO/TKO,100,11,0,111
Parker Porter,2022-05-21,Jailton Almeida,Submission,0,0,0,0
Darrell Horcher,2017-06-25,Devin Powell,Decision - Split,70,0,0,70
Darrell Horcher,2018-11-30,Roosevelt Roberts,Submission,0,0,0,0
Darrell Horcher,2016-04-16,Khabib Nurmagomedov,KO/TKO,0,0,0,0
Darrell Horcher,2017-12-09,Scott Holtzman,Decision - Unanimous,0,0,0,0
Devin Powell,2017-06-25,Darrell Horcher,Decision - Split,0,6,0,6
Devin Powell,2017-01-15,Drakkar Klose,Decision - Unanimous,0,0,0,0
Devin Powell,2018-11-17,Jesus Pinedo,Decision - Unanimous,0,0,0,0
Devin Powell,2018-07-28,Alvaro Herrera Mendoza,KO/TKO,100,5,0,105
Jamahal Hill,2022-02-19,Johnny Walker,KO/TKO,100,0,25,125
Jamahal Hill,2024-04-13,Alex Pereira,KO/TKO,0,0,25,25
Jamahal Hill,2023-01-21,Glover Teixeira,Decision - Unanimous,80,157,25,262
Jamahal Hill,2019-07-23,Alexander Poppeck,KO/TKO,100,55,0,155
Jamahal Hill,2021-12-04,Jimmy Crute,KO/TKO,100,0,0,100
Jamahal Hill,2022-08-06,Thiago Santos,KO/TKO,100,36,25,161
Jamahal Hill,2020-12-05,Ovince Saint Preux,KO/TKO,100,32,0,132
Jamahal Hill,2020-01-25,Darko Stosic,Decision - Unanimous,80,70,0,150
Jamahal Hill,2021-06-12,Paul Craig,KO/TKO,0,0,0,0
Johnny Walker,2022-02-19,Jamahal Hill,KO/TKO,0,6,25,31
Johnny Walker,2024-01-13,Magomed Ankalaev,KO/TKO,0,0,25,25
Johnny Walker,2022-09-10,Ion Cutelaba,Submission,90,0,0,90
Johnny Walker,2023-05-13,Anthony Smith,Decision - Unanimous,80,54,0,134
Johnny Walker,2019-11-02,Corey Anderson,KO/TKO,0,0,0,0
Johnny Walker,2024-06-22,Volkan Oezdemir,KO/TKO,0,0,0,0
Johnny Walker,2019-03-02,Misha Cirkunov,KO/TKO,100,3,0,103
Johnny Walker,2020-03-14,Nikita Krylov,Decision - Unanimous,0,0,0,0
Johnny Walker,2018-11-17,Khalil Rountree Jr.,KO/TKO,100,6,0,106
Johnny Walker,2019-02-02,Justin Ledet,KO/TKO,100,7,0,107
Johnny Walker,2021-10-02,Thiago Santos,Decision - Unanimous,0,4,25,29
Johnny Walker,2018-08-11,Henrique da Silva,Decision - Unanimous,80,28,0,108
Johnny Walker,2023-01-21,Paul Craig,KO/TKO,100,13,0,113
Johnny Walker,2020-09-19,Ryan Spann,KO/TKO,100,19,0,119
Cynthia Calvillo,2017-12-30,Carla Esparza,Decision - Unanimous,0,0,0,0
Cynthia Calvillo,2021-09-25,Jessica Andrade,KO/TKO,0,0,0,0
Cynthia Calvillo,2021-11-13,Andrea Lee,KO/TKO,0,0,0,0
Cynthia Calvillo,2020-06-13,Jessica Eye,Decision - Unanimous,80,43,25,148
Cynthia Calvillo,2017-07-16,Joanne Wood,Decision - Unanimous,80,0,0,80
Cynthia Calvillo,2018-11-17,Poliana Botelho,Submission,90,16,0,106
Cynthia Calvillo,2022-08-13,Nina Nunes,Decision - Split,0,9,0,9
Cynthia Calvillo,2023-04-08,Loopy Godinez,Decision - Split,0,17,0,17
Cynthia Calvillo,2017-04-08,Pearl Gonzalez,Submission,90,13,0,103
Cynthia Calvillo,2017-03-04,Amanda Cooper,Submission,90,6,0,96
Cynthia Calvillo,2019-02-17,Cortney Casey,Decision - Unanimous,80,9,0,89
Cynthia Calvillo,2020-11-21,Katlyn Cerminara,Decision - Unanimous,0,0,0,0
Kamaru Usman,2018-01-14,Emil Meek,Decision - Unanimous,80,20,0,100
Kamaru Usman,2022-08-20,Leon Edwards,KO/TKO,0,28,25,53
Kamaru Usman,2023-10-21,Khamzat Chimaev,Decision - Majority,0,0,0,0
Kamaru Usman,2016-07-23,Alexander Yakovlev,Decision - Unanimous,80,33,0,113
Kamaru Usman,2015-07-12,Hayder Hassan,Submission,90,12,0,102
Kamaru Usman,2020-07-11,Jorge Masvidal,Decision - Unanimous,80,28,25,133
Kamaru Usman,2023-03-18,Leon Edwards,Decision - Majority,0,0,25,25
Kamaru Usman,2021-02-13,Gilbert Burns,KO/TKO,100,38,25,163
Kamaru Usman,2017-04-08,Sean Strickland,Decision - Unanimous,80,63,0,143
Kamaru Usman,2016-11-19,Warlley Alves,Decision - Unanimous,80,46,0,126
Kamaru Usman,2019-03-02,Tyron Woodley,Decision - Unanimous,80,107,25,212
Kamaru Usman,2019-12-14,Colby Covington,KO/TKO,100,32,25,157
Kamaru Usman,2021-04-24,Jorge Masvidal,KO/TKO,100,0,25,125
Kamaru Usman,2017-09-16,Sergio Moraes,KO/TKO,100,3,0,103
Kamaru Usman,2018-05-19,Demian Maia,Decision - Unanimous,80,39,25,144
Kamaru Usman,2021-11-06,Colby Covington,Decision - Unanimous,80,16,25,121
Kamaru Usman,2015-12-19,Leon Edwards,Decision - Unanimous,80,22,0,102
Kamaru Usman,2018-11-30,Rafael Dos Anjos,Decision - Unanimous,80,68,25,173
Emil Meek,2018-01-14,Kamaru Usman,Decision - Unanimous,0,0,0,0
Emil Meek,2018-07-22,Bartosz Fabinski,Decision - Unanimous,0,0,0,0
Emil Meek,2016-12-10,Jordan Mein,Decision - Unanimous,80,16,0,96
Emil Meek,2020-02-22,Jake Matthews,Decision - Unanimous,0,17,0,17
Justin Levens,2006-04-15,Evan Tanner,Submission,0,0,0,0
Justin Levens,2006-10-12,Justin Hawes,KO/TKO,100,5,0,105
Justin Levens,2006-06-28,Jorge Santiago,KO/TKO,0,0,0,0
Justin Levens,2006-01-13,Scott Smith,KO/TKO,0,0,0,0
Andre Petroski,2024-09-07,Dylan Budka,Decision - Unanimous,80,6,0,86
Andre Petroski,2024-07-13,Josh Fremd,Decision - Unanimous,80,0,0,80
Andre Petroski,2024-03-30,Jacob Malkoun,KO/TKO,0,0,0,0
Andre Petroski,2022-05-14,Nick Maximov,Submission,90,0,0,90
Andre Petroski,2021-08-28,Micheal Gillmore,KO/TKO,100,15,0,115
Andre Petroski,2023-08-19,Gerald Meerschaert,Decision - Split,70,0,0,70
Andre Petroski,2023-10-14,Michel Pereira,KO/TKO,0,0,0,0
Andre Petroski,2022-11-12,Wellington Turman,Decision - Unanimous,80,1,0,81
Andre Petroski,2021-10-30,Hu Yaozong,Submission,90,47,0,137
Dylan Budka,2024-09-07,Andre Petroski,Decision - Unanimous,0,0,0,0
Dylan Budka,2023-09-05,Chad Hanekom,Decision - Unanimous,80,11,0,91
Dylan Budka,2024-04-06,Cesar Almeida,KO/TKO,0,0,0,0
Bobby Voelker,2013-07-27,Robbie Lawler,KO/TKO,0,0,0,0
Bobby Voelker,2013-03-16,Patrick Cote,Decision - Unanimous,0,11,0,11
Bobby Voelker,2011-07-22,Roger Bowling,KO/TKO,100,0,0,100
Bobby Voelker,2014-06-07,Lance Benoist,Decision - Unanimous,0,0,0,0
Bobby Voelker,2013-12-28,William Macario,Decision - Unanimous,0,0,0,0
Kazuhiro Nakamura,2005-06-26,Wanderlei Silva,KO/TKO,0,0,0,0
Kazuhiro Nakamura,2006-09-10,Yoshihiro Nakao,Decision - Unanimous,80,31,0,111
Kazuhiro Nakamura,2006-07-01,Evangelista Santos,Submission,90,12,0,102
Kazuhiro Nakamura,2004-02-01,Dos Caras Jr.,Decision - Unanimous,80,6,0,86
Kazuhiro Nakamura,2004-10-31,Dan Henderson,KO/TKO,0,0,0,0
Kazuhiro Nakamura,2003-03-16,Rogerio Nogueira,Submission,0,0,0,0
Kazuhiro Nakamura,2003-10-05,Daniel Gracie,Decision - Unanimous,80,11,0,91
Kazuhiro Nakamura,2005-04-23,Kevin Randleman,Decision - Unanimous,80,21,0,101
Kazuhiro Nakamura,2010-07-10,Karl Amoussou,Decision - Unanimous,80,18,0,98
Kazuhiro Nakamura,2005-08-28,Igor Vovchanchyn,Decision - Unanimous,80,0,0,80
Kazuhiro Nakamura,2007-09-22,Lyoto Machida,Decision - Unanimous,0,0,0,0
Kazuhiro Nakamura,2005-12-31,Yuki Kondo,Decision - Unanimous,80,16,0,96
Kazuhiro Nakamura,2011-09-24,Gerald Harris,Decision - Split,0,0,0,0
Kazuhiro Nakamura,2006-02-26,Josh Barnett,Submission,0,0,0,0
Kazuhiro Nakamura,2006-12-31,Mauricio Rua,Decision - Unanimous,0,0,0,0
Kazuhiro Nakamura,2004-08-15,Murilo Bustamante,Decision - Unanimous,80,13,0,93
Kazuhiro Nakamura,2006-10-21,Travis Galbraith,KO/TKO,100,0,0,100
Kazuhiro Nakamura,2004-07-19,Rogerio Nogueira,Decision - Split,0,0,0,0
Kazuhiro Nakamura,2005-02-20,Stefan Leko,KO/TKO,100,9,0,109
Kazuhiro Nakamura,2004-05-23,Chalid Arrab,Submission,90,0,0,90
Kazuhiro Nakamura,2008-05-24,Rameau Thierry Sokoudjou,KO/TKO,0,0,0,0
Marcin Tybura,2018-02-18,Derrick Lewis,KO/TKO,0,7,0,7
Marcin Tybura,2021-06-05,Walt Harris,KO/TKO,100,0,0,100
Marcin Tybura,2016-04-10,Timothy Johnson,Decision - Unanimous,0,3,0,3
Marcin Tybura,2020-02-29,Serghei Spivac,Decision - Unanimous,80,17,0,97
Marcin Tybura,2022-08-20,Alexandr Romanov,Decision - Majority,75,7,0,82
Marcin Tybura,2020-12-19,Greg Hardy,KO/TKO,100,1,0,101
Marcin Tybura,2019-09-14,Augusto Sakai,KO/TKO,0,0,0,0
Marcin Tybura,2023-07-22,Tom Aspinall,KO/TKO,0,0,25,25
Marcin Tybura,2024-03-16,Tai Tuivasa,Submission,90,12,25,127
Marcin Tybura,2018-07-22,Stefan Struve,Decision - Unanimous,80,10,0,90
Marcin Tybura,2023-02-04,Blagoy Ivanov,Decision - Unanimous,80,6,0,86
Marcin Tybura,2024-08-10,Serghei Spivac,Submission,0,0,25,25
Marcin Tybura,2024-11-16,Jhonata Diniz,TKO - Doctor's Stoppage,0,20,0,20
Marcin Tybura,2017-11-18,Fabricio Werdum,Decision - Unanimous,0,0,25,25
Marcin Tybura,2017-03-04,Luis Henrique,KO/TKO,100,36,0,136
Marcin Tybura,2016-08-06,Viktor Pesta,KO/TKO,100,12,0,112
Marcin Tybura,2017-06-17,Andrei Arlovski,Decision - Unanimous,80,23,0,103
Marcin Tybura,2020-10-10,Ben Rothwell,Decision - Unanimous,80,5,0,85
Marcin Tybura,2021-10-30,Alexander Volkov,Decision - Unanimous,0,0,0,0
Marcin Tybura,2020-07-11,Maxim Grishin,Decision - Unanimous,80,6,0,86
Marcin Tybura,2019-04-20,Shamil Abdurakhimov,KO/TKO,0,0,0,0
Jake O'Brien,2006-11-18,Josh Shockman,Decision - Unanimous,80,0,0,80
Jake O'Brien,2008-03-01,Andrei Arlovski,KO/TKO,0,0,0,0
Jake O'Brien,2007-01-25,Heath Herring,Decision - Unanimous,80,2,0,82
Jake O'Brien,2009-07-11,Jon Jones,Submission,0,0,0,0
Jake O'Brien,2010-07-10,Gegard Mousasi,Submission,0,0,0,0
Jake O'Brien,2008-07-19,Cain Velasquez,KO/TKO,0,0,0,0
Jake O'Brien,2006-08-17,Kristof Midoux,KO/TKO,100,23,0,123
Jake O'Brien,2009-01-31,Christian Wellisch,Decision - Split,70,0,0,70
Josh Shockman,2006-11-18,Jake O'Brien,Decision - Unanimous,0,0,0,0
Don Frye,1996-12-07,Mark Hall,Submission,90,0,0,90
Don Frye,2001-09-24,Gilbert Yvel,DQ,0,0,0,0
Don Frye,2003-06-08,Mark Coleman,Decision - Unanimous,0,0,0,0
Don Frye,1996-07-12,Mark Hall,KO/TKO,100,25,0,125
Don Frye,1996-05-17,Amaury Bitetti,KO/TKO,100,44,0,144
Don Frye,1996-12-07,David Abbott,Submission,90,0,0,90
Don Frye,1996-07-12,Brian Johnston,KO/TKO,100,0,0,100
Don Frye,1996-12-07,Gary Goodridge,Submission,90,2,0,92
Don Frye,2003-12-31,Gary Goodridge,KO/TKO,0,0,0,0
Don Frye,1996-02-16,Sam Adkins,TKO - Doctor's Stoppage,0,5,0,5
Don Frye,1996-02-16,Gary Goodridge,KO/TKO,100,10,0,110
Don Frye,2007-04-08,James Thompson,KO/TKO,0,0,0,0
Don Frye,1996-07-12,Mark Coleman,KO/TKO,0,0,0,0
Don Frye,2002-02-24,Ken Shamrock,Decision - Split,70,22,0,92
Don Frye,2002-06-23,Yoshihiro Takayama,KO/TKO,100,29,0,129
Don Frye,1996-02-16,Thomas Ramirez,KO/TKO,100,2,0,102
Don Frye,2002-11-24,Hidehiko Yoshida,Submission,0,0,0,0
Ryo Chonan,2006-06-04,Joey Villasenor,Decision - Split,70,18,0,88
Ryo Chonan,2008-12-27,Brad Blackburn,Decision - Unanimous,0,0,0,0
Ryo Chonan,2006-08-27,Paulo Filho,Submission,0,0,0,0
Ryo Chonan,2004-10-14,Carlos Newton,Decision - Unanimous,80,45,0,125
Ryo Chonan,2005-05-22,Antonio Schembri,Decision - Unanimous,80,27,0,107
Ryo Chonan,2008-09-06,Roan Carneiro,Decision - Split,70,5,0,75
Ryo Chonan,2010-03-22,Andrews Nakahara,Decision - Unanimous,80,17,0,97
Ryo Chonan,2011-12-31,Hayato Sakurai,Decision - Unanimous,0,0,0,0
Ryo Chonan,2005-09-25,Dan Henderson,KO/TKO,0,0,0,0
Ryo Chonan,2004-05-23,Ricardo Almeida,Decision - Unanimous,0,0,0,0
Ryo Chonan,2009-04-18,TJ Grant,Decision - Split,0,0,0,0
Ryo Chonan,2007-11-17,Karo Parisyan,Decision - Unanimous,0,0,0,0
Ryo Chonan,2005-07-17,Phil Baroni,KO/TKO,0,3,0,3
Ryo Chonan,2004-12-31,Anderson Silva,Submission,90,0,0,90
Joey Villasenor,2006-06-04,Ryo Chonan,Decision - Split,0,0,0,0
Joey Villasenor,2010-05-15,Jacare Souza,Decision - Unanimous,0,0,0,0
Joey Villasenor,2008-03-29,Ryan Jensen,KO/TKO,100,0,0,100
Joey Villasenor,2008-05-31,Phil Baroni,KO/TKO,100,7,0,107
Joey Villasenor,2006-10-21,Robbie Lawler,KO/TKO,0,0,0,0
Joey Villasenor,2007-06-22,Murilo Rua,KO/TKO,0,0,25,25
Elias Theodorou,2018-05-27,Trevor Smith,Decision - Unanimous,80,36,0,116
Elias Theodorou,2016-06-18,Sam Alvey,Decision - Unanimous,80,13,0,93
Elias Theodorou,2019-05-04,Derek Brunson,Decision - Unanimous,0,9,0,9
Elias Theodorou,2014-10-04,Bruno Santos,Decision - Unanimous,80,27,0,107
Elias Theodorou,2018-12-08,Eryk Anders,Decision - Split,70,27,0,97
Elias Theodorou,2017-07-07,Brad Tavares,Decision - Unanimous,0,3,0,3
Elias Theodorou,2017-11-18,Daniel Kelly,Decision - Unanimous,80,76,0,156
Elias Theodorou,2015-12-10,Thiago Santos,Decision - Unanimous,0,0,0,0
Elias Theodorou,2015-03-14,Roger Narvaez,KO/TKO,100,23,0,123
Elias Theodorou,2014-04-16,Sheldon Westcott,KO/TKO,100,60,0,160
Elias Theodorou,2017-02-19,Cezar Ferreira,Decision - Unanimous,80,27,0,107
Trevor Smith,2018-05-27,Elias Theodorou,Decision - Unanimous,0,0,0,0
Trevor Smith,2016-08-06,Joseph Gigliotti,Decision - Unanimous,80,27,0,107
Trevor Smith,2014-07-19,Tor Troeng,Decision - Unanimous,80,16,0,96
Trevor Smith,2013-07-27,Ed Herman,Decision - Split,0,14,0,14
Trevor Smith,2018-12-15,Zak Cummings,Decision - Unanimous,0,0,0,0
Trevor Smith,2012-01-07,Gian Villante,KO/TKO,0,0,0,0
Trevor Smith,2013-01-12,Tim Kennedy,Submission,0,0,0,0
Trevor Smith,2017-05-28,Chris Camozzi,Decision - Unanimous,80,29,0,109
Trevor Smith,2014-04-11,Thales Leites,KO/TKO,0,0,0,0
Trevor Smith,2014-01-15,Brian Houston,Decision - Split,70,27,0,97
Trevor Smith,2019-12-07,Makhmud Muradov,KO/TKO,0,0,0,0
Trevor Smith,2015-07-12,Dan Miller,Decision - Unanimous,80,26,0,106
Trevor Smith,2014-11-08,Caio Magalhaes,KO/TKO,0,0,0,0
Trevor Smith,2016-12-09,Andrew Sanchez,Decision - Unanimous,0,0,0,0
Trevor Smith,2011-11-18,TJ Cook,Submission,90,3,0,93
Carlos Condit,2007-01-20,Kyle Jensen,Submission,90,2,0,92
Carlos Condit,2016-08-27,Demian Maia,Submission,0,0,25,25
Carlos Condit,2016-01-02,Robbie Lawler,Decision - Split,0,84,25,109
Carlos Condit,2018-04-14,Alex Oliveira,Submission,0,3,0,3
Carlos Condit,2011-07-02,Dong Hyun Kim,KO/TKO,100,7,0,107
Carlos Condit,2017-12-30,Neil Magny,Decision - Unanimous,0,5,0,5
Carlos Condit,2013-08-28,Martin Kampmann,KO/TKO,100,65,25,190
Carlos Condit,2014-03-15,Tyron Woodley,KO/TKO,0,0,0,0
Carlos Condit,2009-04-01,Martin Kampmann,Decision - Split,0,9,0,9
Carlos Condit,2009-09-16,Jake Ellenberger,Decision - Split,70,0,0,70
Carlos Condit,2008-08-03,Hiromitsu Miura,KO/TKO,100,0,25,125
Carlos Condit,2010-10-16,Dan Hardy,KO/TKO,100,17,0,117
Carlos Condit,2006-04-21,Jake Shields,Decision - Unanimous,0,0,0,0
Carlos Condit,2012-11-17,Georges St-Pierre,Decision - Unanimous,0,0,25,25
Carlos Condit,2015-05-30,Thiago Alves,TKO - Doctor's Stoppage,0,41,25,66
Carlos Condit,2021-07-10,Max Griffin,Decision - Unanimous,0,0,0,0
Carlos Condit,2021-01-16,Matt Brown,Decision - Unanimous,80,11,0,91
Carlos Condit,2008-02-13,Carlo Prater,Submission,90,3,25,118
Carlos Condit,2007-03-24,John Alessio,Submission,90,29,25,144
Carlos Condit,2007-08-05,Brock Larson,Submission,90,2,25,117
Carlos Condit,2013-03-16,Johny Hendricks,Decision - Unanimous,0,12,0,12
Carlos Condit,2020-10-03,Court McGee,Decision - Unanimous,80,4,0,84
Carlos Condit,2018-12-29,Michael Chiesa,Submission,0,0,0,0
Carlos Condit,2012-02-04,Nick Diaz,Decision - Unanimous,80,46,25,151
Carlos Condit,2010-06-12,Rory MacDonald,KO/TKO,100,43,0,143
Kyle Jensen,2007-01-20,Carlos Condit,Submission,0,0,0,0
Jeremy Kennedy,2016-08-27,Alex Ricci,Decision - Unanimous,80,0,0,80
Jeremy Kennedy,2018-02-10,Alexander Volkanovski,KO/TKO,0,0,0,0
Jeremy Kennedy,2017-03-11,Rony Jason,Decision - Unanimous,80,28,0,108
Jeremy Kennedy,2017-07-22,Kyle Bochniak,Decision - Unanimous,80,18,0,98
Alex Ricci,2016-08-27,Jeremy Kennedy,Decision - Unanimous,0,1,0,1
Alex Ricci,2017-02-19,Paul Felder,KO/TKO,0,0,0,0
Alexander Volkov,2024-12-07,Ciryl Gane,Decision - Split,0,0,0,0
Alexander Volkov,2018-03-17,Fabricio Werdum,KO/TKO,100,0,25,125
Alexander Volkov,2023-09-09,Tai Tuivasa,Submission,90,65,0,155
Alexander Volkov,2017-09-02,Stefan Struve,KO/TKO,100,94,25,219
Alexander Volkov,2024-06-22,Sergei Pavlovich,Decision - Unanimous,80,37,0,117
Alexander Volkov,2020-10-24,Walt Harris,KO/TKO,100,29,0,129
Alexander Volkov,2017-04-15,Roy Nelson,Decision - Unanimous,80,90,0,170
Alexander Volkov,2021-02-06,Alistair Overeem,KO/TKO,100,44,25,169
Alexander Volkov,2022-06-04,Jairzinho Rozenstruik,KO/TKO,100,15,25,140
Alexander Volkov,2021-06-26,Ciryl Gane,Decision - Unanimous,0,0,25,25
Alexander Volkov,2016-11-19,Timothy Johnson,Decision - Split,70,2,0,72
Alexander Volkov,2019-11-09,Greg Hardy,Decision - Unanimous,80,40,0,120
Alexander Volkov,2023-03-11,Alexandr Romanov,KO/TKO,100,12,0,112
Alexander Volkov,2018-10-06,Derrick Lewis,KO/TKO,0,82,0,82
Alexander Volkov,2021-10-30,Marcin Tybura,Decision - Unanimous,80,17,0,97
Alexander Volkov,2020-06-20,Curtis Blaydes,Decision - Unanimous,0,0,25,25
Alexander Volkov,2022-03-19,Tom Aspinall,Submission,0,0,25,25
Leon Edwards,2022-08-20,Kamaru Usman,KO/TKO,100,0,25,125
Leon Edwards,2024-07-27,Belal Muhammad,Decision - Unanimous,0,0,25,25
Leon Edwards,2015-04-11,Seth Baczynski,KO/TKO,100,3,0,103
Leon Edwards,2018-03-17,Peter Sobotta,KO/TKO,100,26,0,126
Leon Edwards,2019-03-16,Gunnar Nelson,Decision - Split,70,22,0,92
Leon Edwards,2023-03-18,Kamaru Usman,Decision - Majority,75,33,25,133
Leon Edwards,2021-06-12,Nate Diaz,Decision - Unanimous,80,1,25,106
Leon Edwards,2014-11-08,Claudio Silva,Decision - Split,0,0,0,0
Leon Edwards,2015-07-18,Pawel Pawlak,Decision - Unanimous,80,12,0,92
Leon Edwards,2017-03-18,Vicente Luque,Decision - Unanimous,80,29,0,109
Leon Edwards,2019-07-20,Rafael Dos Anjos,Decision - Unanimous,80,11,25,116
Leon Edwards,2017-09-02,Bryan Barberena,Decision - Unanimous,80,0,0,80
Leon Edwards,2016-05-08,Dominic Waters,Decision - Unanimous,80,21,0,101
Leon Edwards,2016-10-08,Albert Tumenov,Submission,90,0,0,90
Leon Edwards,2023-12-16,Colby Covington,Decision - Unanimous,80,13,25,118
Leon Edwards,2015-12-19,Kamaru Usman,Decision - Unanimous,0,0,0,0
Leon Edwards,2018-06-23,Donald Cerrone,Decision - Unanimous,80,24,25,129
Nathaniel Wood,2022-07-23,Charles Rosa,Decision - Unanimous,80,46,0,126
Nathaniel Wood,2020-10-24,Casey Kenney,Decision - Unanimous,0,13,0,13
Nathaniel Wood,2023-10-21,Muhammad Naimov,Decision - Unanimous,0,2,0,2
Nathaniel Wood,2022-09-03,Charles Jourdain,Decision - Unanimous,80,11,0,91
Nathaniel Wood,2023-07-22,Andre Fili,Decision - Unanimous,80,26,0,106
Nathaniel Wood,2020-07-25,John Castaneda,Decision - Unanimous,80,76,0,156
Nathaniel Wood,2018-12-29,Andre Ewell,Submission,90,46,0,136
Nathaniel Wood,2018-06-01,Johnny Eduardo,Submission,90,0,0,90
Nathaniel Wood,2024-07-27,Daniel Pineda,Decision - Unanimous,80,34,0,114
Nathaniel Wood,2019-03-16,Jose Quinonez,Submission,90,0,0,90
Nathaniel Wood,2020-02-15,John Dodson,KO/TKO,0,7,0,7
Charles Rosa,2022-07-23,Nathaniel Wood,Decision - Unanimous,0,0,0,0
Charles Rosa,2021-10-09,Damon Jackson,Decision - Unanimous,0,0,0,0
Charles Rosa,2017-04-08,Shane Burgos,KO/TKO,0,9,0,9
Charles Rosa,2015-01-18,Sean Soriano,Submission,90,0,0,90
Charles Rosa,2021-02-20,Darrick Minner,Decision - Unanimous,0,0,0,0
Charles Rosa,2016-01-17,Kyle Bochniak,Decision - Unanimous,80,40,0,120
Charles Rosa,2021-06-26,Justin Jaynes,Decision - Split,70,7,0,77
Charles Rosa,2022-01-15,TJ Brown,Decision - Unanimous,0,0,0,0
Charles Rosa,2014-10-04,Dennis Siver,Decision - Unanimous,0,0,0,0
Charles Rosa,2015-06-13,Yair Rodriguez,Decision - Split,0,0,0,0
Charles Rosa,2020-06-13,Kevin Aguilar,Decision - Split,70,16,0,86
Charles Rosa,2020-05-09,Bryce Mitchell,Decision - Unanimous,0,0,0,0
Charles Rosa,2019-10-18,Manny Bermudez,Submission,90,0,0,90
Sam Alvey,2019-07-20,Klidson Abreu,Decision - Unanimous,0,0,0,0
Sam Alvey,2015-05-09,Daniel Kelly,KO/TKO,100,6,0,106
Sam Alvey,2022-08-06,Michal Oleksiejczuk,KO/TKO,0,0,0,0
Sam Alvey,2019-02-09,Jimmy Crute,KO/TKO,0,0,0,0
Sam Alvey,2017-08-05,Rashad Evans,Decision - Split,70,23,0,93
Sam Alvey,2020-05-09,Ryan Spann,Decision - Split,0,6,0,6
Sam Alvey,2016-06-18,Elias Theodorou,Decision - Unanimous,0,0,0,0
Sam Alvey,2017-10-21,Ramazan Emeev,Decision - Unanimous,0,0,0,0
Sam Alvey,2015-08-08,Derek Brunson,KO/TKO,0,0,0,0
Sam Alvey,2014-11-07,Dylan Andrews,KO/TKO,100,2,0,102
Sam Alvey,2016-08-27,Kevin Casey,KO/TKO,100,34,0,134
Sam Alvey,2021-04-10,Julian Marquez,Submission,0,0,0,0
Sam Alvey,2021-08-28,Wellington Turman,Decision - Split,0,0,0,0
Sam Alvey,2014-08-16,Tom Watson,Decision - Unanimous,0,0,0,0
Sam Alvey,2017-01-28,Nate Marquardt,Decision - Unanimous,80,8,0,88
Sam Alvey,2016-07-13,Eric Spicely,Submission,90,1,0,91
Sam Alvey,2017-04-22,Thales Leites,Decision - Unanimous,0,0,0,0
Sam Alvey,2016-11-05,Alex Nicholson,Decision - Unanimous,80,0,0,80
Sam Alvey,2018-06-01,Gian Villante,Decision - Split,70,3,0,73
Sam Alvey,2018-09-22,Rogerio Nogueira,KO/TKO,0,8,0,8
Sam Alvey,2015-02-22,Cezar Ferreira,KO/TKO,100,0,0,100
Sam Alvey,2022-02-05,Brendan Allen,Submission,0,0,0,0
Sam Alvey,2018-02-24,Marcin Prachnio,KO/TKO,100,0,0,100
Arnold Allen,2018-05-27,Mads Burnell,Submission,90,9,0,99
Arnold Allen,2020-01-25,Nik Lentz,Decision - Unanimous,80,14,0,94
Arnold Allen,2022-03-19,Dan Hooker,KO/TKO,100,35,0,135
Arnold Allen,2015-06-20,Alan Omer,Submission,90,0,0,90
Arnold Allen,2016-02-27,Yaotzin Meza,Decision - Unanimous,80,6,0,86
Arnold Allen,2019-07-06,Gilbert Melendez,Decision - Unanimous,80,79,0,159
Arnold Allen,2022-10-29,Calvin Kattar,KO/TKO,100,14,25,139
Arnold Allen,2019-03-16,Jordan Rinaldi,Decision - Unanimous,80,7,0,87
Arnold Allen,2024-07-27,Giga Chikadze,Decision - Unanimous,80,23,0,103
Arnold Allen,2017-03-18,Makwan Amirkhani,Decision - Split,70,15,0,85
Arnold Allen,2021-04-10,Sodiq Yusuff,Decision - Unanimous,80,0,0,80
Arnold Allen,2023-04-15,Max Holloway,Decision - Unanimous,0,0,25,25
Arnold Allen,2024-01-20,Movsar Evloev,Decision - Unanimous,0,8,0,8
Mads Burnell,2018-05-27,Arnold Allen,Submission,0,0,0,0
Mads Burnell,2018-01-14,Mike Santiago,Decision - Unanimous,80,0,0,80
Mads Burnell,2017-09-02,Michel Prazeres,Submission,0,0,0,0
Antonio Carvalho,2012-11-17,Rodrigo Damm,Decision - Split,70,0,0,70
Antonio Carvalho,2012-01-14,Felipe Arantes,Decision - Unanimous,0,0,0,0
Antonio Carvalho,2013-03-16,Darren Elkins,KO/TKO,0,0,0,0
Antonio Carvalho,2012-07-21,Daniel Pineda,KO/TKO,100,3,0,103
Rodrigo Damm,2012-11-17,Antonio Carvalho,Decision - Split,0,2,0,2
Rodrigo Damm,2015-01-03,Evan Dunham,Decision - Unanimous,0,0,0,0
Rodrigo Damm,2009-04-11,Gilbert Melendez,KO/TKO,0,0,25,25
Rodrigo Damm,2014-02-15,Ivan Jorge,Decision - Unanimous,80,5,0,85
Rodrigo Damm,2011-04-01,Justin Wilcox,TKO - Doctor's Stoppage,0,0,0,0
Rodrigo Damm,2013-06-08,Mizuto Hirota,Decision - Split,70,0,0,70
Rodrigo Damm,2014-09-05,Al Iaquinta,KO/TKO,0,0,0,0
Rodrigo Damm,2012-06-23,Anistavio Medeiros,Submission,90,3,0,93
Rodrigo Damm,2014-05-31,Rashid Magomedov,Decision - Unanimous,0,0,0,0
Joe Lauzon,2008-09-17,Kyle Bradley,KO/TKO,100,5,0,105
Joe Lauzon,2016-08-27,Jim Miller,Decision - Split,0,0,0,0
Joe Lauzon,2010-01-02,Sam Stout,Decision - Unanimous,0,0,0,0
Joe Lauzon,2006-09-23,Jens Pulver,KO/TKO,100,9,0,109
Joe Lauzon,2015-01-31,Al Iaquinta,KO/TKO,0,0,0,0
Joe Lauzon,2014-09-05,Michael Chiesa,TKO - Doctor's Stoppage,0,0,0,0
Joe Lauzon,2015-07-25,Takanori Gomi,KO/TKO,100,8,0,108
Joe Lauzon,2018-04-07,Chris Gruetzemacher,KO/TKO,0,0,0,0
Joe Lauzon,2010-08-28,Gabe Ruediger,Submission,90,18,0,108
Joe Lauzon,2011-10-08,Melvin Guillard,Submission,90,0,0,90
Joe Lauzon,2016-07-09,Diego Sanchez,KO/TKO,100,16,0,116
Joe Lauzon,2012-02-25,Anthony Pettis,KO/TKO,0,0,0,0
Joe Lauzon,2015-12-11,Evan Dunham,Decision - Unanimous,0,0,0,0
Joe Lauzon,2017-11-11,Clay Guida,KO/TKO,0,0,0,0
Joe Lauzon,2009-02-07,Jeremy Stephens,Submission,90,0,0,90
Joe Lauzon,2007-11-17,Jason Reinhardt,Submission,90,4,0,94
Joe Lauzon,2011-06-26,Curt Warburton,Submission,90,7,0,97
Joe Lauzon,2012-12-29,Jim Miller,Decision - Unanimous,0,0,0,0
Joe Lauzon,2007-06-23,Brandon Melendez,Submission,90,0,0,90
Joe Lauzon,2019-10-18,Jonathan Pearce,KO/TKO,100,17,0,117
Joe Lauzon,2012-08-04,Jamie Varner,Submission,90,0,0,90
Joe Lauzon,2017-04-22,Stevie Ray,Decision - Majority,0,0,0,0
Joe Lauzon,2010-11-20,George Sotiropoulos,Submission,0,0,0,0
Joe Lauzon,2008-04-02,Kenny Florian,KO/TKO,0,0,0,0
Joe Lauzon,2013-08-17,Michael Johnson,Decision - Unanimous,0,0,0,0
Joe Lauzon,2013-12-14,Mac Danzig,Decision - Unanimous,80,0,0,80
Joe Lauzon,2017-01-15,Marcin Held,Decision - Split,70,0,0,70
Kyle Bradley,2008-09-17,Joe Lauzon,KO/TKO,0,0,0,0
Kyle Bradley,2010-01-11,Rafael Dos Anjos,Decision - Unanimous,0,0,0,0
Kyle Bradley,2008-02-02,Chris Lytle,KO/TKO,0,0,0,0
Kyle Bradley,2009-05-23,Phillipe Nover,KO/TKO,100,4,0,104
Quinton Jackson,2003-12-31,Ikuhisa Minowa,KO/TKO,100,64,0,164
Quinton Jackson,2005-04-23,Mauricio Rua,KO/TKO,0,0,0,0
Quinton Jackson,2006-07-22,Matt Lindland,Decision - Split,70,16,0,86
Quinton Jackson,2003-06-08,Mikhail Iloukhine,KO/TKO,100,18,0,118
Quinton Jackson,2005-10-23,Hirotaka Yokoi,KO/TKO,100,24,0,124
Quinton Jackson,2003-03-16,Kevin Randleman,KO/TKO,100,28,0,128
Quinton Jackson,2008-12-27,Wanderlei Silva,KO/TKO,100,4,0,104
Quinton Jackson,2003-11-09,Chuck Liddell,KO/TKO,100,74,0,174
Quinton Jackson,2007-02-03,Marvin Eastman,KO/TKO,100,30,0,130
Quinton Jackson,2001-12-23,Daijiro Matsui,DQ,0,1,0,1
Quinton Jackson,2003-11-09,Wanderlei Silva,KO/TKO,0,0,0,0
Quinton Jackson,2005-02-20,Murilo Rua,Decision - Split,70,3,0,73
Quinton Jackson,2008-07-05,Forrest Griffin,Decision - Unanimous,0,0,25,25
Quinton Jackson,2004-10-31,Wanderlei Silva,KO/TKO,0,0,0,0
Quinton Jackson,2001-11-03,Yuki Ishikawa,KO/TKO,100,14,0,114
Quinton Jackson,2011-05-28,Matt Hamill,Decision - Unanimous,80,23,0,103
Quinton Jackson,2007-05-26,Chuck Liddell,KO/TKO,100,2,25,127
Quinton Jackson,2002-09-29,Igor Vovchanchyn,KO/TKO,100,23,0,123
Quinton Jackson,2012-02-25,Ryan Bader,Decision - Unanimous,0,0,0,0
Quinton Jackson,2001-07-29,Kazushi Sakuraba,Submission,0,6,0,6
Quinton Jackson,2013-01-26,Glover Teixeira,Decision - Unanimous,0,0,0,0
Quinton Jackson,2006-02-26,Dong Sik Yoon,Decision - Unanimous,80,44,0,124
Quinton Jackson,2007-09-08,Dan Henderson,Decision - Unanimous,80,14,25,119
Quinton Jackson,2010-11-20,Lyoto Machida,Decision - Split,70,0,0,70
Quinton Jackson,2015-04-25,Fabio Maldonado,Decision - Unanimous,80,32,0,112
Quinton Jackson,2003-08-10,Murilo Bustamante,Decision - Split,70,41,0,111
Quinton Jackson,2004-06-20,Ricardo Arona,KO/TKO,100,1,0,101
Quinton Jackson,2010-05-29,Rashad Evans,Decision - Unanimous,0,0,0,0
Quinton Jackson,2011-09-24,Jon Jones,Submission,0,0,25,25
Quinton Jackson,2002-04-28,Masaaki Satake,KO/TKO,100,49,0,149
Quinton Jackson,2009-03-07,Keith Jardine,Decision - Unanimous,80,0,0,80
Nikita Krylov,2014-07-19,Cody Donovan,KO/TKO,100,21,0,121
Nikita Krylov,2022-10-22,Volkan Oezdemir,Decision - Unanimous,80,15,0,95
Nikita Krylov,2014-01-25,Walt Harris,KO/TKO,100,10,0,110
Nikita Krylov,2023-03-11,Ryan Spann,Submission,90,2,0,92
Nikita Krylov,2019-04-13,Ovince Saint Preux,Submission,90,23,0,113
Nikita Krylov,2013-08-31,Soa Palelei,KO/TKO,0,16,0,16
Nikita Krylov,2015-01-24,Stanislav Nedkov,Submission,90,9,0,99
Nikita Krylov,2016-07-30,Ed Herman,KO/TKO,100,34,0,134
Nikita Krylov,2018-09-15,Jan Blachowicz,Submission,0,0,0,0
Nikita Krylov,2022-03-19,Paul Craig,Submission,0,17,0,17
Nikita Krylov,2016-05-08,Francimar Barroso,Submission,90,36,0,126
Nikita Krylov,2020-03-14,Johnny Walker,Decision - Unanimous,80,8,0,88
Nikita Krylov,2021-02-27,Magomed Ankalaev,Decision - Unanimous,0,4,0,4
Nikita Krylov,2019-09-14,Glover Teixeira,Decision - Split,0,4,0,4
Nikita Krylov,2014-03-15,Ovince Saint Preux,Submission,0,0,0,0
Nikita Krylov,2015-08-23,Marcos Rogerio de Lima,Submission,90,16,0,106
Nikita Krylov,2022-07-23,Alexander Gustafsson,KO/TKO,100,21,0,121
Nikita Krylov,2016-12-10,Misha Cirkunov,Submission,0,8,0,8
Cody Donovan,2014-07-19,Nikita Krylov,KO/TKO,0,0,0,0
Cody Donovan,2013-11-16,Gian Villante,KO/TKO,0,8,0,8
Cody Donovan,2013-08-17,Ovince Saint Preux,KO/TKO,0,4,0,4
Cody Donovan,2012-12-14,Nick Penner,KO/TKO,100,12,0,112
BJ Penn,2009-12-12,Diego Sanchez,TKO - Doctor's Stoppage,0,62,25,87
BJ Penn,2001-11-02,Caol Uno,KO/TKO,100,5,0,105
BJ Penn,2002-01-11,Jens Pulver,Decision - Majority,0,11,25,36
BJ Penn,2008-01-19,Joe Stevenson,Submission,90,24,25,139
BJ Penn,2003-10-10,Takanori Gomi,Submission,90,29,0,119
BJ Penn,2008-05-24,Sean Sherk,KO/TKO,100,76,25,201
BJ Penn,2014-07-06,Frankie Edgar,KO/TKO,0,0,25,25
BJ Penn,2018-12-29,Ryan Hall,Submission,0,0,0,0
BJ Penn,2006-09-23,Matt Hughes,KO/TKO,0,0,25,25
BJ Penn,2002-09-27,Matt Serra,Decision - Unanimous,80,24,0,104
BJ Penn,2004-05-22,Duane Ludwig,Submission,90,6,0,96
BJ Penn,2009-01-31,Georges St-Pierre,KO/TKO,0,0,25,25
BJ Penn,2001-05-04,Joey Gilbert,KO/TKO,100,19,0,119
BJ Penn,2002-05-10,Paul Creighton,KO/TKO,100,33,0,133
BJ Penn,2005-03-26,Lyoto Machida,Decision - Unanimous,0,0,0,0
BJ Penn,2006-03-04,Georges St-Pierre,Decision - Split,0,0,0,0
BJ Penn,2009-08-08,Kenny Florian,Submission,90,38,25,153
BJ Penn,2001-06-29,Din Thomas,KO/TKO,100,5,0,105
BJ Penn,2017-01-15,Yair Rodriguez,KO/TKO,0,0,25,25
BJ Penn,2010-11-20,Matt Hughes,KO/TKO,100,4,0,104
BJ Penn,2004-01-31,Matt Hughes,Submission,90,13,25,128
BJ Penn,2010-08-28,Frankie Edgar,Decision - Unanimous,0,0,25,25
BJ Penn,2005-07-09,Renzo Gracie,Decision - Unanimous,80,20,0,100
BJ Penn,2004-11-20,Rodrigo Gracie,Decision - Unanimous,80,24,0,104
BJ Penn,2017-06-25,Dennis Siver,Decision - Majority,0,0,0,0
BJ Penn,2007-06-23,Jens Pulver,Submission,90,17,0,107
BJ Penn,2012-12-08,Rory MacDonald,Decision - Unanimous,0,0,0,0
BJ Penn,2010-04-10,Frankie Edgar,Decision - Unanimous,0,10,25,35
BJ Penn,2019-05-11,Clay Guida,Decision - Unanimous,0,0,0,0
BJ Penn,2011-10-29,Nick Diaz,Decision - Unanimous,0,0,0,0
Marc Diakiese,2022-03-26,Viacheslav Borshchev,Decision - Unanimous,80,5,0,85
Marc Diakiese,2017-03-18,Teemu Packalen,KO/TKO,100,5,0,105
Marc Diakiese,2020-07-18,Rafael Fiziev,Decision - Unanimous,0,0,0,0
Marc Diakiese,2022-07-23,Damir Hadzovic,Decision - Unanimous,80,8,0,88
Marc Diakiese,2016-12-09,Frankie Perez,Decision - Unanimous,80,0,0,80
Marc Diakiese,2019-09-28,Lando Vannata,Decision - Unanimous,80,15,0,95
Marc Diakiese,2022-12-03,Michael Johnson,Decision - Unanimous,0,0,0,0
Marc Diakiese,2016-10-08,Lukasz Sajewski,KO/TKO,100,27,0,127
Marc Diakiese,2017-07-07,Drakkar Klose,Decision - Split,0,0,0,0
Marc Diakiese,2018-07-22,Nasrat Haqparast,Decision - Unanimous,0,0,0,0
Marc Diakiese,2019-03-16,Joe Duffy,Decision - Unanimous,80,48,0,128
Marc Diakiese,2017-12-30,Dan Hooker,Submission,0,7,0,7
Marc Diakiese,2023-11-04,Kaue Fernandes,Decision - Split,70,0,0,70
Marc Diakiese,2023-07-22,Joel Alvarez,Submission,0,0,0,0
Marc Diakiese,2021-11-13,Rafael Alves,Submission,0,0,0,0
Viacheslav Borshchev,2022-03-26,Marc Diakiese,Decision - Unanimous,0,0,0,0
Viacheslav Borshchev,2024-08-24,James Llontop,Decision - Split,70,3,0,73
Viacheslav Borshchev,2022-01-15,Dakota Bush,KO/TKO,100,5,0,105
Viacheslav Borshchev,2023-05-20,Maheshate,KO/TKO,100,53,0,153
Viacheslav Borshchev,2024-05-11,Chase Hooper,Submission,0,0,0,0
Viacheslav Borshchev,2022-10-01,Mike Davis,Decision - Unanimous,0,0,0,0
Viacheslav Borshchev,2021-10-12,Chris Duncan,KO/TKO,100,5,0,105
Claudio Silva,2019-08-03,Cole Williams,Submission,90,30,0,120
Claudio Silva,2021-05-22,Court McGee,Decision - Unanimous,0,0,0,0
Claudio Silva,2014-11-08,Leon Edwards,Decision - Split,70,1,0,71
Claudio Silva,2018-05-27,Nordine Taleb,Submission,90,12,0,102
Claudio Silva,2019-03-16,Danny Roberts,Submission,90,0,0,90
Claudio Silva,2020-10-17,James Krause,Decision - Unanimous,0,0,0,0
Claudio Silva,2014-03-08,Brad Scott,Decision - Unanimous,80,0,0,80
Claudio Silva,2022-07-23,Nicolas Dalby,Decision - Unanimous,0,0,0,0
Cole Williams,2019-08-03,Claudio Silva,Submission,0,0,0,0
Cole Williams,2020-10-31,Jason Witt,Submission,0,0,0,0
Chance Rencountre,2019-07-06,Ismail Naurdiev,Decision - Unanimous,80,0,0,80
Chance Rencountre,2019-01-19,Kyle Stewart,Submission,90,4,0,94
Chance Rencountre,2019-11-02,Lyman Good,KO/TKO,0,0,0,0
Chance Rencountre,2018-06-01,Belal Muhammad,Decision - Unanimous,0,0,0,0
Ismail Naurdiev,2019-07-06,Chance Rencountre,Decision - Unanimous,0,17,0,17
Ismail Naurdiev,2019-02-23,Michel Prazeres,Decision - Unanimous,80,48,0,128
Ismail Naurdiev,2024-10-26,Bruno Silva,Decision - Unanimous,80,30,0,110
Ismail Naurdiev,2020-02-29,Sean Brady,Decision - Unanimous,0,0,0,0
Ismail Naurdiev,2019-09-28,Siyar Bahadurzada,Decision - Unanimous,80,57,0,137
Antonio Silva,2008-02-16,Ricco Rodriguez,Decision - Split,70,14,0,84
Antonio Silva,2013-05-25,Cain Velasquez,KO/TKO,0,0,25,25
Antonio Silva,2016-05-08,Stefan Struve,KO/TKO,0,0,0,0
Antonio Silva,2011-02-12,Fedor Emelianenko,TKO - Doctor's Stoppage,0,13,0,13
Antonio Silva,2007-02-10,Wesley Correira,KO/TKO,100,19,0,119
Antonio Silva,2010-12-04,Mike Kyle,KO/TKO,100,0,0,100
Antonio Silva,2015-08-01,Soa Palelei,KO/TKO,100,0,0,100
Antonio Silva,2011-09-10,Daniel Cormier,KO/TKO,0,0,0,0
Antonio Silva,2007-11-10,Jonathan Wiezorek,Submission,90,23,0,113
Antonio Silva,2014-09-13,Andrei Arlovski,KO/TKO,0,0,25,25
Antonio Silva,2016-09-24,Roy Nelson,KO/TKO,0,0,0,0
Antonio Silva,2009-11-07,Fabricio Werdum,Decision - Unanimous,0,0,0,0
Antonio Silva,2010-05-15,Andrei Arlovski,Decision - Unanimous,80,17,0,97
Antonio Silva,2015-11-14,Mark Hunt,KO/TKO,0,0,0,0
Antonio Silva,2015-02-22,Frank Mir,KO/TKO,0,0,25,25
Antonio Silva,2013-02-02,Alistair Overeem,KO/TKO,100,0,0,100
Antonio Silva,2012-05-26,Cain Velasquez,KO/TKO,0,0,0,0
Antonio Silva,2008-07-26,Justin Eilers,KO/TKO,100,26,25,151
Antonio Silva,2012-10-05,Travis Browne,KO/TKO,100,7,25,132
Ricco Rodriguez,2008-02-16,Antonio Silva,Decision - Split,0,0,0,0
Ricco Rodriguez,2002-09-27,Randy Couture,KO/TKO,100,0,25,125
Ricco Rodriguez,2005-10-14,Jimmy Ambriz,KO/TKO,100,26,0,126
Ricco Rodriguez,2001-06-29,Andrei Arlovski,KO/TKO,100,19,0,119
Ricco Rodriguez,2003-08-10,Antonio Rodrigo Nogueira,Decision - Unanimous,0,7,0,7
Ricco Rodriguez,2000-06-04,Gary Goodridge,Decision - Unanimous,80,22,0,102
Ricco Rodriguez,2003-11-21,Pedro Rizzo,Decision - Unanimous,0,0,0,0
Ricco Rodriguez,2000-08-27,Takayuki Okada,Submission,90,15,0,105
Ricco Rodriguez,2001-11-02,Pete Williams,KO/TKO,100,22,0,122
Ricco Rodriguez,2003-02-28,Tim Sylvia,KO/TKO,0,0,25,25
Ricco Rodriguez,2005-08-18,Ron Waterman,Decision - Unanimous,0,0,0,0
Ricco Rodriguez,2000-12-09,John Marsh,Decision - Unanimous,80,33,0,113
Ricco Rodriguez,2007-09-20,Ben Rothwell,Decision - Unanimous,0,2,0,2
Ricco Rodriguez,2002-05-10,Tsuyoshi Kohsaka,KO/TKO,100,13,0,113
Ricco Rodriguez,2002-01-11,Jeff Monson,KO/TKO,100,35,0,135
Daniel Rodriguez,2024-10-12,Alex Morono,Decision - Split,70,49,0,119
Daniel Rodriguez,2020-11-21,Nicolas Dalby,Decision - Unanimous,0,33,0,33
Daniel Rodriguez,2022-09-10,Li Jingliang,Decision - Split,70,10,0,80
Daniel Rodriguez,2020-08-22,Dwight Grant,KO/TKO,100,0,0,100
Daniel Rodriguez,2022-11-05,Neil Magny,Submission,0,9,0,9
Daniel Rodriguez,2023-05-13,Ian Machado Garry,KO/TKO,0,0,0,0
Daniel Rodriguez,2021-04-10,Mike Perry,Decision - Unanimous,80,68,0,148
Daniel Rodriguez,2024-06-22,Kelvin Gastelum,Decision - Unanimous,0,15,0,15
Daniel Rodriguez,2021-07-17,Preston Parsons,KO/TKO,100,22,0,122
Daniel Rodriguez,2020-05-30,Gabe Green,Decision - Unanimous,80,48,0,128
Daniel Rodriguez,2019-07-30,Rico Farrington,Decision - Unanimous,80,13,0,93
Daniel Rodriguez,2020-02-15,Tim Means,Submission,90,8,0,98
Daniel Rodriguez,2021-08-28,Kevin Lee,Decision - Unanimous,80,64,0,144
Alex Morono,2024-10-12,Daniel Rodriguez,Decision - Split,0,0,0,0
Alex Morono,2021-09-04,David Zawada,Decision - Unanimous,80,4,0,84
Alex Morono,2020-02-08,Khaos Williams,KO/TKO,0,0,0,0
Alex Morono,2023-10-07,Joaquin Buckley,Decision - Unanimous,0,0,0,0
Alex Morono,2021-05-08,Donald Cerrone,KO/TKO,100,18,0,118
Alex Morono,2020-11-14,Rhys McKee,Decision - Unanimous,80,52,0,132
Alex Morono,2019-10-12,Max Griffin,Decision - Unanimous,80,6,0,86
Alex Morono,2024-06-01,Niko Price,Decision - Unanimous,0,0,0,0
Alex Morono,2018-11-24,Song Kenan,Decision - Unanimous,80,37,0,117
Alex Morono,2023-05-13,Tim Means,Submission,90,0,0,90
Alex Morono,2018-07-28,Jordan Mein,Decision - Unanimous,0,6,0,6
Alex Morono,2021-12-04,Mickey Gall,Decision - Unanimous,80,25,0,105
Alex Morono,2018-02-18,Joshua Burkman,Submission,90,3,0,93
Alex Morono,2019-03-09,Zak Ottow,KO/TKO,100,15,0,115
Alex Morono,2022-07-30,Matthew Semelsberger,Decision - Unanimous,80,32,0,112
Alex Morono,2016-01-02,Kyle Noke,Decision - Split,70,0,0,70
Alex Morono,2016-12-17,James Moontasri,Decision - Unanimous,80,65,0,145
Alex Morono,2017-09-22,Keita Nakamura,Decision - Split,0,11,0,11
Alex Morono,2020-12-19,Anthony Pettis,Decision - Unanimous,0,0,0,0
Alex Morono,2022-12-10,Santiago Ponzinibbio,KO/TKO,0,0,0,0
Alex Morono,2024-04-06,Court McGee,Decision - Unanimous,80,0,0,80
Dusko Todorovic,2022-05-21,Chidi Njokuani,KO/TKO,0,0,0,0
Dusko Todorovic,2024-11-09,Mansur Abdul-Malik,KO/TKO,0,0,0,0
Dusko Todorovic,2019-08-27,Teddy Ash,Decision - Unanimous,80,0,0,80
Dusko Todorovic,2021-06-05,Gregory Rodrigues,Decision - Unanimous,0,0,0,0
Dusko Todorovic,2022-10-15,Jordan Wright,KO/TKO,100,36,0,136
Dusko Todorovic,2021-12-04,Maki Pitolo,KO/TKO,100,17,0,117
Dusko Todorovic,2023-03-18,Christian Leroy Duncan,KO/TKO,0,0,0,0
Dusko Todorovic,2021-01-16,Punahele Soriano,KO/TKO,0,0,0,0
Dusko Todorovic,2020-10-03,Dequan Townsend,KO/TKO,100,72,0,172
Belal Muhammad,2017-02-11,Randy Brown,Decision - Unanimous,80,19,0,99
Belal Muhammad,2020-06-20,Lyman Good,Decision - Unanimous,80,1,0,81
Belal Muhammad,2023-05-06,Gilbert Burns,Decision - Unanimous,80,51,25,156
Belal Muhammad,2024-07-27,Leon Edwards,Decision - Unanimous,80,21,25,126
Belal Muhammad,2022-10-22,Sean Brady,KO/TKO,100,22,0,122
Belal Muhammad,2017-07-08,Jordan Mein,Decision - Unanimous,80,9,0,89
Belal Muhammad,2021-02-13,Dhiego Lima,Decision - Unanimous,80,60,0,140
Belal Muhammad,2021-12-18,Stephen Thompson,Decision - Unanimous,80,39,0,119
Belal Muhammad,2022-04-16,Vicente Luque,Decision - Unanimous,80,0,25,105
Belal Muhammad,2017-11-18,Tim Means,Decision - Split,70,0,0,70
Belal Muhammad,2016-09-17,Augusto Montano,KO/TKO,100,0,0,100
Belal Muhammad,2021-06-12,Demian Maia,Decision - Unanimous,80,24,0,104
Belal Muhammad,2016-07-07,Alan Jouban,Decision - Unanimous,0,0,0,0
Belal Muhammad,2019-01-19,Geoff Neal,Decision - Unanimous,0,0,0,0
Belal Muhammad,2019-04-13,Curtis Millender,Decision - Unanimous,80,0,0,80
Belal Muhammad,2019-09-07,Takashi Sato,Submission,90,20,0,110
Belal Muhammad,2016-11-12,Vicente Luque,KO/TKO,0,0,0,0
Belal Muhammad,2018-06-01,Chance Rencountre,Decision - Unanimous,80,54,0,134
Robert Whittaker,2021-04-17,Kelvin Gastelum,Decision - Unanimous,80,88,25,193
Robert Whittaker,2013-08-28,Court McGee,Decision - Split,0,0,0,0
Robert Whittaker,2024-06-22,Ikram Aliskerov,KO/TKO,100,9,25,134
Robert Whittaker,2012-12-14,Brad Scott,Decision - Unanimous,80,28,0,108
Robert Whittaker,2022-02-12,Israel Adesanya,Decision - Unanimous,0,0,25,25
Robert Whittaker,2022-09-03,Marvin Vettori,Decision - Unanimous,80,41,0,121
Robert Whittaker,2024-10-26,Khamzat Chimaev,Submission,0,0,25,25
Robert Whittaker,2016-04-23,Rafael Natal,Decision - Unanimous,80,27,0,107
Robert Whittaker,2014-02-22,Stephen Thompson,KO/TKO,0,0,0,0
Robert Whittaker,2015-05-09,Brad Tavares,KO/TKO,100,8,0,108
Robert Whittaker,2015-11-14,Uriah Hall,Decision - Unanimous,80,22,0,102
Robert Whittaker,2016-11-26,Derek Brunson,KO/TKO,100,14,25,139
Robert Whittaker,2018-06-09,Yoel Romero,Decision - Split,70,17,25,112
Robert Whittaker,2020-10-24,Jared Cannonier,Decision - Unanimous,80,16,0,96
Robert Whittaker,2023-07-08,Dricus Du Plessis,KO/TKO,0,0,0,0
Robert Whittaker,2013-05-25,Colton Smith,KO/TKO,100,20,0,120
Robert Whittaker,2019-10-05,Israel Adesanya,KO/TKO,0,0,25,25
Robert Whittaker,2014-06-28,Mike Rhodes,Decision - Unanimous,80,19,0,99
Robert Whittaker,2014-11-07,Clint Hester,KO/TKO,100,21,0,121
Robert Whittaker,2020-07-25,Darren Till,Decision - Unanimous,80,28,25,133
Robert Whittaker,2017-07-08,Yoel Romero,Decision - Unanimous,80,26,25,131
Robert Whittaker,2017-04-15,Jacare Souza,KO/TKO,100,46,0,146
Robert Whittaker,2024-02-17,Paulo Costa,Decision - Unanimous,80,28,0,108
Kevin Randleman,2002-01-11,Renato Sobral,Decision - Unanimous,80,16,0,96
Kevin Randleman,2010-05-15,Roger Gracie,Submission,0,0,0,0
Kevin Randleman,2009-06-06,Mike Whitehead,Decision - Unanimous,0,0,0,0
Kevin Randleman,2002-09-29,Michiyoshi Ohara,Decision - Unanimous,80,50,0,130
Kevin Randleman,2000-06-09,Pedro Rizzo,Decision - Unanimous,80,5,25,110
Kevin Randleman,2003-03-16,Quinton Jackson,KO/TKO,0,0,0,0
Kevin Randleman,2001-05-04,Chuck Liddell,KO/TKO,0,0,0,0
Kevin Randleman,2002-12-23,Murilo Rua,TKO - Doctor's Stoppage,0,2,0,2
Kevin Randleman,2004-04-25,Mirko Filipovic,KO/TKO,100,5,0,105
Kevin Randleman,2005-04-23,Kazuhiro Nakamura,Decision - Unanimous,0,0,0,0
Kevin Randleman,2003-11-09,Kazushi Sakuraba,Submission,0,9,0,9
Kevin Randleman,2004-12-31,Mirko Filipovic,Submission,0,0,0,0
Kevin Randleman,1999-03-05,Maurice Smith,Decision - Unanimous,80,8,0,88
Kevin Randleman,1999-05-07,Bas Rutten,Decision - Split,0,2,0,2
Kevin Randleman,2004-08-15,Ron Waterman,Submission,0,2,0,2
Kevin Randleman,2002-11-24,Kenichi Yamamoto,KO/TKO,100,38,0,138
Kevin Randleman,1999-11-19,Pete Williams,Decision - Unanimous,80,2,25,107
Kevin Randleman,2006-10-21,Mauricio Rua,Submission,0,0,0,0
Kevin Randleman,2000-11-17,Randy Couture,KO/TKO,0,0,25,25
Kevin Randleman,2004-06-20,Fedor Emelianenko,Submission,0,0,0,0
Renato Sobral,2002-01-11,Kevin Randleman,Decision - Unanimous,0,0,0,0
Renato Sobral,2006-08-26,Chuck Liddell,KO/TKO,0,0,25,25
Renato Sobral,2005-04-16,Travis Wiuff,Submission,90,12,0,102
Renato Sobral,2010-12-04,Dan Henderson,KO/TKO,0,0,0,0
Renato Sobral,2003-09-06,Mauricio Rua,Submission,90,0,0,90
Renato Sobral,2010-06-16,Robbie Lawler,Decision - Unanimous,80,21,0,101
Renato Sobral,2009-01-24,Rameau Thierry Sokoudjou,Submission,90,7,0,97
Renato Sobral,2002-11-22,Chuck Liddell,KO/TKO,0,0,0,0
Renato Sobral,2007-03-03,Jason Lambert,KO/TKO,0,0,0,0
Renato Sobral,2005-10-07,Chael Sonnen,Submission,90,0,0,90
Renato Sobral,2007-08-25,David Heath,Submission,90,54,0,144
Renato Sobral,2008-11-21,Bobby Southworth,TKO - Doctor's Stoppage,0,5,25,30
Renato Sobral,2000-11-17,Maurice Smith,Decision - Majority,75,2,0,77
Renato Sobral,2008-07-19,Mike Whitehead,Decision - Unanimous,80,30,0,110
Renato Sobral,2006-02-04,Mike van Arsdale,Submission,90,8,0,98
Renato Sobral,2002-07-13,Elvis Sinosic,Decision - Unanimous,80,35,0,115
Renato Sobral,2009-08-15,Gegard Mousasi,KO/TKO,0,0,25,25
Kazuyuki Fujita,2000-05-01,Mark Kerr,Decision - Unanimous,80,20,0,100
Kazuyuki Fujita,2000-12-09,Gilbert Yvel,Decision - Unanimous,80,0,0,80
Kazuyuki Fujita,2002-12-31,Mirko Filipovic,Decision - Unanimous,0,0,0,0
Kazuyuki Fujita,2006-05-05,James Thompson,KO/TKO,100,0,0,100
Kazuyuki Fujita,2006-12-31,Eldari Kurtanidze,KO/TKO,100,7,0,107
Kazuyuki Fujita,2000-01-30,Hans Nijman,Submission,90,3,0,93
Kazuyuki Fujita,2009-12-31,Alistair Overeem,KO/TKO,0,0,0,0
Kazuyuki Fujita,2007-04-08,Jeff Monson,Submission,0,0,0,0
Kazuyuki Fujita,2001-08-19,Mirko Filipovic,TKO - Doctor's Stoppage,0,0,0,0
Kazuyuki Fujita,2006-07-01,Wanderlei Silva,KO/TKO,0,0,0,0
Kazuyuki Fujita,2001-05-27,Yoshihiro Takayama,Submission,90,11,0,101
Kazuyuki Fujita,2000-08-27,Ken Shamrock,KO/TKO,100,0,0,100
Kazuyuki Fujita,2000-05-01,Mark Coleman,KO/TKO,0,0,0,0
Kazuyuki Fujita,2003-06-08,Fedor Emelianenko,Submission,0,0,0,0
Cole Province,2009-08-09,Fredson Paixao,Decision - Unanimous,80,0,0,80
Cole Province,2008-12-03,Diego Nunes,Decision - Unanimous,0,0,0,0
Cole Province,2010-09-30,Mike Brown,KO/TKO,0,0,0,0
Fredson Paixao,2009-08-09,Cole Province,Decision - Unanimous,0,1,0,1
Fredson Paixao,2009-04-05,Wagnney Fabiano,Decision - Unanimous,0,0,0,0
Fredson Paixao,2010-08-18,Bryan Caraway,Decision - Split,70,4,0,74
Fredson Paixao,2010-12-04,Pablo Garza,KO/TKO,0,0,0,0
Fredson Paixao,2010-03-06,Courtney Buck,Submission,90,0,0,90
Don'Tale Mayes,2020-11-14,Roque Martinez,Decision - Unanimous,80,1,0,81
Don'Tale Mayes,2020-05-16,Rodrigo Nascimento,Submission,0,0,0,0
Don'Tale Mayes,2023-02-25,Augusto Sakai,Decision - Unanimous,0,0,0,0
Don'Tale Mayes,2019-07-16,Ricardo Prasel,KO/TKO,100,28,0,128
Don'Tale Mayes,2021-12-18,Josh Parisian,KO/TKO,100,15,0,115
Don'Tale Mayes,2024-08-03,Shamil Gaziev,Decision - Unanimous,0,0,0,0
Don'Tale Mayes,2023-06-03,Andrei Arlovski,KO/TKO,100,1,0,101
Don'Tale Mayes,2019-10-26,Ciryl Gane,Submission,0,0,0,0
Don'Tale Mayes,2024-04-27,Caio Machado,Decision - Unanimous,80,0,0,80
Don'Tale Mayes,2017-08-29,Allen Crowder,KO/TKO,0,0,0,0
Don'Tale Mayes,2023-11-04,Rodrigo Nascimento,Decision - Unanimous,0,9,0,9
Don'Tale Mayes,2018-07-31,Mitchell Sipe,KO/TKO,100,44,0,144
Roque Martinez,2020-11-14,Don'Tale Mayes,Decision - Unanimous,0,0,0,0
Roque Martinez,2021-06-19,Josh Parisian,Decision - Split,0,0,0,0
Roque Martinez,2020-09-12,Alexandr Romanov,Submission,0,0,0,0
Duane Ludwig,2010-03-21,Darren Elkins,KO/TKO,0,1,0,1
Duane Ludwig,2012-01-20,Josh Neer,Submission,0,19,0,19
Duane Ludwig,2004-05-22,BJ Penn,Submission,0,0,0,0
Duane Ludwig,2010-01-02,Jim Miller,Submission,0,0,0,0
Duane Ludwig,2012-05-26,Dan Hardy,KO/TKO,0,0,0,0
Duane Ludwig,2008-11-21,Yves Edwards,Decision - Unanimous,80,33,0,113
Duane Ludwig,2006-06-09,Tyson Griffin,KO/TKO,0,0,0,0
Duane Ludwig,2010-11-13,Nick Osipczak,Decision - Split,70,39,0,109
Duane Ludwig,2003-04-25,Genki Sudo,Decision - Unanimous,80,14,0,94
Duane Ludwig,2012-09-29,Che Mills,KO/TKO,0,0,0,0
Duane Ludwig,2007-06-22,Paul Daley,KO/TKO,0,0,0,0
Duane Ludwig,2006-01-16,Jonathan Goulet,KO/TKO,100,1,0,101
Duane Ludwig,2008-10-03,Sammy Morgan,KO/TKO,100,13,0,113
Duane Ludwig,2006-10-07,Josh Thomson,Submission,0,0,0,0
Duane Ludwig,2011-08-14,Amir Sadollah,Decision - Unanimous,80,28,0,108
Duane Ludwig,2006-12-08,Tony Fryklund,KO/TKO,100,68,0,168
Troy Mandaloniz,2007-12-08,Richie Hightower,KO/TKO,100,10,0,110
Troy Mandaloniz,2009-02-21,Paul Kelly,Decision - Unanimous,0,0,0,0
Richie Hightower,2007-12-08,Troy Mandaloniz,KO/TKO,0,0,0,0
Marcus Jones,2009-12-05,Matt Mitrione,KO/TKO,0,0,0,0
Michelle Waterson-Gomez,2019-10-12,Joanna Jedrzejczyk,Decision - Unanimous,0,0,25,25
Michelle Waterson-Gomez,2020-05-09,Carla Esparza,Decision - Split,0,0,0,0
Michelle Waterson-Gomez,2017-12-02,Tecia Pennington,Decision - Unanimous,0,0,0,0
Michelle Waterson-Gomez,2022-07-16,Amanda Lemos,Submission,0,9,0,9
Michelle Waterson-Gomez,2017-04-15,Rose Namajunas,Submission,0,0,0,0
Michelle Waterson-Gomez,2013-04-05,Jessica Penne,Submission,90,6,25,121
Michelle Waterson-Gomez,2023-09-23,Marina Rodriguez,KO/TKO,0,0,0,0
Michelle Waterson-Gomez,2021-05-08,Marina Rodriguez,Decision - Unanimous,0,0,25,25
Michelle Waterson-Gomez,2019-03-30,Karolina Kowalkiewicz,Decision - Unanimous,80,7,0,87
Michelle Waterson-Gomez,2018-10-06,Felice Herrig,Decision - Unanimous,80,25,0,105
Michelle Waterson-Gomez,2015-07-12,Angela Magana,Submission,90,39,0,129
Michelle Waterson-Gomez,2023-04-08,Luana Pinheiro,Decision - Split,0,17,0,17
Michelle Waterson-Gomez,2016-12-17,Paige VanZant,Submission,90,7,25,122
Michelle Waterson-Gomez,2018-04-14,Cortney Casey,Decision - Split,70,25,0,95
Michelle Waterson-Gomez,2008-10-03,Tyra Parker,Submission,90,10,0,100
Michelle Waterson-Gomez,2024-06-29,Gillian Robertson,Decision - Unanimous,0,0,0,0
Michelle Waterson-Gomez,2020-09-12,Angela Hill,Decision - Split,70,0,25,95
Satoshi Honma,2000-04-14,Ron Waterman,Decision - Unanimous,0,0,0,0
Satoshi Honma,1998-10-11,Yuhi Sano,KO/TKO,100,53,0,153
Satoshi Honma,1999-04-29,Francisco Bueno,KO/TKO,0,0,0,0
Bobby Green,2013-12-14,Pat Healy,Decision - Unanimous,80,21,0,101
Bobby Green,2017-04-15,Rashid Magomedov,Decision - Split,0,0,0,0
Bobby Green,2023-07-29,Tony Ferguson,Submission,90,83,0,173
Bobby Green,2024-04-13,Jim Miller,Decision - Unanimous,80,129,0,209
Bobby Green,2016-06-04,Dustin Poirier,KO/TKO,0,0,0,0
Bobby Green,2020-06-20,Clay Guida,Decision - Unanimous,80,62,0,142
Bobby Green,2021-11-06,Al Iaquinta,KO/TKO,100,18,0,118
Bobby Green,2013-02-02,Jacob Volkmann,Submission,90,48,0,138
Bobby Green,2022-12-17,Drew Dober,KO/TKO,0,39,0,39
Bobby Green,2018-12-15,Drakkar Klose,Decision - Unanimous,0,34,0,34
Bobby Green,2021-08-07,Rafael Fiziev,Decision - Unanimous,0,39,0,39
Bobby Green,2020-10-31,Thiago Moises,Decision - Unanimous,0,43,0,43
Bobby Green,2012-08-18,Matt Ricehouse,Decision - Unanimous,80,29,0,109
Bobby Green,2009-01-24,Dan Lauzon,Submission,0,19,0,19
Bobby Green,2024-07-27,Paddy Pimblett,Submission,0,7,0,7
Bobby Green,2022-02-12,Nasrat Haqparast,Decision - Unanimous,80,112,0,192
Bobby Green,2014-11-22,Edson Barboza,Decision - Unanimous,0,0,0,0
Bobby Green,2022-02-26,Islam Makhachev,KO/TKO,0,0,25,25
Bobby Green,2013-11-06,James Krause,KO/TKO,100,0,0,100
Bobby Green,2014-07-26,Josh Thomson,Decision - Split,70,14,0,84
Bobby Green,2019-11-16,Francisco Trinaldo,Decision - Unanimous,0,19,0,19
Bobby Green,2023-10-07,Grant Dawson,KO/TKO,100,7,25,132
Bobby Green,2020-08-01,Lando Vannata,Decision - Unanimous,80,61,0,141
Bobby Green,2020-09-12,Alan Patrick,Decision - Unanimous,80,42,0,122
Bobby Green,2018-01-27,Erik Koch,Decision - Unanimous,80,54,0,134
Bobby Green,2023-12-02,Jalin Turner,KO/TKO,0,0,0,0
Demetrious Johnson,2017-04-15,Wilson Reis,Submission,90,92,25,207
Demetrious Johnson,2018-08-04,Henry Cejudo,Decision - Split,0,30,25,55
Demetrious Johnson,2013-07-27,John Moraga,Submission,90,35,25,150
Demetrious Johnson,2010-09-30,Nick Pace,Decision - Unanimous,80,38,0,118
Demetrious Johnson,2013-12-14,Joseph Benavidez,KO/TKO,100,3,25,128
Demetrious Johnson,2011-10-01,Dominick Cruz,Decision - Unanimous,0,3,25,28
Demetrious Johnson,2017-10-07,Ray Borg,Submission,90,51,25,166
Demetrious Johnson,2011-05-28,Miguel Torres,Decision - Unanimous,80,3,0,83
Demetrious Johnson,2013-01-26,John Dodson,Decision - Unanimous,80,70,25,175
Demetrious Johnson,2012-09-22,Joseph Benavidez,Decision - Split,70,33,25,128
Demetrious Johnson,2014-06-14,Ali Bagautinov,Decision - Unanimous,80,97,25,202
Demetrious Johnson,2010-04-24,Brad Pickett,Decision - Unanimous,0,22,0,22
Demetrious Johnson,2014-09-27,Chris Cariaso,Submission,90,21,25,136
Demetrious Johnson,2015-04-25,Kyoji Horiguchi,Submission,90,35,25,150
Demetrious Johnson,2010-11-11,Damacio Page,Submission,90,13,0,103
Demetrious Johnson,2015-09-05,John Dodson,Decision - Unanimous,80,30,25,135
Demetrious Johnson,2012-06-08,Ian McCall,Decision - Unanimous,80,33,0,113
Demetrious Johnson,2016-04-23,Henry Cejudo,KO/TKO,100,15,25,140
Demetrious Johnson,2011-02-05,Norifumi Yamamoto,Decision - Unanimous,80,22,0,102
Demetrious Johnson,2016-12-03,Tim Elliott,Decision - Unanimous,80,4,25,109
Danny Martinez,2015-11-14,Richie Vaculik,Decision - Unanimous,80,0,0,80
Danny Martinez,2014-06-07,Scott Jorgensen,Decision - Unanimous,0,7,0,7
Danny Martinez,2014-02-01,Chris Cariaso,Decision - Unanimous,0,0,0,0
Danny Martinez,2015-06-27,Sirwan Kakai,Decision - Unanimous,0,7,0,7
Danny Martinez,2008-12-03,Joseph Benavidez,Decision - Unanimous,0,0,0,0
Richie Vaculik,2015-11-14,Danny Martinez,Decision - Unanimous,0,9,0,9
Richie Vaculik,2013-12-06,Justin Scoggins,KO/TKO,0,0,0,0
Richie Vaculik,2014-06-28,Roldan Sangcha'an,Decision - Unanimous,80,0,0,80
Richie Vaculik,2014-11-07,Louis Smolka,KO/TKO,0,7,0,7
Xiao Long,2024-11-23,Quang Le,KO/TKO,100,23,0,123
Xiao Long,2023-08-27,Shuya Kamikubo,Decision - Majority,75,52,0,127
Xiao Long,2021-10-26,Cristian Quinonez,Decision - Unanimous,0,2,0,2
Xiao Long,2024-06-22,ChangHo Lee,Decision - Split,0,0,0,0
Xiao Long,2023-05-28,Shohei Nose,Decision - Split,70,20,0,90
Quang Le,2024-11-23,Xiao Long,KO/TKO,0,0,0,0
Quang Le,2024-08-10,Chris Gutierrez,Decision - Unanimous,0,0,0,0
Andre Fili,2015-11-21,Gabriel Benitez,KO/TKO,100,5,0,105
Andre Fili,2013-10-19,Jeremy Larsen,KO/TKO,100,32,0,132
Andre Fili,2020-06-13,Charles Jourdain,Decision - Split,70,0,0,70
Andre Fili,2019-07-13,Sheymon Moraes,KO/TKO,100,8,0,108
Andre Fili,2022-09-17,Bill Algeo,Decision - Split,70,0,0,70
Andre Fili,2023-12-16,Lucas Almeida,KO/TKO,100,10,0,110
Andre Fili,2023-07-22,Nathaniel Wood,Decision - Unanimous,0,0,0,0
Andre Fili,2015-03-21,Godofredo Pepey,Submission,0,0,0,0
Andre Fili,2020-10-31,Bryce Mitchell,Decision - Unanimous,0,0,0,0
Andre Fili,2022-04-30,Joanderson Brito,KO/TKO,0,0,0,0
Andre Fili,2014-04-26,Max Holloway,Submission,0,0,0,0
Andre Fili,2020-01-18,Sodiq Yusuff,Decision - Unanimous,0,0,0,0
Andre Fili,2018-08-25,Michael Johnson,Decision - Split,0,0,0,0
Andre Fili,2016-04-23,Yair Rodriguez,KO/TKO,0,0,0,0
Andre Fili,2014-10-25,Felipe Arantes,Decision - Unanimous,80,13,0,93
Andre Fili,2017-07-29,Calvin Kattar,Decision - Unanimous,0,0,0,0
Andre Fili,2018-01-27,Dennis Bermudez,Decision - Split,70,0,0,70
Andre Fili,2024-02-10,Dan Ige,KO/TKO,0,0,0,0
Andre Fili,2016-10-01,Hacran Dias,Decision - Unanimous,80,20,0,100
Andre Fili,2019-02-17,Myles Jury,Decision - Unanimous,80,22,0,102
Andre Fili,2024-06-29,Cub Swanson,Decision - Split,70,5,0,75
Andre Fili,2017-10-21,Artem Lobov,Decision - Unanimous,80,0,0,80
Vaughan Lee,2013-06-08,Raphael Assuncao,Submission,0,0,0,0
Vaughan Lee,2013-02-16,Motonobu Tezuka,Decision - Unanimous,80,16,0,96
Vaughan Lee,2012-02-25,Norifumi Yamamoto,Submission,90,0,0,90
Vaughan Lee,2012-07-11,TJ Dillashaw,Submission,0,5,0,5
Vaughan Lee,2015-07-18,Paddy Holohan,Decision - Unanimous,0,0,0,0
Vaughan Lee,2014-03-01,Nam Phan,Decision - Unanimous,80,118,0,198
Vaughan Lee,2011-11-05,Chris Cariaso,Decision - Split,0,0,0,0
Vaughan Lee,2014-05-31,Iuri Alcantara,KO/TKO,0,0,0,0
Katsuhisa Fujii,2004-05-23,Jin Oh Kim,Submission,90,10,0,100
Katsuhisa Fujii,1999-11-19,Masutatsu Yano,KO/TKO,100,0,0,100
Katsuhisa Fujii,2004-10-14,Igor Vovchanchyn,KO/TKO,0,0,0,0
Katsuhisa Fujii,1999-11-19,Kenichi Yamamoto,Submission,0,26,0,26
Jin Oh Kim,2004-05-23,Katsuhisa Fujii,Submission,0,0,0,0
Joseph Benavidez,2009-08-09,Dominick Cruz,Decision - Unanimous,0,0,0,0
Joseph Benavidez,2020-02-29,Deiveson Figueiredo,KO/TKO,0,21,25,46
Joseph Benavidez,2013-12-14,Demetrious Johnson,KO/TKO,0,0,25,25
Joseph Benavidez,2010-08-18,Dominick Cruz,Decision - Split,0,0,25,25
Joseph Benavidez,2009-04-05,Jeff Curran,Decision - Unanimous,80,29,0,109
Joseph Benavidez,2015-10-03,Ali Bagautinov,Decision - Unanimous,80,17,0,97
Joseph Benavidez,2010-11-11,Wagnney Fabiano,Submission,90,11,0,101
Joseph Benavidez,2013-09-04,Jussier Formiga,KO/TKO,100,14,0,114
Joseph Benavidez,2021-03-06,Askar Askarov,Decision - Unanimous,0,0,0,0
Joseph Benavidez,2013-04-20,Darren Uyenoyama,KO/TKO,100,46,0,146
Joseph Benavidez,2012-09-22,Demetrious Johnson,Decision - Split,0,0,25,25
Joseph Benavidez,2016-02-06,Zach Makovsky,Decision - Unanimous,80,26,0,106
Joseph Benavidez,2008-12-03,Danny Martinez,Decision - Unanimous,80,43,0,123
Joseph Benavidez,2018-06-09,Sergio Pettis,Decision - Split,0,0,0,0
Joseph Benavidez,2016-12-03,Henry Cejudo,Decision - Split,70,1,0,71
Joseph Benavidez,2014-04-26,Tim Elliott,Submission,90,0,0,90
Joseph Benavidez,2020-07-18,Deiveson Figueiredo,Submission,0,0,25,25
Joseph Benavidez,2008-07-21,Junya Kudo,Submission,90,7,0,97
Joseph Benavidez,2019-01-19,Dustin Ortiz,Decision - Unanimous,80,0,0,80
Joseph Benavidez,2010-03-06,Miguel Torres,Submission,90,0,0,90
Joseph Benavidez,2009-12-19,Rani Yahya,KO/TKO,100,2,0,102
Joseph Benavidez,2013-02-02,Ian McCall,Decision - Unanimous,80,17,0,97
Joseph Benavidez,2015-05-23,John Moraga,Decision - Unanimous,80,21,0,101
Joseph Benavidez,2019-06-29,Jussier Formiga,KO/TKO,100,35,0,135
Joseph Benavidez,2018-11-30,Alex Perez,KO/TKO,100,21,0,121
Joseph Benavidez,2011-08-14,Eddie Wineland,Decision - Unanimous,80,42,0,122
Joseph Benavidez,2014-11-22,Dustin Ortiz,Decision - Unanimous,80,57,0,137
Joseph Benavidez,2012-03-02,Yasuhiro Urushitani,KO/TKO,100,10,0,110
Joseph Benavidez,2011-03-19,Ian Loveland,Decision - Unanimous,80,3,0,83
Karl Roberson,2021-04-24,Brendan Allen,Submission,0,0,0,0
Karl Roberson,2020-06-13,Marvin Vettori,Submission,0,0,0,0
Karl Roberson,2018-05-12,Cezar Ferreira,Submission,0,0,0,0
Karl Roberson,2019-07-13,Wellington Turman,Decision - Split,70,25,0,95
Karl Roberson,2018-11-03,Jack Marshman,Decision - Unanimous,80,13,0,93
Karl Roberson,2019-01-19,Glover Teixeira,Submission,0,18,0,18
Karl Roberson,2017-11-11,Darren Stewart,Submission,90,11,0,101
Karl Roberson,2019-11-09,Roman Kopylov,Submission,90,6,0,96
Karl Roberson,2022-07-09,Kennedy Nzechukwu,KO/TKO,0,0,0,0
Karl Roberson,2017-07-25,Ryan Spann,KO/TKO,100,4,0,104
Karl Roberson,2022-03-12,Khalil Rountree Jr.,KO/TKO,0,0,0,0
Denise Gomes,2022-08-23,Rayanne dos Santos,Decision - Unanimous,80,48,0,128
Denise Gomes,2023-07-08,Yazmin Jauregui,KO/TKO,100,17,0,117
Denise Gomes,2022-09-17,Loma Lookboonmee,Decision - Unanimous,0,0,0,0
Denise Gomes,2024-11-09,Karolina Kowalkiewicz,Decision - Unanimous,80,27,0,107
Denise Gomes,2023-11-04,Angela Hill,Decision - Unanimous,0,0,0,0
Denise Gomes,2024-06-08,Eduarda Moura,Decision - Split,70,32,0,102
Denise Gomes,2023-04-15,Bruna Brasil,KO/TKO,100,39,0,139
Rayanne dos Santos,2022-08-23,Denise Gomes,Decision - Unanimous,0,0,0,0
Rayanne dos Santos,2024-06-08,Puja Tomar,Decision - Split,0,0,0,0
Rayanne dos Santos,2023-12-09,Talita Alencar,Decision - Split,0,21,0,21
Donald Cerrone,2009-06-07,James Krause,Submission,90,9,0,99
Donald Cerrone,2015-01-03,Myles Jury,Decision - Unanimous,80,22,0,102
Donald Cerrone,2011-10-29,Dennis Siver,Submission,90,0,0,90
Donald Cerrone,2020-01-18,Conor McGregor,KO/TKO,0,0,25,25
Donald Cerrone,2008-06-01,Danny Castillo,Submission,90,0,0,90
Donald Cerrone,2021-05-08,Alex Morono,KO/TKO,0,0,0,0
Donald Cerrone,2011-12-30,Nate Diaz,Decision - Unanimous,0,0,0,0
Donald Cerrone,2009-12-19,Ed Ratcliff,Submission,90,15,0,105
Donald Cerrone,2014-01-25,Adriano Martins,KO/TKO,100,3,0,103
Donald Cerrone,2013-08-28,Rafael Dos Anjos,Decision - Unanimous,0,1,0,1
Donald Cerrone,2014-07-16,Jim Miller,KO/TKO,100,7,25,132
Donald Cerrone,2015-05-23,John Makdessi,KO/TKO,100,0,0,100
Donald Cerrone,2013-01-26,Anthony Pettis,KO/TKO,0,0,0,0
Donald Cerrone,2020-05-09,Anthony Pettis,Decision - Unanimous,0,0,0,0
Donald Cerrone,2017-01-28,Jorge Masvidal,KO/TKO,0,0,0,0
Donald Cerrone,2017-07-29,Robbie Lawler,Decision - Unanimous,0,5,0,5
Donald Cerrone,2017-10-21,Darren Till,KO/TKO,0,0,25,25
Donald Cerrone,2010-09-30,Jamie Varner,Decision - Unanimous,80,27,0,107
Donald Cerrone,2011-06-11,Vagner Rocha,Decision - Unanimous,80,40,0,120
Donald Cerrone,2016-12-10,Matt Brown,KO/TKO,100,0,0,100
Donald Cerrone,2015-01-18,Benson Henderson,Decision - Unanimous,80,0,0,80
Donald Cerrone,2010-04-24,Benson Henderson,Submission,0,0,25,25
Donald Cerrone,2018-02-18,Yancy Medeiros,KO/TKO,100,3,25,128
Donald Cerrone,2015-12-19,Rafael Dos Anjos,KO/TKO,0,0,25,25
Donald Cerrone,2012-08-11,Melvin Guillard,KO/TKO,100,0,0,100
Donald Cerrone,2016-08-20,Rick Story,KO/TKO,100,28,0,128
Donald Cerrone,2019-05-04,Al Iaquinta,Decision - Unanimous,80,48,25,153
Donald Cerrone,2011-02-05,Paul Kelly,Submission,90,15,0,105
Donald Cerrone,2013-11-16,Evan Dunham,Submission,90,8,0,98
Donald Cerrone,2014-09-27,Eddie Alvarez,Decision - Unanimous,80,40,0,120
Donald Cerrone,2014-04-19,Edson Barboza,Submission,90,0,0,90
Donald Cerrone,2016-06-18,Patrick Cote,KO/TKO,100,27,0,127
Donald Cerrone,2012-05-15,Jeremy Stephens,Decision - Unanimous,80,41,0,121
Donald Cerrone,2019-09-14,Justin Gaethje,KO/TKO,0,0,25,25
Donald Cerrone,2018-11-10,Mike Perry,Submission,90,0,0,90
Donald Cerrone,2022-07-02,Jim Miller,Submission,0,0,0,0
Donald Cerrone,2013-05-25,KJ Noons,Decision - Unanimous,80,36,0,116
Donald Cerrone,2019-01-19,Alexander Hernandez,KO/TKO,100,31,0,131
Donald Cerrone,2019-06-08,Tony Ferguson,TKO - Doctor's Stoppage,0,0,0,0
Donald Cerrone,2010-12-16,Chris Horodecki,Submission,90,0,0,90
Donald Cerrone,2009-01-25,Jamie Varner,Decision - Split,0,6,25,31
Donald Cerrone,2011-08-14,Charles Oliveira,KO/TKO,100,20,0,120
Donald Cerrone,2018-06-23,Leon Edwards,Decision - Unanimous,0,0,25,25
Donald Cerrone,2016-02-21,Alex Oliveira,Submission,90,0,25,115
Donald Cerrone,2009-10-10,Benson Henderson,Decision - Unanimous,0,0,25,25
Donald Cerrone,2008-11-05,Rob McCullough,Decision - Unanimous,80,11,0,91
James Krause,2009-06-07,Donald Cerrone,Submission,0,0,0,0
James Krause,2015-07-25,Daron Cruickshank,Submission,90,4,0,94
James Krause,2017-07-07,Tom Gallicchio,Decision - Unanimous,80,53,0,133
James Krause,2016-02-21,Shane Campbell,Decision - Unanimous,80,0,0,80
James Krause,2015-02-28,Valmir Lazaro,Decision - Split,0,0,0,0
James Krause,2019-11-16,Sergio Moraes,KO/TKO,100,61,0,161
James Krause,2009-11-18,Ricardo Lamas,Decision - Unanimous,0,1,0,1
James Krause,2014-09-27,Jorge Masvidal,Decision - Unanimous,0,0,0,0
James Krause,2013-06-15,Sam Stout,Submission,90,23,0,113
James Krause,2018-08-25,Warlley Alves,KO/TKO,100,31,0,131
James Krause,2020-10-17,Claudio Silva,Decision - Unanimous,80,30,0,110
James Krause,2018-01-14,Alex White,Decision - Unanimous,80,0,0,80
James Krause,2013-11-06,Bobby Green,KO/TKO,0,2,0,2
James Krause,2014-05-24,Jamie Varner,KO/TKO,100,15,0,115
James Krause,2020-02-08,Trevin Giles,Decision - Split,0,0,0,0
James McSweeney,2009-12-05,Darrill Schoonover,KO/TKO,100,42,0,142
James McSweeney,2010-06-19,Travis Browne,KO/TKO,0,0,0,0
James McSweeney,2010-10-16,Fabio Maldonado,KO/TKO,0,0,0,0
Darrill Schoonover,2009-12-05,James McSweeney,KO/TKO,0,0,0,0
Magomed Ankalaev,2020-02-29,Ion Cutelaba,KO/TKO,100,3,0,103
Magomed Ankalaev,2024-01-13,Johnny Walker,KO/TKO,100,15,25,140
Magomed Ankalaev,2020-10-24,Ion Cutelaba,KO/TKO,100,10,0,110
Magomed Ankalaev,2024-10-26,Aleksandar Rakic,Decision - Unanimous,80,2,0,82
Magomed Ankalaev,2022-03-12,Thiago Santos,Decision - Unanimous,80,18,25,123
Magomed Ankalaev,2018-03-17,Paul Craig,Submission,0,41,0,41
Magomed Ankalaev,2021-10-30,Volkan Oezdemir,Decision - Unanimous,80,18,0,98
Magomed Ankalaev,2021-02-27,Nikita Krylov,Decision - Unanimous,80,0,0,80
Magomed Ankalaev,2019-11-09,Dalcha Lungiambula,KO/TKO,100,38,0,138
Magomed Ankalaev,2018-09-15,Marcin Prachnio,KO/TKO,100,9,0,109
Magomed Ankalaev,2019-02-23,Klidson Abreu,Decision - Unanimous,80,7,0,87
Magomed Ankalaev,2022-07-30,Anthony Smith,KO/TKO,100,28,0,128
Ion Cutelaba,2020-02-29,Magomed Ankalaev,KO/TKO,0,0,0,0
Ion Cutelaba,2020-10-24,Magomed Ankalaev,KO/TKO,0,0,0,0
Ion Cutelaba,2022-09-10,Johnny Walker,Submission,0,0,0,0
Ion Cutelaba,2022-11-19,Kennedy Nzechukwu,KO/TKO,0,0,0,0
Ion Cutelaba,2019-04-27,Glover Teixeira,Submission,0,44,0,44
Ion Cutelaba,2019-09-28,Khalil Rountree Jr.,KO/TKO,100,10,0,110
Ion Cutelaba,2016-12-03,Jared Cannonier,Decision - Unanimous,0,0,0,0
Ion Cutelaba,2023-04-15,Tanner Boser,KO/TKO,100,25,0,125
Ion Cutelaba,2018-07-28,Gadzhimurad Antigulov,KO/TKO,100,28,0,128
Ion Cutelaba,2016-06-18,Misha Cirkunov,Submission,0,0,0,0
Ion Cutelaba,2024-09-28,Ivan Erslan,Decision - Split,70,6,0,76
Ion Cutelaba,2024-03-09,Philipe Lins,Decision - Unanimous,0,0,0,0
Ion Cutelaba,2021-09-18,Devin Clark,Decision - Unanimous,80,41,0,121
Ion Cutelaba,2017-06-10,Henrique da Silva,KO/TKO,100,14,0,114
Ion Cutelaba,2022-05-14,Ryan Spann,Submission,0,0,0,0
Ion Cutelaba,2016-10-01,Jonathan Wilson,Decision - Unanimous,80,59,0,139
Danny Castillo,2008-11-05,Rafael Dias,KO/TKO,100,18,0,118
Danny Castillo,2009-08-09,Ricardo Lamas,KO/TKO,100,0,0,100
Danny Castillo,2014-04-26,Charlie Brenneman,KO/TKO,100,3,0,103
Danny Castillo,2008-06-01,Donald Cerrone,Submission,0,0,0,0
Danny Castillo,2013-07-27,Tim Means,Decision - Unanimous,80,0,0,80
Danny Castillo,2015-01-03,Paul Felder,KO/TKO,0,0,0,0
Danny Castillo,2012-05-05,John Cholish,Decision - Unanimous,80,23,0,103
Danny Castillo,2010-08-18,Dustin Poirier,Decision - Unanimous,80,24,0,104
Danny Castillo,2011-03-03,Joe Stevenson,Decision - Unanimous,80,43,0,123
Danny Castillo,2014-08-30,Tony Ferguson,Decision - Split,0,0,0,0
Danny Castillo,2013-12-14,Edson Barboza,Decision - Majority,0,12,0,12
Danny Castillo,2009-03-01,Phil Cardella,Decision - Split,70,1,0,71
Danny Castillo,2009-11-18,Shane Roller,Submission,0,0,0,0
Danny Castillo,2011-12-30,Anthony Njokuani,Decision - Split,70,0,0,70
Danny Castillo,2015-07-25,Jim Miller,Decision - Split,0,0,0,0
Danny Castillo,2013-02-16,Paul Sass,Decision - Unanimous,80,34,0,114
Danny Castillo,2010-12-16,Will Kerr,KO/TKO,100,5,0,105
Danny Castillo,2011-11-19,Shamar Bailey,KO/TKO,100,19,0,119
Danny Castillo,2012-10-05,Michael Johnson,KO/TKO,0,0,0,0
Danny Castillo,2010-03-06,Anthony Pettis,KO/TKO,0,1,0,1
Danny Castillo,2015-12-19,Nik Lentz,Decision - Split,0,0,0,0
Danny Castillo,2011-08-14,Jacob Volkmann,Decision - Unanimous,0,16,0,16
Rafael Dias,2008-11-05,Danny Castillo,KO/TKO,0,0,0,0
Rafael Dias,2009-04-05,Mike Budnik,Decision - Unanimous,80,6,0,86
Rafael Dias,2009-08-09,Diego Nunes,Decision - Unanimous,0,0,0,0
Joanderson Brito,2023-07-01,Westin Wilson,KO/TKO,100,18,0,118
Joanderson Brito,2021-08-31,Diego Lopes,Decision - Unanimous,80,24,0,104
Joanderson Brito,2024-05-04,Jack Shore,TKO - Doctor's Stoppage,0,6,0,6
Joanderson Brito,2022-10-15,Lucas Alexander,Submission,90,3,0,93
Joanderson Brito,2022-01-15,Bill Algeo,Decision - Unanimous,0,0,0,0
Joanderson Brito,2022-04-30,Andre Fili,KO/TKO,100,8,0,108
Joanderson Brito,2023-11-18,Jonathan Pearce,Submission,90,0,0,90
Joanderson Brito,2024-09-28,William Gomis,Decision - Split,0,0,0,0
Westin Wilson,2023-07-01,Joanderson Brito,KO/TKO,0,0,0,0
Westin Wilson,2024-06-15,Jeka Saragih,Submission,90,0,0,90
Westin Wilson,2024-01-13,Jean Silva,KO/TKO,0,0,0,0
Marina Rodriguez,2019-03-30,Jessica Aguilar,Decision - Unanimous,80,68,0,148
Marina Rodriguez,2024-10-05,Iasmin Lucindo,Decision - Split,0,3,0,3
Marina Rodriguez,2019-08-10,Tecia Pennington,Decision - Unanimous,80,43,0,123
Marina Rodriguez,2023-09-23,Michelle Waterson-Gomez,KO/TKO,100,57,0,157
Marina Rodriguez,2021-01-23,Amanda Ribas,KO/TKO,100,8,0,108
Marina Rodriguez,2018-08-11,Maria Oliveira,KO/TKO,100,27,0,127
Marina Rodriguez,2021-05-08,Michelle Waterson-Gomez,Decision - Unanimous,80,37,25,142
Marina Rodriguez,2022-11-05,Amanda Lemos,KO/TKO,0,0,25,25
Marina Rodriguez,2022-03-05,Yan Xiaonan,Decision - Split,70,16,0,86
Marina Rodriguez,2024-04-13,Jessica Andrade,Decision - Split,0,0,0,0
Marina Rodriguez,2023-05-06,Virna Jandiroba,Decision - Unanimous,0,6,0,6
Marina Rodriguez,2020-07-25,Carla Esparza,Decision - Split,0,7,0,7
Marina Rodriguez,2021-10-09,Mackenzie Dern,Decision - Unanimous,80,95,25,200
Jessica Aguilar,2019-03-30,Marina Rodriguez,Decision - Unanimous,0,0,0,0
Jessica Aguilar,2017-05-13,Cortney Casey,Decision - Unanimous,0,0,0,0
Jessica Aguilar,2018-11-24,Zhang Weili,Submission,0,0,0,0
Jessica Aguilar,2018-07-14,Jodie Esquibel,Decision - Unanimous,80,47,0,127
Jessica Aguilar,2015-08-01,Claudia Gadelha,Decision - Unanimous,0,0,0,0
Pat Sabatini,2021-11-20,Tucker Lutz,Decision - Unanimous,80,0,0,80
Pat Sabatini,2022-09-17,Damon Jackson,KO/TKO,0,0,0,0
Pat Sabatini,2021-08-28,Jamall Emmers,Submission,90,0,0,90
Pat Sabatini,2023-06-17,Lucas Almeida,Submission,90,25,0,115
Pat Sabatini,2021-04-24,Tristan Connelly,Decision - Unanimous,80,7,0,87
Pat Sabatini,2024-10-12,Jonathan Pearce,Submission,90,1,0,91
Pat Sabatini,2022-04-16,TJ Laramie,Decision - Unanimous,80,21,0,101
Pat Sabatini,2023-11-11,Diego Lopes,KO/TKO,0,0,0,0
Tucker Lutz,2021-11-20,Pat Sabatini,Decision - Unanimous,0,1,0,1
Tucker Lutz,2020-11-17,Sherrard Blackledge,Decision - Unanimous,80,0,0,80
Tucker Lutz,2023-03-25,Daniel Pineda,Submission,0,4,0,4
Tucker Lutz,2020-09-01,Chase Gibson,Decision - Unanimous,80,49,0,129
Tucker Lutz,2023-07-15,Melsik Baghdasaryan,Decision - Unanimous,0,0,0,0
Tucker Lutz,2021-05-15,Kevin Aguilar,Decision - Unanimous,80,18,0,98
Ricky Glenn,2017-09-09,Gavin Tucker,Decision - Unanimous,80,119,0,199
Ricky Glenn,2024-08-17,Song Kenan,Decision - Unanimous,0,0,0,0
Ricky Glenn,2017-02-11,Phillipe Nover,Decision - Split,70,2,0,72
Ricky Glenn,2018-07-14,Dennis Bermudez,Decision - Split,70,6,0,76
Ricky Glenn,2023-10-07,Drew Dober,KO/TKO,0,0,0,0
Ricky Glenn,2018-11-30,Kevin Aguilar,Decision - Unanimous,0,0,0,0
Ricky Glenn,2021-06-19,Joaquim Silva,KO/TKO,100,9,0,109
Ricky Glenn,2023-04-22,Christos Giagos,KO/TKO,0,0,0,0
Ricky Glenn,2017-12-30,Myles Jury,Decision - Unanimous,0,0,0,0
Ricky Glenn,2016-09-17,Evan Dunham,Decision - Unanimous,0,0,0,0
Gavin Tucker,2017-09-09,Ricky Glenn,Decision - Unanimous,0,0,0,0
Gavin Tucker,2021-03-13,Dan Ige,KO/TKO,0,0,0,0
Gavin Tucker,2020-12-12,Billy Quarantillo,Decision - Unanimous,80,22,0,102
Gavin Tucker,2023-08-05,Diego Lopes,Submission,0,0,0,0
Gavin Tucker,2019-07-27,SeungWoo Choi,Submission,90,14,0,104
Gavin Tucker,2020-08-08,Justin Jaynes,Submission,90,46,0,136
Gavin Tucker,2017-02-19,Sam Sicilia,Decision - Unanimous,80,45,0,125
Dennis Buzukja,2024-03-30,Connor Matthews,KO/TKO,100,23,0,123
Dennis Buzukja,2020-09-01,Melsik Baghdasaryan,Decision - Unanimous,0,0,0,0
Dennis Buzukja,2022-07-26,Kaleio Romero,Decision - Unanimous,80,10,0,90
Dennis Buzukja,2024-08-24,Francis Marshall,Decision - Split,0,9,0,9
Dennis Buzukja,2023-08-05,Sean Woodson,Decision - Unanimous,0,0,0,0
Dennis Buzukja,2023-11-11,Jamall Emmers,KO/TKO,0,0,0,0
Connor Matthews,2024-03-30,Dennis Buzukja,KO/TKO,0,0,0,0
Connor Matthews,2022-08-02,Francis Marshall,Decision - Unanimous,0,0,0,0
Connor Matthews,2023-10-10,Jair Farias,Decision - Unanimous,80,23,0,103
Elias Urbina,2017-08-29,Bevon Lewis,KO/TKO,0,0,0,0
Daijiro Matsui,1999-07-04,Carlos Newton,Decision - Unanimous,0,5,0,5
Daijiro Matsui,1999-11-21,Wanderlei Silva,Decision,0,0,0,0
Daijiro Matsui,2001-12-23,Quinton Jackson,DQ,0,0,0,0
Daijiro Matsui,2000-06-04,Igor Vovchanchyn,TKO - Doctor's Stoppage,0,0,0,0
Daijiro Matsui,2001-07-29,Ebenezer Fontes Braga,Decision - Unanimous,0,0,0,0
Daijiro Matsui,2000-08-27,Vitor Belfort,Decision,0,0,0,0
Daijiro Matsui,1999-09-12,Bob Schrijber,DQ,0,0,0,0
Daijiro Matsui,2001-05-27,Jose Landi-Jons,Decision - Unanimous,80,0,0,80
Daijiro Matsui,2001-09-24,Murilo Rua,KO/TKO,0,0,0,0
Daijiro Matsui,2002-02-24,Rodrigo Gracie,Submission,0,0,0,0
Daijiro Matsui,2002-08-28,Jerrel Venetiaan,Decision - Split,0,0,0,0
Daijiro Matsui,2002-12-23,Kazuki Okubo,Decision - Unanimous,80,23,0,103
Desmond Green,2018-09-15,Mairbek Taisumov,Decision - Unanimous,0,0,0,0
Desmond Green,2018-02-03,Michel Prazeres,Decision - Unanimous,0,0,0,0
Desmond Green,2019-03-30,Ross Pearson,KO/TKO,100,13,0,113
Desmond Green,2017-04-08,Josh Emmett,Decision - Split,70,16,0,86
Desmond Green,2017-09-02,Rustam Khabilov,Decision - Unanimous,0,13,0,13
Desmond Green,2018-06-01,Gleison Tibau,Decision - Unanimous,80,49,0,129
Desmond Green,2019-05-18,Charles Jourdain,Decision - Unanimous,80,23,0,103
Cody McKenzie,2010-12-04,Aaron Wilkinson,Submission,90,0,0,90
Cody McKenzie,2012-05-15,Marcus LeVesseur,Submission,90,0,0,90
Cody McKenzie,2012-07-07,Chad Mendes,KO/TKO,0,0,0,0
Cody McKenzie,2011-01-22,Yves Edwards,Submission,0,0,0,0
Cody McKenzie,2011-09-17,Vagner Rocha,Submission,0,0,0,0
Cody McKenzie,2013-12-14,Sam Stout,Decision - Unanimous,0,0,0,0
Cody McKenzie,2013-04-27,Leonard Garcia,Decision - Unanimous,80,15,0,95
Aaron Wilkinson,2010-12-04,Cody McKenzie,Submission,0,0,0,0
Uriah Hall,2014-07-05,Thiago Santos,Decision - Unanimous,80,0,0,80
Uriah Hall,2016-09-17,Derek Brunson,KO/TKO,0,0,0,0
Uriah Hall,2013-04-13,Kelvin Gastelum,Decision - Split,0,13,0,13
Uriah Hall,2019-09-14,Antonio Carlos Junior,Decision - Split,70,12,0,82
Uriah Hall,2018-07-07,Paulo Costa,KO/TKO,0,0,0,0
Uriah Hall,2016-11-19,Gegard Mousasi,KO/TKO,0,0,25,25
Uriah Hall,2015-05-23,Rafael Natal,Decision - Split,0,0,0,0
Uriah Hall,2022-07-02,Andre Muniz,Decision - Unanimous,0,0,0,0
Uriah Hall,2021-07-31,Sean Strickland,Decision - Unanimous,0,0,25,25
Uriah Hall,2015-01-18,Ron Stallings,TKO - Doctor's Stoppage,0,17,0,17
Uriah Hall,2015-11-14,Robert Whittaker,Decision - Unanimous,0,0,0,0
Uriah Hall,2017-09-16,Krzysztof Jotko,KO/TKO,100,0,0,100
Uriah Hall,2015-09-26,Gegard Mousasi,KO/TKO,100,1,0,101
Uriah Hall,2015-08-08,Oluwale Bamgbose,KO/TKO,100,4,0,104
Uriah Hall,2018-12-29,Bevon Lewis,KO/TKO,100,0,0,100
Uriah Hall,2013-08-17,John Howard,Decision - Split,0,8,0,8
Uriah Hall,2021-04-24,Chris Weidman,KO/TKO,100,0,0,100
Uriah Hall,2013-12-28,Chris Leben,TKO - Doctor's Stoppage,0,9,0,9
Uriah Hall,2020-10-31,Anderson Silva,KO/TKO,100,7,25,132
Thiago Santos,2014-07-05,Uriah Hall,Decision - Unanimous,0,2,0,2
Thiago Santos,2016-05-14,Nate Marquardt,KO/TKO,100,9,0,109
Thiago Santos,2017-02-19,Jack Marshman,KO/TKO,100,21,0,121
Thiago Santos,2019-02-23,Jan Blachowicz,KO/TKO,100,32,25,157
Thiago Santos,2018-02-03,Anthony Smith,KO/TKO,100,48,0,148
Thiago Santos,2022-08-06,Jamahal Hill,KO/TKO,0,0,25,25
Thiago Santos,2020-11-07,Glover Teixeira,Submission,0,0,25,25
Thiago Santos,2019-07-06,Jon Jones,Decision - Split,0,0,25,25
Thiago Santos,2022-03-12,Magomed Ankalaev,Decision - Unanimous,0,0,25,25
Thiago Santos,2018-09-22,Eryk Anders,KO/TKO,100,68,25,193
Thiago Santos,2015-06-27,Steve Bosse,KO/TKO,100,3,0,103
Thiago Santos,2016-07-09,Gegard Mousasi,KO/TKO,0,0,0,0
Thiago Santos,2016-09-24,Eric Spicely,Submission,0,0,0,0
Thiago Santos,2015-01-31,Andy Enz,KO/TKO,100,19,0,119
Thiago Santos,2018-04-21,David Branch,KO/TKO,0,9,0,9
Thiago Santos,2015-12-10,Elias Theodorou,Decision - Unanimous,80,24,0,104
Thiago Santos,2018-08-04,Kevin Holland,Decision - Unanimous,80,38,0,118
Thiago Santos,2021-10-02,Johnny Walker,Decision - Unanimous,80,0,25,105
Thiago Santos,2018-12-08,Jimi Manuwa,KO/TKO,100,15,0,115
Thiago Santos,2017-07-08,Gerald Meerschaert,KO/TKO,100,45,0,145
Thiago Santos,2014-03-23,Ronny Markes,KO/TKO,100,7,0,107
Thiago Santos,2017-10-28,Jack Hermansson,KO/TKO,100,23,0,123
Thiago Santos,2013-08-03,Cezar Ferreira,Submission,0,0,0,0
Thiago Santos,2021-03-06,Aleksandar Rakic,Decision - Unanimous,0,13,0,13
Joby Sanchez,2017-08-22,JP Buys,KO/TKO,100,10,0,110
Joby Sanchez,2015-12-11,Geane Herrera,KO/TKO,0,15,0,15
Joby Sanchez,2015-01-18,Tateki Matsuda,Decision - Split,70,3,0,73
Joby Sanchez,2017-07-11,Manny Vazquez,Decision - Unanimous,80,18,0,98
Joby Sanchez,2018-02-18,Robert Sanchez,Submission,0,0,0,0
Joby Sanchez,2018-11-10,Mark De La Rosa,Decision - Split,0,0,0,0
Joby Sanchez,2014-08-23,Wilson Reis,Decision - Unanimous,0,0,0,0
JP Buys,2017-08-22,Joby Sanchez,KO/TKO,0,0,0,0
JP Buys,2021-09-18,Montel Jackson,Decision - Unanimous,0,0,0,0
JP Buys,2020-11-17,Jacob Silva,Submission,90,22,0,112
JP Buys,2022-06-25,Cody Durden,KO/TKO,0,0,0,0
JP Buys,2021-03-20,Bruno Silva,KO/TKO,0,0,0,0
JP Buys,2023-08-12,Marcus McGhee,KO/TKO,0,0,0,0
Bryan Travers,2010-05-21,Pat Healy,Decision - Unanimous,0,0,0,0
Virna Jandiroba,2022-05-14,Angela Hill,Decision - Unanimous,80,0,0,80
Virna Jandiroba,2019-04-27,Carla Esparza,Decision - Unanimous,0,0,0,0
Virna Jandiroba,2021-10-30,Amanda Ribas,Decision - Unanimous,0,0,0,0
Virna Jandiroba,2024-03-30,Loopy Godinez,Decision - Unanimous,80,0,0,80
Virna Jandiroba,2019-12-07,Mallory Martin,Submission,90,0,0,90
Virna Jandiroba,2023-05-06,Marina Rodriguez,Decision - Unanimous,80,0,0,80
Virna Jandiroba,2021-06-19,Kanako Murata,TKO - Doctor's Stoppage,0,13,0,13
Virna Jandiroba,2020-08-15,Felice Herrig,Submission,90,3,0,93
Virna Jandiroba,2024-07-20,Amanda Lemos,Submission,90,0,25,115
Virna Jandiroba,2020-12-12,Mackenzie Dern,Decision - Unanimous,0,0,0,0
Angela Hill,2022-05-14,Virna Jandiroba,Decision - Unanimous,0,7,0,7
Angela Hill,2018-08-25,Cortney Casey,Decision - Split,0,10,0,10
Angela Hill,2014-12-12,Emily Kagan,Decision - Unanimous,80,66,0,146
Angela Hill,2023-05-20,Mackenzie Dern,Decision - Unanimous,0,0,25,25
Angela Hill,2017-07-07,Ashley Yoder,Decision - Unanimous,80,21,0,101
Angela Hill,2019-04-27,Jodie Esquibel,Decision - Unanimous,80,60,0,140
Angela Hill,2020-01-25,Hannah Cifers,KO/TKO,100,24,0,124
Angela Hill,2020-02-22,Loma Lookboonmee,Decision - Unanimous,80,0,0,80
Angela Hill,2019-06-08,Yan Xiaonan,Decision - Unanimous,0,0,0,0
Angela Hill,2021-08-07,Tecia Pennington,Decision - Unanimous,0,0,0,0
Angela Hill,2023-11-04,Denise Gomes,Decision - Unanimous,80,14,0,94
Angela Hill,2024-08-24,Tabatha Ricci,Decision - Unanimous,0,11,0,11
Angela Hill,2017-11-11,Nina Nunes,Decision - Unanimous,0,0,0,0
Angela Hill,2022-08-13,Loopy Godinez,Decision - Unanimous,80,0,0,80
Angela Hill,2019-09-21,Ariane Carnelossi,TKO - Doctor's Stoppage,0,20,0,20
Angela Hill,2017-02-04,Jessica Andrade,Decision - Unanimous,0,0,0,0
Angela Hill,2015-06-13,Tecia Pennington,Decision - Unanimous,0,0,0,0
Angela Hill,2015-10-03,Rose Namajunas,Submission,0,0,0,0
Angela Hill,2021-12-18,Amanda Lemos,Decision - Split,0,0,0,0
Angela Hill,2024-05-18,Luana Pinheiro,Submission,90,11,0,101
Angela Hill,2020-05-16,Claudia Gadelha,Decision - Split,0,6,0,6
Angela Hill,2021-03-13,Ashley Yoder,Decision - Unanimous,80,43,0,123
Angela Hill,2020-09-12,Michelle Waterson-Gomez,Decision - Split,0,3,25,28
Angela Hill,2019-03-23,Randa Markos,Submission,0,0,0,0
Angela Hill,2022-12-03,Emily Ducote,Decision - Unanimous,80,111,0,191
Angela Hill,2018-02-24,Maryna Moroz,Decision - Unanimous,80,30,0,110
Jared Cannonier,2021-08-21,Kelvin Gastelum,Decision - Unanimous,80,0,25,105
Jared Cannonier,2017-07-07,Nick Roehrick,KO/TKO,100,56,0,156
Jared Cannonier,2015-01-03,Shawn Jordan,KO/TKO,0,0,0,0
Jared Cannonier,2018-11-03,David Branch,KO/TKO,100,16,0,116
Jared Cannonier,2022-07-02,Israel Adesanya,Decision - Unanimous,0,0,25,25
Jared Cannonier,2019-05-11,Anderson Silva,KO/TKO,100,9,0,109
Jared Cannonier,2016-04-10,Cyril Asker,KO/TKO,100,14,0,114
Jared Cannonier,2016-12-03,Ion Cutelaba,Decision - Unanimous,80,14,0,94
Jared Cannonier,2020-10-24,Robert Whittaker,Decision - Unanimous,0,0,0,0
Jared Cannonier,2022-12-17,Sean Strickland,Decision - Split,70,0,25,95
Jared Cannonier,2019-09-28,Jack Hermansson,KO/TKO,100,8,25,133
Jared Cannonier,2017-02-11,Glover Teixeira,Decision - Unanimous,0,0,0,0
Jared Cannonier,2022-02-12,Derek Brunson,KO/TKO,100,12,0,112
Jared Cannonier,2023-06-17,Marvin Vettori,Decision - Unanimous,80,88,25,193
Jared Cannonier,2024-08-24,Caio Borralho,Decision - Unanimous,0,0,25,25
Jared Cannonier,2018-05-19,Dominick Reyes,KO/TKO,0,0,0,0
Jared Cannonier,2024-06-08,Nassourdine Imavov,KO/TKO,0,0,25,25
Jared Cannonier,2017-12-16,Jan Blachowicz,Decision - Unanimous,0,0,0,0
Deiveson Figueiredo,2024-11-23,Petr Yan,Decision - Unanimous,0,0,25,25
Deiveson Figueiredo,2019-03-23,Jussier Formiga,Decision - Unanimous,0,0,0,0
Deiveson Figueiredo,2020-02-29,Joseph Benavidez,KO/TKO,100,0,25,125
Deiveson Figueiredo,2017-10-28,Jarred Brooks,Decision - Split,70,0,0,70
Deiveson Figueiredo,2022-01-22,Brandon Moreno,Decision - Unanimous,80,0,25,105
Deiveson Figueiredo,2019-07-27,Alexandre Pantoja,Decision - Unanimous,80,6,0,86
Deiveson Figueiredo,2024-08-03,Marlon Vera,Decision - Unanimous,80,0,0,80
Deiveson Figueiredo,2018-08-25,John Moraga,KO/TKO,100,15,0,115
Deiveson Figueiredo,2017-06-03,Marco Beltran,KO/TKO,100,1,0,101
Deiveson Figueiredo,2020-07-18,Joseph Benavidez,Submission,90,17,25,132
Deiveson Figueiredo,2020-11-21,Alex Perez,Submission,90,0,25,115
Deiveson Figueiredo,2024-04-13,Cody Garbrandt,Submission,90,0,0,90
Deiveson Figueiredo,2023-12-02,Rob Font,Decision - Unanimous,80,0,0,80
Deiveson Figueiredo,2018-02-03,Joseph Morales,KO/TKO,100,22,0,122
Deiveson Figueiredo,2019-10-12,Tim Elliott,Submission,90,0,0,90
Deiveson Figueiredo,2021-06-12,Brandon Moreno,Submission,0,0,25,25
Deiveson Figueiredo,2023-01-21,Brandon Moreno,TKO - Doctor's Stoppage,0,0,25,25
Jared Rosholt,2014-04-11,Daniel Omielanczuk,Decision - Unanimous,80,24,0,104
Jared Rosholt,2016-02-06,Roy Nelson,Decision - Unanimous,0,0,0,0
Jared Rosholt,2015-08-08,Timothy Johnson,Decision - Unanimous,80,0,0,80
Jared Rosholt,2015-11-14,Stefan Struve,Decision - Unanimous,80,0,0,80
Jared Rosholt,2014-06-28,Soa Palelei,Decision - Unanimous,80,32,0,112
Jared Rosholt,2014-11-22,Aleksei Oleinik,KO/TKO,0,6,0,6
Jared Rosholt,2013-11-30,Walt Harris,Decision - Unanimous,80,15,0,95
Jared Rosholt,2015-03-14,Josh Copeland,KO/TKO,100,13,0,113
Damon Jackson,2022-09-17,Pat Sabatini,KO/TKO,100,10,0,110
Damon Jackson,2024-08-10,Chepe Mariscal,Decision - Unanimous,0,0,0,0
Damon Jackson,2021-10-09,Charles Rosa,Decision - Unanimous,80,7,0,87
Damon Jackson,2023-01-14,Dan Ige,KO/TKO,0,2,0,2
Damon Jackson,2020-12-05,Ilia Topuria,KO/TKO,0,0,0,0
Damon Jackson,2020-09-19,Mirsad Bektic,Submission,90,0,0,90
Damon Jackson,2024-04-06,Alexander Hernandez,Decision - Split,70,10,0,80
Damon Jackson,2014-08-30,Yancy Medeiros,Submission,0,0,0,0
Damon Jackson,2022-03-12,Kamuela Kirk,Submission,90,10,0,100
Damon Jackson,2024-11-16,Jim Miller,Submission,0,6,0,6
Damon Jackson,2023-08-05,Billy Quarantillo,Decision - Unanimous,0,0,0,0
Damon Jackson,2022-06-04,Dan Argueta,Decision - Unanimous,80,5,0,85
Loopy Godinez,2021-10-09,Silvana Gomez Juarez,Submission,90,8,0,98
Loopy Godinez,2024-08-03,Mackenzie Dern,Decision - Unanimous,0,0,0,0
Loopy Godinez,2021-10-16,Luana Carolina,Decision - Unanimous,0,0,0,0
Loopy Godinez,2023-11-11,Tabatha Ricci,Decision - Split,70,14,0,84
Loopy Godinez,2024-03-30,Virna Jandiroba,Decision - Unanimous,0,8,0,8
Loopy Godinez,2023-05-20,Emily Ducote,Decision - Unanimous,80,20,0,100
Loopy Godinez,2022-05-07,Ariane Carnelossi,Decision - Unanimous,80,37,0,117
Loopy Godinez,2023-09-16,Elise Reed,Submission,90,18,0,108
Loopy Godinez,2023-04-08,Cynthia Calvillo,Decision - Split,70,0,0,70
Loopy Godinez,2022-08-13,Angela Hill,Decision - Unanimous,0,7,0,7
Loopy Godinez,2021-11-20,Loma Lookboonmee,Decision - Unanimous,80,8,0,88
Loopy Godinez,2021-04-17,Jessica Penne,Decision - Split,0,9,0,9
James Vick,2016-04-23,Glaico Franca Moreira,Decision - Unanimous,80,55,0,135
James Vick,2019-10-12,Niko Price,KO/TKO,0,0,0,0
James Vick,2013-08-17,Ramsey Nijem,Submission,90,0,0,90
James Vick,2014-11-22,Nick Hein,Decision - Unanimous,80,15,0,95
James Vick,2018-08-25,Justin Gaethje,KO/TKO,0,3,25,28
James Vick,2019-02-17,Paul Felder,Decision - Unanimous,0,6,0,6
James Vick,2019-07-20,Dan Hooker,KO/TKO,0,0,0,0
James Vick,2017-02-04,Abel Trujillo,Submission,90,14,0,104
James Vick,2018-02-18,Francisco Trinaldo,Decision - Unanimous,80,42,0,122
James Vick,2017-05-13,Marco Polo Reyes,KO/TKO,100,4,0,104
James Vick,2015-05-09,Jake Matthews,Submission,90,6,0,96
James Vick,2016-06-04,Beneil Dariush,KO/TKO,0,0,0,0
James Vick,2014-08-23,Valmir Lazaro,Decision - Unanimous,80,0,0,80
James Vick,2017-11-04,Joe Duffy,KO/TKO,100,17,0,117
Samandar Murodov,2024-08-23,Jonathan Piersma,Decision - Unanimous,80,7,0,87
Samandar Murodov,2022-10-23,Gian Siqueira,Submission,90,13,0,103
Jonathan Piersma,2024-08-23,Samandar Murodov,Decision - Unanimous,0,0,0,0
Gary Goodridge,1996-02-16,Jerry Bohlander,KO/TKO,100,2,0,102
Gary Goodridge,1997-10-11,Oleg Taktarov,KO/TKO,100,12,0,112
Gary Goodridge,2001-07-29,Antonio Rodrigo Nogueira,Submission,0,0,0,0
Gary Goodridge,2003-08-10,Fedor Emelianenko,KO/TKO,0,0,0,0
Gary Goodridge,2008-11-09,Alistair Overeem,Submission,0,0,0,0
Gary Goodridge,2002-08-28,Lloyd Van Dams,KO/TKO,100,11,0,111
Gary Goodridge,2000-10-31,Yoshiaki Yatsu,KO/TKO,100,66,0,166
Gary Goodridge,1996-05-17,Mark Schultz,TKO - Doctor's Stoppage,0,0,0,0
Gary Goodridge,1999-11-21,Tom Erikson,Decision - Unanimous,0,0,0,0
Gary Goodridge,1996-07-12,John Campetella,KO/TKO,100,0,0,100
Gary Goodridge,1996-07-12,Mark Coleman,Submission,0,0,0,0
Gary Goodridge,1998-10-11,Igor Vovchanchyn,KO/TKO,0,0,0,0
Gary Goodridge,2000-06-04,Ricco Rodriguez,Decision - Unanimous,0,0,0,0
Gary Goodridge,2003-11-09,Dan Bobish,KO/TKO,100,8,0,108
Gary Goodridge,1999-07-04,Naoya Ogawa,Submission,0,3,0,3
Gary Goodridge,1996-12-07,Don Frye,Submission,0,0,0,0
Gary Goodridge,2000-01-30,Osamu Tachihikari,Submission,90,9,0,99
Gary Goodridge,2003-12-31,Don Frye,KO/TKO,100,4,0,104
Gary Goodridge,1996-02-16,Don Frye,KO/TKO,0,0,0,0
Gary Goodridge,1996-02-16,Paul Herrera,KO/TKO,100,8,0,108
Gary Goodridge,2002-06-23,Achmed Labasanov,Decision - Split,70,7,0,77
Gary Goodridge,1998-06-24,Amir Rahnavardi,KO/TKO,100,17,0,117
Gary Goodridge,2009-12-31,Gegard Mousasi,KO/TKO,0,0,0,0
Gary Goodridge,2001-09-24,Yoshiaki Yatsu,KO/TKO,100,17,0,117
Gary Goodridge,2000-08-27,Gilbert Yvel,KO/TKO,0,0,0,0
Gary Goodridge,1998-03-05,Marco Ruas,Submission,0,8,0,8
Gary Goodridge,1999-03-05,Andre Roberts,KO/TKO,100,6,0,106
Gary Goodridge,2000-05-01,Igor Vovchanchyn,KO/TKO,0,0,0,0
Gary Goodridge,2001-05-27,Valentijn Overeem,KO/TKO,100,5,0,105
Jerry Bohlander,1996-02-16,Gary Goodridge,KO/TKO,0,0,0,0
Jerry Bohlander,1998-03-13,Kevin Jackson,Submission,90,0,0,90
Jerry Bohlander,1996-02-16,Scott Ferrozzo,Submission,90,0,0,90
Jerry Bohlander,1996-09-20,Fabio Gurgel,Decision - Unanimous,80,16,0,96
Jerry Bohlander,1999-01-08,Tito Ortiz,TKO - Doctor's Stoppage,0,0,0,0
Jerry Bohlander,1997-02-07,Nick Sanzo,Submission,90,2,0,92
Jerry Bohlander,1997-02-07,Rainy Martinez,Submission,90,0,0,90
Motonobu Tezuka,2013-02-16,Vaughan Lee,Decision - Unanimous,0,0,0,0
Motonobu Tezuka,2012-11-10,Alex Caceres,Decision - Split,0,0,0,0
Chuck Liddell,2006-12-30,Tito Ortiz,KO/TKO,100,28,25,153
Chuck Liddell,2001-05-27,Guy Mezger,KO/TKO,100,0,0,100
Chuck Liddell,2006-08-26,Renato Sobral,KO/TKO,100,16,25,141
Chuck Liddell,2004-08-21,Vernon White,KO/TKO,100,18,0,118
Chuck Liddell,1998-05-15,Noe Hernandez,Decision - Unanimous,80,37,0,117
Chuck Liddell,2009-04-18,Mauricio Rua,KO/TKO,0,0,0,0
Chuck Liddell,2003-06-06,Randy Couture,KO/TKO,0,0,25,25
Chuck Liddell,1999-09-24,Paul Jones,TKO - Doctor's Stoppage,0,8,0,8
Chuck Liddell,2003-11-09,Quinton Jackson,KO/TKO,0,0,0,0
Chuck Liddell,2001-05-04,Kevin Randleman,KO/TKO,100,3,0,103
Chuck Liddell,1999-03-05,Jeremy Horn,Submission,0,4,0,4
Chuck Liddell,2001-09-28,Murilo Bustamante,Decision - Unanimous,80,12,0,92
Chuck Liddell,2000-12-16,Jeff Monson,Decision - Unanimous,80,36,0,116
Chuck Liddell,2002-11-22,Renato Sobral,KO/TKO,100,3,0,103
Chuck Liddell,2010-06-12,Rich Franklin,KO/TKO,0,0,0,0
Chuck Liddell,2007-05-26,Quinton Jackson,KO/TKO,0,0,25,25
Chuck Liddell,2005-08-20,Jeremy Horn,KO/TKO,100,33,25,158
Chuck Liddell,2003-08-10,Alistair Overeem,KO/TKO,100,6,0,106
Chuck Liddell,2008-09-06,Rashad Evans,KO/TKO,0,0,0,0
Chuck Liddell,2004-04-02,Tito Ortiz,KO/TKO,100,10,0,110
Chuck Liddell,2002-06-22,Vitor Belfort,Decision - Unanimous,80,23,0,103
Chuck Liddell,2007-12-29,Wanderlei Silva,Decision - Unanimous,80,14,0,94
Chuck Liddell,2005-04-16,Randy Couture,KO/TKO,100,4,25,129
Chuck Liddell,2002-01-11,Amar Suloev,Decision - Unanimous,80,20,0,100
Chuck Liddell,2006-02-04,Randy Couture,KO/TKO,100,12,25,137
Chuck Liddell,2007-09-22,Keith Jardine,Decision - Split,0,0,0,0
Michael Johnson,2021-02-06,Clay Guida,Decision - Unanimous,0,9,0,9
Michael Johnson,2012-01-28,Shane Roller,Decision - Unanimous,80,8,0,88
Michael Johnson,2018-10-27,Artem Lobov,Decision - Unanimous,80,32,0,112
Michael Johnson,2010-12-04,Jonathan Brookins,Decision - Unanimous,0,0,0,0
Michael Johnson,2011-06-26,Edward Faaloloto,KO/TKO,100,10,0,110
Michael Johnson,2018-01-14,Darren Elkins,Submission,0,27,0,27
Michael Johnson,2015-02-22,Edson Barboza,Decision - Unanimous,80,7,0,87
Michael Johnson,2015-08-08,Beneil Dariush,Decision - Split,0,9,0,9
Michael Johnson,2016-11-12,Khabib Nurmagomedov,Submission,0,0,0,0
Michael Johnson,2013-04-06,Reza Madadi,Submission,0,0,0,0
Michael Johnson,2013-12-28,Gleison Tibau,KO/TKO,100,10,0,110
Michael Johnson,2022-07-09,Jamie Mullarkey,Decision - Split,0,0,0,0
Michael Johnson,2024-12-14,Ottman Azaitar,KO/TKO,100,3,0,103
Michael Johnson,2022-12-03,Marc Diakiese,Decision - Unanimous,80,28,0,108
Michael Johnson,2022-05-14,Alan Patrick,KO/TKO,100,8,0,108
Michael Johnson,2020-05-13,Thiago Moises,Submission,0,26,0,26
Michael Johnson,2012-12-29,Myles Jury,Decision - Unanimous,0,0,0,0
Michael Johnson,2014-03-08,Melvin Guillard,Decision - Unanimous,80,26,0,106
Michael Johnson,2011-10-01,Paul Sass,Submission,0,6,0,6
Michael Johnson,2016-09-17,Dustin Poirier,KO/TKO,100,8,25,133
Michael Johnson,2019-03-30,Josh Emmett,KO/TKO,0,2,0,2
Michael Johnson,2024-02-10,Darrius Flowers,Decision - Unanimous,80,28,0,108
Michael Johnson,2015-12-19,Nate Diaz,Decision - Unanimous,0,0,0,0
Michael Johnson,2018-08-25,Andre Fili,Decision - Split,70,28,0,98
Michael Johnson,2013-08-17,Joe Lauzon,Decision - Unanimous,80,91,0,171
Michael Johnson,2012-10-05,Danny Castillo,KO/TKO,100,0,0,100
Michael Johnson,2019-10-26,Stevie Ray,Decision - Majority,0,0,0,0
Michael Johnson,2012-05-05,Tony Ferguson,Decision - Unanimous,80,22,0,102
Michael Johnson,2023-05-20,Diego Ferreira,KO/TKO,0,2,0,2
Michael Johnson,2017-07-07,Justin Gaethje,KO/TKO,0,0,25,25
Sergio Moraes,2017-03-11,Davi Ramos,Decision - Unanimous,80,4,0,84
Sergio Moraes,2016-11-19,Zak Ottow,Decision - Split,70,0,0,70
Sergio Moraes,2018-02-03,Tim Means,Decision - Split,70,0,0,70
Sergio Moraes,2018-09-22,Ben Saunders,Submission,90,1,0,91
Sergio Moraes,2019-11-16,James Krause,KO/TKO,0,0,0,0
Sergio Moraes,2012-06-23,Cezar Ferreira,Decision - Unanimous,0,0,0,0
Sergio Moraes,2015-04-11,Mickael Lebout,Decision - Unanimous,80,4,0,84
Sergio Moraes,2012-10-13,Renee Forte,Submission,90,0,0,90
Sergio Moraes,2019-03-09,Anthony Rocco Martin,Decision - Unanimous,0,0,0,0
Sergio Moraes,2017-09-16,Kamaru Usman,KO/TKO,0,0,0,0
Sergio Moraes,2013-08-03,Neil Magny,Submission,90,6,0,96
Sergio Moraes,2019-05-11,Warlley Alves,KO/TKO,0,0,0,0
Sergio Moraes,2015-12-10,Omari Akhmedov,KO/TKO,100,0,0,100
Andre Lima,2024-03-23,Igor Severino,DQ,0,0,0,0
Andre Lima,2024-06-01,Mitch Raposo,Decision - Split,70,19,0,89
Andre Lima,2023-10-10,Rickson Zenidim,Decision - Unanimous,80,36,0,116
Andre Lima,2024-09-07,Felipe dos Santos,Decision - Unanimous,80,0,0,80
Igor Severino,2024-03-23,Andre Lima,DQ,0,6,0,6
Igor Severino,2023-09-19,Jhonata Silva,KO/TKO,100,38,0,138
Shuya Kamikubo,2023-08-27,Xiao Long,Decision - Majority,0,0,0,0
Shuya Kamikubo,2023-05-28,Baergeng Jieleyisi,Decision - Split,70,20,0,90
Eric Schafer,2007-10-20,Stephan Bonnar,KO/TKO,0,0,0,0
Eric Schafer,2006-08-26,Rob MacDonald,Submission,90,5,0,95
Eric Schafer,2006-12-30,Michael Bisping,KO/TKO,0,0,0,0
Eric Schafer,2011-10-08,Aaron Simpson,Decision - Unanimous,0,0,0,0
Eric Schafer,2010-03-21,Jason Brilz,Decision - Unanimous,0,0,0,0
Eric Schafer,2009-10-24,Ryan Bader,Decision - Unanimous,0,0,0,0
Eric Schafer,2008-09-17,Houston Alexander,Submission,90,12,0,102
Eric Schafer,2009-01-17,Antonio Mendes,KO/TKO,100,19,0,119
Eric Schafer,2012-01-20,Jorge Rivera,KO/TKO,0,0,0,0
Georges St-Pierre,2005-04-16,Jason Miller,Decision - Unanimous,80,48,0,128
Georges St-Pierre,2010-12-11,Josh Koscheck,Decision - Unanimous,80,94,25,199
Georges St-Pierre,2013-03-16,Nick Diaz,Decision - Unanimous,80,64,25,169
Georges St-Pierre,2017-11-04,Michael Bisping,Submission,90,32,25,147
Georges St-Pierre,2002-10-11,Travis Galbraith,KO/TKO,100,12,0,112
Georges St-Pierre,2010-03-27,Dan Hardy,Decision - Unanimous,80,55,25,160
Georges St-Pierre,2005-08-20,Frank Trigg,Submission,90,24,0,114
Georges St-Pierre,2009-07-11,Thiago Alves,Decision - Unanimous,80,29,25,134
Georges St-Pierre,2004-06-19,Jay Hieron,KO/TKO,100,19,0,119
Georges St-Pierre,2008-08-09,Jon Fitch,Decision - Unanimous,80,94,25,199
Georges St-Pierre,2009-01-31,BJ Penn,KO/TKO,100,76,25,201
Georges St-Pierre,2007-04-07,Matt Serra,KO/TKO,0,0,25,25
Georges St-Pierre,2011-04-30,Jake Shields,Decision - Unanimous,80,7,25,112
Georges St-Pierre,2012-11-17,Carlos Condit,Decision - Unanimous,80,35,25,140
Georges St-Pierre,2005-01-29,Dave Strasser,Submission,90,1,0,91
Georges St-Pierre,2006-03-04,BJ Penn,Decision - Split,70,22,0,92
Georges St-Pierre,2013-11-16,Johny Hendricks,Decision - Split,70,16,25,111
Georges St-Pierre,2007-12-29,Matt Hughes,Submission,90,23,25,138
Georges St-Pierre,2003-11-29,Pete Spratt,Submission,90,4,0,94
Georges St-Pierre,2004-10-22,Matt Hughes,Submission,0,2,25,27
Georges St-Pierre,2008-04-19,Matt Serra,KO/TKO,100,39,25,164
Georges St-Pierre,2007-08-25,Josh Koscheck,Decision - Unanimous,80,34,0,114
Georges St-Pierre,2003-01-25,Thomas Denny,KO/TKO,100,17,0,117
Georges St-Pierre,2002-01-25,Ivan Menjivar,KO/TKO,100,9,0,109
Georges St-Pierre,2002-06-15,Justin Bruckmann,Submission,90,18,0,108
Georges St-Pierre,2005-11-19,Sean Sherk,KO/TKO,100,38,0,138
Georges St-Pierre,2004-01-31,Karo Parisyan,Decision - Unanimous,80,45,0,125
Georges St-Pierre,2006-11-18,Matt Hughes,KO/TKO,100,35,25,160
Jason Miller,2005-04-16,Georges St-Pierre,Decision - Unanimous,0,0,0,0
Jason Miller,2011-12-03,Michael Bisping,KO/TKO,0,0,25,25
Jason Miller,2012-05-26,CB Dollaway,Decision - Unanimous,0,0,0,0
Jason Miller,2007-05-12,Hiromitsu Miura,Decision - Unanimous,80,8,0,88
Jason Miller,2008-05-11,Katsuyori Shibata,KO/TKO,100,38,0,138
Jason Miller,2010-09-25,Kazushi Sakuraba,Submission,90,13,0,103
Jason Miller,2006-07-22,Lodune Sincaid,Submission,90,7,0,97
Jason Miller,2009-11-07,Jake Shields,Decision - Unanimous,0,13,25,38
Jason Miller,2008-06-15,Jacare Souza,Decision - Unanimous,0,5,0,5
Myles Jury,2015-01-03,Donald Cerrone,Decision - Unanimous,0,0,0,0
Myles Jury,2014-03-15,Diego Sanchez,Decision - Unanimous,80,21,0,101
Myles Jury,2018-07-14,Chad Mendes,KO/TKO,0,0,0,0
Myles Jury,2013-09-21,Mike Ricci,Decision - Split,70,0,0,70
Myles Jury,2012-12-29,Michael Johnson,Decision - Unanimous,80,50,0,130
Myles Jury,2013-04-20,Ramsey Nijem,KO/TKO,100,0,0,100
Myles Jury,2014-09-20,Takanori Gomi,KO/TKO,100,9,0,109
Myles Jury,2012-06-01,Chris Saunders,Submission,90,6,0,96
Myles Jury,2017-04-08,Mike de la Torre,KO/TKO,100,36,0,136
Myles Jury,2015-12-19,Charles Oliveira,Submission,0,0,0,0
Myles Jury,2017-12-30,Ricky Glenn,Decision - Unanimous,80,27,0,107
Myles Jury,2019-02-17,Andre Fili,Decision - Unanimous,0,0,0,0
Luke Stewart,2007-09-29,Sam Liera,KO/TKO,100,24,0,124
Luke Stewart,2006-10-07,Jeremiah Metcalf,Submission,90,2,0,92
Luke Stewart,2008-11-21,Joe Riggs,KO/TKO,0,0,0,0
Luke Stewart,2008-09-20,Jesse Juarez,Submission,90,0,0,90
Luke Stewart,2007-06-22,Jason Von Flue,KO/TKO,100,56,0,156
Luke Stewart,2007-11-16,Bryson Kamaka,KO/TKO,100,1,0,101
Luke Stewart,2006-06-09,Bill Duvall,Submission,90,3,0,93
Sam Liera,2007-09-29,Luke Stewart,KO/TKO,0,0,0,0
Curtis Blaydes,2021-09-25,Jairzinho Rozenstruik,Decision - Unanimous,80,14,0,94
Curtis Blaydes,2024-07-27,Tom Aspinall,KO/TKO,0,0,25,25
Curtis Blaydes,2022-07-23,Tom Aspinall,KO/TKO,100,1,25,126
Curtis Blaydes,2017-07-08,Daniel Omielanczuk,Decision - Unanimous,80,21,0,101
Curtis Blaydes,2018-02-10,Mark Hunt,Decision - Unanimous,80,42,0,122
Curtis Blaydes,2022-03-26,Chris Daukaus,KO/TKO,100,17,25,142
Curtis Blaydes,2021-02-20,Derrick Lewis,KO/TKO,0,21,25,46
Curtis Blaydes,2016-04-10,Francis Ngannou,TKO - Doctor's Stoppage,0,0,0,0
Curtis Blaydes,2019-03-23,Justin Willis,Decision - Unanimous,80,20,0,100
Curtis Blaydes,2017-11-04,Aleksei Oleinik,TKO - Doctor's Stoppage,0,5,0,5
Curtis Blaydes,2023-04-22,Sergei Pavlovich,KO/TKO,0,0,25,25
Curtis Blaydes,2018-06-09,Alistair Overeem,KO/TKO,100,30,0,130
Curtis Blaydes,2016-10-01,Cody East,KO/TKO,100,31,0,131
Curtis Blaydes,2018-11-24,Francis Ngannou,KO/TKO,0,0,25,25
Curtis Blaydes,2020-06-20,Alexander Volkov,Decision - Unanimous,80,38,25,143
Curtis Blaydes,2019-09-07,Shamil Abdurakhimov,KO/TKO,100,22,0,122
Curtis Blaydes,2020-01-25,Junior Dos Santos,KO/TKO,100,21,25,146
Curtis Blaydes,2024-03-09,Jailton Almeida,KO/TKO,100,15,0,115
Anthony Njokuani,2009-12-19,Chris Horodecki,KO/TKO,100,20,0,120
Anthony Njokuani,2011-07-02,Andre Winner,Decision - Unanimous,80,101,0,181
Anthony Njokuani,2010-04-24,Shane Roller,Submission,0,0,0,0
Anthony Njokuani,2009-01-25,Benson Henderson,Submission,0,0,0,0
Anthony Njokuani,2014-10-04,Daron Cruickshank,Decision - Unanimous,0,0,0,0
Anthony Njokuani,2009-10-10,Muhsin Corbbrey,KO/TKO,100,27,0,127
Anthony Njokuani,2011-12-30,Danny Castillo,Decision - Split,0,11,0,11
Anthony Njokuani,2013-04-20,Roger Bowling,KO/TKO,100,0,0,100
Anthony Njokuani,2011-03-19,Edson Barboza,Decision - Unanimous,0,26,0,26
Anthony Njokuani,2012-07-11,Rafael Dos Anjos,Decision - Unanimous,0,0,0,0
Anthony Njokuani,2012-04-21,John Makdessi,Decision - Unanimous,80,34,0,114
Anthony Njokuani,2014-05-24,Vinc Pichel,Decision - Unanimous,0,0,0,0
Anthony Njokuani,2010-08-18,Maciej Jewtuszko,KO/TKO,0,0,0,0
Anthony Njokuani,2010-11-11,Edward Faaloloto,KO/TKO,100,44,0,144
Anthony Njokuani,2009-04-05,Bart Palaszewski,KO/TKO,100,29,0,129
Chris Horodecki,2009-12-19,Anthony Njokuani,KO/TKO,0,0,0,0
Chris Horodecki,2010-06-20,Danny Downes,Submission,90,48,0,138
Chris Horodecki,2007-11-03,Bart Palaszewski,Decision - Split,70,32,0,102
Chris Horodecki,2010-09-30,Ed Ratcliff,Decision - Split,70,7,0,77
Chris Horodecki,2010-12-16,Donald Cerrone,Submission,0,4,0,4
Derek Brunson,2016-09-17,Uriah Hall,KO/TKO,100,3,0,103
Derek Brunson,2016-02-21,Roan Carneiro,KO/TKO,100,23,0,123
Derek Brunson,2018-11-03,Israel Adesanya,KO/TKO,0,0,0,0
Derek Brunson,2017-02-11,Anderson Silva,Decision - Unanimous,0,11,0,11
Derek Brunson,2023-03-04,Dricus Du Plessis,KO/TKO,0,0,0,0
Derek Brunson,2014-08-30,Lorenz Larkin,Decision - Unanimous,80,0,0,80
Derek Brunson,2012-12-29,Chris Leben,Decision - Unanimous,80,1,0,81
Derek Brunson,2015-01-31,Ed Herman,KO/TKO,100,11,0,111
Derek Brunson,2017-06-10,Daniel Kelly,KO/TKO,100,7,0,107
Derek Brunson,2019-05-04,Elias Theodorou,Decision - Unanimous,80,0,0,80
Derek Brunson,2015-08-08,Sam Alvey,KO/TKO,100,23,0,123
Derek Brunson,2011-11-18,Nate James,Decision - Unanimous,80,20,0,100
Derek Brunson,2014-01-15,Yoel Romero,KO/TKO,0,0,0,0
Derek Brunson,2016-11-26,Robert Whittaker,KO/TKO,0,0,25,25
Derek Brunson,2017-10-28,Lyoto Machida,KO/TKO,100,7,25,132
Derek Brunson,2018-01-27,Jacare Souza,KO/TKO,0,0,25,25
Derek Brunson,2021-03-20,Kevin Holland,Decision - Unanimous,80,7,25,112
Derek Brunson,2019-08-17,Ian Heinisch,Decision - Unanimous,80,23,0,103
Derek Brunson,2013-11-06,Brian Houston,Submission,90,1,0,91
Derek Brunson,2022-02-12,Jared Cannonier,KO/TKO,0,0,0,0
Derek Brunson,2021-09-04,Darren Till,Submission,90,15,25,130
Derek Brunson,2020-08-01,Edmen Shahbazyan,KO/TKO,100,53,0,153
Derek Brunson,2012-08-18,Jacare Souza,KO/TKO,0,0,0,0
Mickey Gall,2019-08-03,Salim Touahri,Decision - Unanimous,80,2,0,82
Mickey Gall,2020-06-27,Mike Perry,Decision - Unanimous,0,0,0,0
Mickey Gall,2016-02-06,Mike Jackson,Submission,90,0,0,90
Mickey Gall,2017-11-04,Randy Brown,Decision - Unanimous,0,0,0,0
Mickey Gall,2019-03-02,Diego Sanchez,KO/TKO,0,0,0,0
Mickey Gall,2024-06-01,Bassil Hafez,Decision - Unanimous,0,0,0,0
Mickey Gall,2022-04-09,Mike Malott,KO/TKO,0,0,0,0
Mickey Gall,2018-08-25,George Sullivan,Submission,90,0,0,90
Mickey Gall,2021-12-04,Alex Morono,Decision - Unanimous,0,0,0,0
Mickey Gall,2016-09-10,CM Punk,Submission,90,20,0,110
Mickey Gall,2016-12-17,Sage Northcutt,Submission,90,0,0,90
Mickey Gall,2021-07-24,Jordan Williams,Submission,90,0,0,90
Mickey Gall,2024-11-16,Ramiz Brahimaj,KO/TKO,0,0,0,0
Salim Touahri,2019-08-03,Mickey Gall,Decision - Unanimous,0,0,0,0
Salim Touahri,2018-12-01,Keita Nakamura,Decision - Split,0,0,0,0
Salim Touahri,2017-10-21,Warlley Alves,Decision - Unanimous,0,0,0,0
Daniel Pineda,2012-01-20,Pat Schilling,Submission,90,15,0,105
Daniel Pineda,2012-05-26,Mike Brown,Decision - Unanimous,0,0,0,0
Daniel Pineda,2023-03-25,Tucker Lutz,Submission,90,0,0,90
Daniel Pineda,2013-04-13,Justin Lawrence,Submission,90,1,0,91
Daniel Pineda,2013-08-17,Diego Brandao,Decision - Unanimous,0,19,0,19
Daniel Pineda,2023-06-03,Alex Caceres,Decision - Unanimous,0,0,0,0
Daniel Pineda,2012-07-21,Antonio Carvalho,KO/TKO,0,0,0,0
Daniel Pineda,2012-03-02,Mackens Semerzier,Submission,90,5,0,95
Daniel Pineda,2014-03-15,Robert Whiteford,Decision - Unanimous,0,0,0,0
Daniel Pineda,2024-07-27,Nathaniel Wood,Decision - Unanimous,0,0,0,0
Daniel Pineda,2020-08-15,Herbert Burns,KO/TKO,100,47,0,147
Daniel Pineda,2024-10-19,Darren Elkins,Decision - Unanimous,0,0,0,0
Daniel Pineda,2020-12-12,Cub Swanson,KO/TKO,0,0,0,0
Jessica Andrade,2021-09-25,Cynthia Calvillo,KO/TKO,100,21,0,121
Jessica Andrade,2023-08-05,Tatiana Suarez,Submission,0,0,0,0
Jessica Andrade,2017-09-22,Claudia Gadelha,Decision - Unanimous,80,99,0,179
Jessica Andrade,2020-10-17,Katlyn Cerminara,KO/TKO,100,9,0,109
Jessica Andrade,2020-07-11,Rose Namajunas,Decision - Split,0,0,0,0
Jessica Andrade,2016-06-04,Jessica Penne,KO/TKO,100,90,0,190
Jessica Andrade,2023-02-18,Erin Blanchfield,Submission,0,2,25,27
Jessica Andrade,2018-09-08,Karolina Kowalkiewicz,KO/TKO,100,14,0,114
Jessica Andrade,2015-07-15,Sarah Moras,Decision - Unanimous,80,32,0,112
Jessica Andrade,2013-07-27,Liz Carmouche,KO/TKO,0,0,0,0
Jessica Andrade,2024-09-07,Natalia Silva,Decision - Unanimous,0,0,0,0
Jessica Andrade,2014-03-15,Raquel Pennington,Decision - Split,70,0,0,70
Jessica Andrade,2015-02-22,Marion Reneau,Submission,0,0,0,0
Jessica Andrade,2023-11-11,Mackenzie Dern,KO/TKO,100,4,0,104
Jessica Andrade,2024-04-13,Marina Rodriguez,Decision - Split,70,7,0,77
Jessica Andrade,2013-10-26,Rosi Sexton,Decision - Unanimous,80,118,0,198
Jessica Andrade,2016-09-10,Joanne Wood,Submission,90,7,0,97
Jessica Andrade,2018-02-24,Tecia Pennington,Decision - Unanimous,80,23,0,103
Jessica Andrade,2017-02-04,Angela Hill,Decision - Unanimous,80,42,0,122
Jessica Andrade,2022-04-23,Amanda Lemos,Submission,90,0,25,115
Jessica Andrade,2019-08-31,Zhang Weili,KO/TKO,0,0,25,25
Jessica Andrade,2021-04-24,Valentina Shevchenko,KO/TKO,0,0,25,25
Jessica Andrade,2014-09-13,Larissa Pacheco,Submission,90,13,0,103
Jessica Andrade,2015-09-05,Raquel Pennington,Submission,0,0,0,0
Jessica Andrade,2023-05-06,Yan Xiaonan,KO/TKO,0,0,0,0
Jessica Andrade,2017-05-13,Joanna Jedrzejczyk,Decision - Unanimous,0,0,25,25
Jessica Andrade,2019-05-11,Rose Namajunas,KO/TKO,100,0,25,125
Jessica Andrade,2023-01-21,Lauren Murphy,Decision - Unanimous,80,131,0,211
Luis Gomez,2017-07-25,Dan Ige,Submission,0,0,0,0
Gray Maynard,2010-08-28,Kenny Florian,Decision - Unanimous,80,1,0,81
Gray Maynard,2013-11-30,Nate Diaz,KO/TKO,0,0,0,0
Gray Maynard,2014-08-16,Ross Pearson,KO/TKO,0,0,0,0
Gray Maynard,2007-09-19,Joe Veres,KO/TKO,100,3,0,103
Gray Maynard,2009-09-16,Roger Huerta,Decision - Split,70,0,0,70
Gray Maynard,2013-05-25,TJ Grant,KO/TKO,0,0,0,0
Gray Maynard,2018-10-06,Nik Lentz,KO/TKO,0,0,0,0
Gray Maynard,2011-10-08,Frankie Edgar,KO/TKO,0,0,25,25
Gray Maynard,2017-07-07,Teruto Ishihara,Decision - Unanimous,80,8,0,88
Gray Maynard,2015-04-04,Alexander Yakovlev,Decision - Unanimous,0,0,0,0
Gray Maynard,2008-01-23,Dennis Siver,Decision - Unanimous,80,10,0,90
Gray Maynard,2009-03-07,Jim Miller,Decision - Unanimous,80,12,0,92
Gray Maynard,2010-01-11,Nate Diaz,Decision - Split,70,0,0,70
Gray Maynard,2016-07-08,Fernando Bruno,Decision - Unanimous,80,0,0,80
Gray Maynard,2008-10-25,Rich Clementi,Decision - Unanimous,80,15,0,95
Gray Maynard,2008-04-02,Frankie Edgar,Decision - Unanimous,80,0,0,80
Gray Maynard,2012-06-22,Clay Guida,Decision - Split,70,4,25,99
Gray Maynard,2016-12-03,Ryan Hall,Decision - Unanimous,0,0,0,0
Kenny Florian,2010-08-28,Gray Maynard,Decision - Unanimous,0,0,0,0
Kenny Florian,2006-10-14,Sean Sherk,Decision - Unanimous,0,0,25,25
Kenny Florian,2005-04-09,Diego Sanchez,KO/TKO,0,0,0,0
Kenny Florian,2008-08-09,Roger Huerta,Decision - Unanimous,80,18,0,98
Kenny Florian,2005-08-06,Alex Karalexis,TKO - Doctor's Stoppage,0,20,0,20
Kenny Florian,2011-06-11,Diego Nunes,Decision - Unanimous,80,11,0,91
Kenny Florian,2007-04-05,Dokonjonosuke Mishima,Submission,90,32,0,122
Kenny Florian,2004-02-21,Bobby McAndrews,Submission,90,0,0,90
Kenny Florian,2009-12-12,Clay Guida,Submission,90,9,0,99
Kenny Florian,2010-03-31,Takanori Gomi,Submission,90,31,0,121
Kenny Florian,2008-11-15,Joe Stevenson,Submission,90,11,0,101
Kenny Florian,2006-06-24,Sam Stout,Submission,90,5,0,95
Kenny Florian,2009-08-08,BJ Penn,Submission,0,0,25,25
Kenny Florian,2007-09-19,Din Thomas,Submission,90,24,0,114
Kenny Florian,2008-04-02,Joe Lauzon,KO/TKO,100,30,0,130
Kenny Florian,2011-10-08,Jose Aldo,Decision - Unanimous,0,0,25,25
Kenny Florian,2007-07-07,Alvin Robinson,KO/TKO,100,14,0,114
Kenny Florian,2005-11-05,Kit Cope,Submission,90,2,0,92
Liang Na,2022-06-11,Silvana Gomez Juarez,KO/TKO,0,0,0,0
Liang Na,2021-04-24,Ariane Carnelossi,KO/TKO,0,0,0,0
Liang Na,2023-08-26,JJ Aldrich,KO/TKO,0,0,0,0
Liang Na,2024-04-27,Ivana Petrovic,Submission,0,0,0,0
Rick Story,2010-01-11,Jesse Lennox,Decision - Split,70,25,0,95
Rick Story,2009-06-13,John Hathaway,Decision - Unanimous,0,0,0,0
Rick Story,2010-12-04,Johny Hendricks,Decision - Unanimous,80,31,0,111
Rick Story,2014-10-04,Gunnar Nelson,Decision - Split,70,115,25,210
Rick Story,2013-05-25,Mike Pyle,Decision - Split,0,24,0,24
Rick Story,2014-07-16,Leonardo Mafra,Submission,90,13,0,103
Rick Story,2016-05-29,Tarec Saffiedine,Decision - Unanimous,80,26,0,106
Rick Story,2013-11-16,Brian Ebersole,Decision - Unanimous,80,29,0,109
Rick Story,2013-03-16,Quinn Mulhern,KO/TKO,100,11,0,111
Rick Story,2011-11-19,Martin Kampmann,Decision - Split,0,23,0,23
Rick Story,2009-09-19,Brian Foster,Submission,90,12,0,102
Rick Story,2011-05-28,Thiago Alves,Decision - Unanimous,80,21,0,101
Rick Story,2016-08-20,Donald Cerrone,KO/TKO,0,0,0,0
Rick Story,2010-08-07,Dustin Hazelett,KO/TKO,100,68,0,168
Rick Story,2014-03-15,Kelvin Gastelum,Decision - Split,0,0,0,0
Rick Story,2010-04-10,Nick Osipczak,Decision - Split,70,3,0,73
Rick Story,2012-06-22,Brock Jardine,Decision - Unanimous,80,33,0,113
Rick Story,2012-10-13,Demian Maia,Submission,0,0,0,0
Rick Story,2011-06-26,Charlie Brenneman,Decision - Unanimous,0,6,0,6
Jordan Rinaldi,2016-05-29,Abel Trujillo,Decision - Unanimous,0,0,0,0
Jordan Rinaldi,2017-08-05,Alvaro Herrera Mendoza,Submission,90,4,0,94
Jordan Rinaldi,2018-01-27,Gregor Gillespie,KO/TKO,0,0,0,0
Jordan Rinaldi,2019-03-16,Arnold Allen,Decision - Unanimous,0,0,0,0
Jordan Rinaldi,2018-11-03,Jason Knight,Decision - Unanimous,80,8,0,88
Atsushi Yamamoto,2011-05-29,Yusaku Nakamura,KO/TKO,100,17,0,117
Atsushi Yamamoto,2008-09-23,Hideo Tokoro,Decision - Unanimous,80,23,0,103
Atsushi Yamamoto,2011-05-29,Hideo Tokoro,Decision - Split,0,0,0,0
Atsushi Yamamoto,2009-03-08,Masakazu Imanari,Decision - Split,0,7,0,7
Yusaku Nakamura,2011-05-29,Atsushi Yamamoto,KO/TKO,0,0,0,0
Moti Horenstein,1997-07-27,Mark Kerr,KO/TKO,0,0,0,0
Moti Horenstein,1996-07-12,Mark Coleman,KO/TKO,0,0,0,0
Casey Kenney,2021-03-06,Dominick Cruz,Decision - Split,0,0,0,0
Casey Kenney,2020-10-24,Nathaniel Wood,Decision - Unanimous,80,0,0,80
Casey Kenney,2017-07-18,CJ Hamilton,Decision - Unanimous,80,22,0,102
Casey Kenney,2020-10-03,Alatengheili,Decision - Unanimous,80,63,0,143
Casey Kenney,2021-08-07,Song Yadong,Decision - Split,0,0,0,0
Casey Kenney,2019-03-30,Ray Borg,Decision - Unanimous,80,15,0,95
Casey Kenney,2020-05-30,Louis Smolka,Submission,90,14,0,104
Casey Kenney,2020-02-15,Merab Dvalishvili,Decision - Unanimous,0,0,0,0
Casey Kenney,2019-08-17,Manny Bermudez,Decision - Unanimous,80,6,0,86
Casey Kenney,2017-08-29,Adam Antolin,Decision - Split,0,0,0,0
Johny Hendricks,2008-12-03,Justin Haskins,KO/TKO,100,6,0,106
Johny Hendricks,2009-03-01,Alex Serdyukov,Decision - Unanimous,80,0,0,80
Johny Hendricks,2010-05-08,TJ Grant,Decision - Majority,75,0,0,75
Johny Hendricks,2010-12-04,Rick Story,Decision - Unanimous,0,0,0,0
Johny Hendricks,2014-03-15,Robbie Lawler,Decision - Unanimous,80,8,25,113
Johny Hendricks,2011-12-30,Jon Fitch,KO/TKO,100,2,0,102
Johny Hendricks,2009-12-12,Ricardo Funch,Decision - Unanimous,80,33,0,113
Johny Hendricks,2016-12-30,Neil Magny,Decision - Unanimous,0,0,0,0
Johny Hendricks,2012-05-05,Josh Koscheck,Decision - Split,70,22,0,92
Johny Hendricks,2017-02-19,Hector Lombard,Decision - Unanimous,80,14,0,94
Johny Hendricks,2011-03-26,TJ Waldburger,KO/TKO,100,4,0,104
Johny Hendricks,2016-07-09,Kelvin Gastelum,Decision - Unanimous,0,0,0,0
Johny Hendricks,2011-08-06,Mike Pierce,Decision - Split,70,17,0,87
Johny Hendricks,2013-11-16,Georges St-Pierre,Decision - Split,0,0,25,25
Johny Hendricks,2015-03-14,Matt Brown,Decision - Unanimous,80,13,0,93
Johny Hendricks,2012-11-17,Martin Kampmann,KO/TKO,100,3,0,103
Johny Hendricks,2014-12-06,Robbie Lawler,Decision - Split,0,0,25,25
Johny Hendricks,2016-02-06,Stephen Thompson,KO/TKO,0,0,25,25
Johny Hendricks,2013-03-16,Carlos Condit,Decision - Unanimous,80,0,0,80
Johny Hendricks,2009-08-08,Amir Sadollah,KO/TKO,100,5,0,105
Johny Hendricks,2010-08-07,Charlie Brenneman,KO/TKO,100,19,0,119
Johny Hendricks,2017-06-25,Tim Boetsch,KO/TKO,0,0,0,0
Johny Hendricks,2017-11-04,Paulo Costa,KO/TKO,0,0,0,0
Justin Haskins,2008-12-03,Johny Hendricks,KO/TKO,0,0,0,0
Justin Haskins,2009-03-01,Mike Pierce,KO/TKO,0,0,0,0
Francisco Trinaldo,2013-01-19,CJ Keith,Submission,90,9,0,99
Francisco Trinaldo,2014-02-15,Jesse Ronson,Decision - Split,70,2,0,72
Francisco Trinaldo,2014-09-13,Leandro Silva,Decision - Unanimous,80,10,0,90
Francisco Trinaldo,2020-03-14,John Makdessi,Decision - Unanimous,80,0,0,80
Francisco Trinaldo,2015-05-30,Norman Parke,Decision - Unanimous,80,41,0,121
Francisco Trinaldo,2016-01-17,Ross Pearson,Decision - Unanimous,80,23,0,103
Francisco Trinaldo,2019-07-20,Alexander Hernandez,Decision - Unanimous,0,0,0,0
Francisco Trinaldo,2012-06-23,Delson Heleno,KO/TKO,100,18,0,118
Francisco Trinaldo,2017-10-28,Jim Miller,Decision - Unanimous,80,29,0,109
Francisco Trinaldo,2013-05-18,Mike Rio,Submission,90,0,0,90
Francisco Trinaldo,2015-08-23,Chad Laprise,KO/TKO,100,9,0,109
Francisco Trinaldo,2016-09-24,Paul Felder,TKO - Doctor's Stoppage,0,0,0,0
Francisco Trinaldo,2022-10-01,Randy Brown,Decision - Unanimous,0,0,0,0
Francisco Trinaldo,2017-03-11,Kevin Lee,Submission,0,10,0,10
Francisco Trinaldo,2018-02-18,James Vick,Decision - Unanimous,0,0,0,0
Francisco Trinaldo,2022-05-07,Danny Roberts,Decision - Unanimous,80,44,0,124
Francisco Trinaldo,2016-05-14,Yancy Medeiros,Decision - Unanimous,80,66,0,146
Francisco Trinaldo,2013-09-04,Piotr Hallmann,Submission,0,0,0,0
Francisco Trinaldo,2021-10-23,Dwight Grant,Decision - Split,70,5,0,75
Francisco Trinaldo,2018-09-22,Evan Dunham,KO/TKO,100,3,0,103
Francisco Trinaldo,2020-07-25,Jai Herbert,KO/TKO,100,9,0,109
Francisco Trinaldo,2012-10-13,Gleison Tibau,Decision - Unanimous,0,9,0,9
Francisco Trinaldo,2021-06-05,Muslim Salikhov,Decision - Unanimous,0,0,0,0
Francisco Trinaldo,2015-03-21,Akbarh Arreola,Decision - Unanimous,80,5,0,85
Francisco Trinaldo,2019-11-16,Bobby Green,Decision - Unanimous,80,0,0,80
Francisco Trinaldo,2014-05-24,Michael Chiesa,Decision - Unanimous,0,0,0,0
CJ Keith,2013-01-19,Francisco Trinaldo,Submission,0,0,0,0
CJ Keith,2012-06-22,Ramsey Nijem,KO/TKO,0,0,0,0
Nate Quarry,2005-04-09,Lodune Sincaid,KO/TKO,100,26,0,126
Nate Quarry,2005-06-04,Shonie Carter,KO/TKO,100,13,0,113
Nate Quarry,2008-11-15,Demian Maia,Submission,0,0,0,0
Nate Quarry,2005-08-06,Pete Sell,KO/TKO,100,1,0,101
Nate Quarry,2008-04-19,Kalib Starnes,Decision - Unanimous,80,72,0,152
Nate Quarry,2009-09-16,Tim Credeur,Decision - Unanimous,80,13,0,93
Nate Quarry,2007-09-19,Pete Sell,KO/TKO,100,11,0,111
Nate Quarry,2009-04-18,Jason MacDonald,KO/TKO,100,15,0,115
Nate Quarry,2010-03-31,Jorge Rivera,KO/TKO,0,0,0,0
Nate Quarry,2005-11-19,Rich Franklin,KO/TKO,0,0,25,25
Lodune Sincaid,2005-04-09,Nate Quarry,KO/TKO,0,0,0,0
Lodune Sincaid,2006-08-17,Doug Marshall,KO/TKO,0,0,0,0
Lodune Sincaid,2006-07-22,Jason Miller,Submission,0,0,0,0
Walt Harris,2018-06-01,Daniel Spitz,KO/TKO,100,12,0,112
Walt Harris,2021-06-05,Marcin Tybura,KO/TKO,0,19,0,19
Walt Harris,2019-05-04,Serghei Spivac,KO/TKO,100,16,0,116
Walt Harris,2014-01-25,Nikita Krylov,KO/TKO,0,0,0,0
Walt Harris,2020-05-16,Alistair Overeem,KO/TKO,0,0,25,25
Walt Harris,2020-10-24,Alexander Volkov,KO/TKO,0,0,0,0
Walt Harris,2016-04-23,Cody East,KO/TKO,100,5,0,105
Walt Harris,2017-06-17,Cyril Asker,KO/TKO,100,19,0,119
Walt Harris,2017-11-04,Mark Godbeer,DQ,0,18,0,18
Walt Harris,2017-10-07,Fabricio Werdum,Submission,0,0,0,0
Walt Harris,2016-10-01,Shamil Abdurakhimov,Decision - Split,0,0,0,0
Walt Harris,2017-01-15,Chase Sherman,KO/TKO,100,12,0,112
Walt Harris,2014-11-07,Soa Palelei,KO/TKO,0,0,0,0
Walt Harris,2013-11-30,Jared Rosholt,Decision - Unanimous,0,0,0,0
Walt Harris,2019-07-20,Aleksei Oleinik,KO/TKO,100,3,0,103
Daniel Spitz,2018-06-01,Walt Harris,KO/TKO,0,0,0,0
Daniel Spitz,2017-09-16,Anthony Hamilton,KO/TKO,100,5,0,105
Daniel Spitz,2019-10-18,Tanner Boser,Decision - Unanimous,0,0,0,0
Daniel Spitz,2017-03-04,Mark Godbeer,Decision - Unanimous,0,0,0,0
Bogdan Guskov,2024-04-27,Ryan Spann,KO/TKO,100,16,0,116
Bogdan Guskov,2024-02-10,Zac Pauga,KO/TKO,100,0,0,100
Bogdan Guskov,2023-09-02,Volkan Oezdemir,Submission,0,0,0,0
Ryan Spann,2024-04-27,Bogdan Guskov,KO/TKO,0,0,0,0
Ryan Spann,2023-03-11,Nikita Krylov,Submission,0,0,0,0
Ryan Spann,2021-09-18,Anthony Smith,Submission,0,0,25,25
Ryan Spann,2023-08-26,Anthony Smith,Decision - Split,0,0,0,0
Ryan Spann,2020-05-09,Sam Alvey,Decision - Split,70,0,0,70
Ryan Spann,2018-06-19,Emiliano Sordi,Submission,90,0,0,90
Ryan Spann,2022-11-12,Dominick Reyes,KO/TKO,100,3,0,103
Ryan Spann,2024-10-05,Ovince Saint Preux,Submission,90,2,0,92
Ryan Spann,2021-03-13,Misha Cirkunov,KO/TKO,100,11,0,111
Ryan Spann,2017-07-25,Karl Roberson,KO/TKO,0,0,0,0
Ryan Spann,2019-05-11,Rogerio Nogueira,KO/TKO,100,7,0,107
Ryan Spann,2018-09-22,Luis Henrique,Decision - Unanimous,80,16,0,96
Ryan Spann,2022-05-14,Ion Cutelaba,Submission,90,2,0,92
Ryan Spann,2019-10-12,Devin Clark,Submission,90,0,0,90
Ryan Spann,2020-09-19,Johnny Walker,KO/TKO,0,0,0,0
Muhammad Mokaev,2023-03-18,Jafel Filho,Submission,90,7,0,97
Muhammad Mokaev,2023-10-21,Tim Elliott,Submission,90,0,0,90
Muhammad Mokaev,2024-07-27,Manel Kape,Decision - Unanimous,80,10,0,90
Muhammad Mokaev,2024-03-02,Alex Perez,Decision - Unanimous,80,17,0,97
Muhammad Mokaev,2022-03-19,Cody Durden,Submission,90,1,0,91
Muhammad Mokaev,2022-07-23,Charles Johnson,Decision - Unanimous,80,0,0,80
Muhammad Mokaev,2022-10-22,Malcolm Gordon,Submission,90,4,0,94
Jafel Filho,2023-03-18,Muhammad Mokaev,Submission,0,0,0,0
Jafel Filho,2023-07-22,Daniel Barez,Submission,90,3,0,93
Jafel Filho,2022-09-20,Roybert Echeverria,KO/TKO,100,0,0,100
Jafel Filho,2024-03-16,Ode Osbourne,Submission,90,21,0,111
Ray Borg,2014-06-28,Shane Howell,Submission,90,2,0,92
Ray Borg,2015-08-08,Geane Herrera,Decision - Unanimous,80,19,0,99
Ray Borg,2017-10-07,Demetrious Johnson,Submission,0,0,25,25
Ray Borg,2019-07-20,Gabriel Silva,Decision - Unanimous,80,7,0,87
Ray Borg,2020-02-15,Rogerio Bontorin,Decision - Unanimous,80,26,0,106
Ray Borg,2014-04-19,Dustin Ortiz,Decision - Split,0,0,0,0
Ray Borg,2016-12-30,Louis Smolka,Decision - Unanimous,80,11,0,91
Ray Borg,2019-03-30,Casey Kenney,Decision - Unanimous,0,0,0,0
Ray Borg,2017-03-11,Jussier Formiga,Decision - Unanimous,80,6,0,86
Ray Borg,2016-02-06,Justin Scoggins,Decision - Unanimous,0,0,0,0
Ray Borg,2020-05-13,Ricky Simon,Decision - Split,0,0,0,0
Ray Borg,2015-02-14,Chris Kelades,Submission,90,15,0,105
Shane Howell,2014-06-28,Ray Borg,Submission,0,0,0,0
Shane Howell,2015-01-18,Paddy Holohan,Decision - Unanimous,0,0,0,0
Aspen Ladd,2017-10-21,Lina Lansberg,KO/TKO,100,0,0,100
Aspen Ladd,2019-07-13,Germaine de Randamie,KO/TKO,0,0,25,25
Aspen Ladd,2018-10-06,Tonya Evinger,KO/TKO,100,41,0,141
Aspen Ladd,2019-12-07,Yana Santos,KO/TKO,100,0,0,100
Aspen Ladd,2022-04-09,Raquel Pennington,Decision - Unanimous,0,0,0,0
Aspen Ladd,2021-10-16,Norma Dumont,Decision - Unanimous,0,0,25,25
Aspen Ladd,2019-05-18,Sijara Eubanks,Decision - Unanimous,80,0,0,80
Diego Brandao,2013-04-06,Pablo Garza,Submission,90,5,0,95
Diego Brandao,2012-10-13,Joey Gambino,Decision - Unanimous,80,0,0,80
Diego Brandao,2012-05-26,Darren Elkins,Decision - Unanimous,0,0,0,0
Diego Brandao,2013-08-17,Daniel Pineda,Decision - Unanimous,80,0,0,80
Diego Brandao,2016-01-02,Brian Ortega,Submission,0,27,0,27
Diego Brandao,2011-12-03,Dennis Bermudez,Submission,90,0,0,90
Diego Brandao,2013-12-28,Dustin Poirier,KO/TKO,0,0,0,0
Diego Brandao,2015-04-18,Jimy Hettes,TKO - Doctor's Stoppage,0,1,0,1
Diego Brandao,2014-07-19,Conor McGregor,KO/TKO,0,0,25,25
Diego Brandao,2015-09-26,Katsunori Kikuno,KO/TKO,100,13,0,113
Pablo Garza,2013-04-06,Diego Brandao,Submission,0,0,0,0
Pablo Garza,2011-11-12,Dustin Poirier,Submission,0,0,0,0
Pablo Garza,2012-11-17,Mark Hominick,Decision - Unanimous,80,44,0,124
Pablo Garza,2011-04-30,Yves Jabouin,Submission,90,10,0,100
Pablo Garza,2010-12-04,Fredson Paixao,KO/TKO,100,2,0,102
Pablo Garza,2010-09-30,Zhang Tiequan,Submission,0,2,0,2
Pablo Garza,2012-05-05,Dennis Bermudez,Decision - Unanimous,0,0,0,0
Brendan Schaub,2014-06-14,Andrei Arlovski,Decision - Split,0,18,0,18
Brendan Schaub,2009-12-05,Roy Nelson,KO/TKO,0,4,0,4
Brendan Schaub,2010-03-21,Chase Gormley,KO/TKO,100,23,0,123
Brendan Schaub,2011-08-27,Antonio Rodrigo Nogueira,KO/TKO,0,0,0,0
Brendan Schaub,2013-09-21,Matt Mitrione,Submission,90,7,0,97
Brendan Schaub,2014-12-06,Travis Browne,KO/TKO,0,0,0,0
Brendan Schaub,2010-10-23,Gabriel Gonzaga,Decision - Unanimous,80,16,0,96
Brendan Schaub,2013-02-23,Lavar Johnson,Decision - Unanimous,80,0,0,80
Brendan Schaub,2012-04-21,Ben Rothwell,KO/TKO,0,1,0,1
Brendan Schaub,2010-07-03,Chris Tuchscherer,KO/TKO,100,9,0,109
Brendan Schaub,2011-03-19,Mirko Filipovic,KO/TKO,100,19,0,119
Lerone Murphy,2020-07-15,Ricardo Ramos,KO/TKO,100,12,0,112
Lerone Murphy,2021-01-20,Douglas Silva de Andrade,Decision - Unanimous,80,9,0,89
Lerone Murphy,2024-10-26,Dan Ige,Decision - Unanimous,80,6,0,86
Lerone Murphy,2023-03-18,Gabriel Santos,Decision - Split,70,24,0,94
Lerone Murphy,2023-07-22,Josh Culibao,Decision - Unanimous,80,36,0,116
Lerone Murphy,2024-05-18,Edson Barboza,Decision - Unanimous,80,141,25,246
Lerone Murphy,2021-10-30,Makwan Amirkhani,KO/TKO,100,0,0,100
Ricardo Ramos,2020-07-15,Lerone Murphy,KO/TKO,0,0,0,0
Ricardo Ramos,2021-05-22,Bill Algeo,Decision - Unanimous,80,0,0,80
Ricardo Ramos,2019-02-02,Said Nurmagomedov,KO/TKO,0,0,0,0
Ricardo Ramos,2019-06-29,Journey Newson,Decision - Unanimous,80,2,0,82
Ricardo Ramos,2024-03-23,Julian Erosa,Submission,0,3,0,3
Ricardo Ramos,2023-09-23,Charles Jourdain,Submission,0,0,0,0
Ricardo Ramos,2017-02-04,Michinori Tanaka,Decision - Unanimous,80,17,0,97
Ricardo Ramos,2018-08-04,Kyung Ho Kang,Decision - Split,70,0,0,70
Ricardo Ramos,2017-11-04,Aiemann Zahabi,KO/TKO,100,0,0,100
Ricardo Ramos,2024-08-17,Josh Culibao,Decision - Split,70,0,0,70
Ricardo Ramos,2021-10-30,Zubaira Tukhugov,Decision - Unanimous,0,0,0,0
Ricardo Ramos,2022-06-18,Danny Chavez,KO/TKO,100,1,0,101
Ricardo Ramos,2019-11-16,Eduardo Garagorri,Submission,90,4,0,94
Jim Miller,2020-02-15,Scott Holtzman,Decision - Unanimous,0,0,0,0
Jim Miller,2018-12-15,Charles Oliveira,Submission,0,1,0,1
Jim Miller,2024-04-13,Bobby Green,Decision - Unanimous,0,0,0,0
Jim Miller,2016-11-12,Thiago Alves,Decision - Unanimous,80,0,0,80
Jim Miller,2019-08-03,Clay Guida,Submission,90,0,0,90
Jim Miller,2018-09-08,Alex White,Submission,90,10,0,100
Jim Miller,2023-06-03,Jesse Butler,KO/TKO,100,2,0,102
Jim Miller,2021-04-10,Joe Solecki,Decision - Unanimous,0,0,0,0
Jim Miller,2016-08-27,Joe Lauzon,Decision - Split,70,26,0,96
Jim Miller,2012-05-05,Nate Diaz,Submission,0,0,25,25
Jim Miller,2009-07-11,Mac Danzig,Decision - Unanimous,80,17,0,97
Jim Miller,2021-10-16,Erick Gonzalez,KO/TKO,100,18,0,118
Jim Miller,2008-12-10,Matt Wiman,Decision - Unanimous,80,41,0,121
Jim Miller,2014-07-16,Donald Cerrone,KO/TKO,0,0,25,25
Jim Miller,2017-10-28,Francisco Trinaldo,Decision - Unanimous,0,0,0,0
Jim Miller,2010-01-02,Duane Ludwig,Submission,90,4,0,94
Jim Miller,2008-10-18,David Baron,Submission,90,8,0,98
Jim Miller,2020-06-20,Roosevelt Roberts,Submission,90,1,0,91
Jim Miller,2022-02-19,Nikolas Motta,KO/TKO,100,27,0,127
Jim Miller,2012-01-20,Melvin Guillard,Submission,90,0,0,90
Jim Miller,2017-02-11,Dustin Poirier,Decision - Majority,0,0,0,0
Jim Miller,2009-03-07,Gray Maynard,Decision - Unanimous,0,0,0,0
Jim Miller,2010-12-11,Charles Oliveira,Submission,90,0,0,90
Jim Miller,2023-02-18,Alexander Hernandez,Decision - Unanimous,0,0,0,0
Jim Miller,2024-01-13,Gabriel Benitez,Submission,90,0,0,90
Jim Miller,2015-07-25,Danny Castillo,Decision - Split,70,10,0,80
Jim Miller,2012-12-29,Joe Lauzon,Decision - Unanimous,80,56,0,136
Jim Miller,2011-08-14,Benson Henderson,Decision - Unanimous,0,0,0,0
Jim Miller,2014-04-26,Yancy Medeiros,Submission,90,0,0,90
Jim Miller,2022-07-02,Donald Cerrone,Submission,90,3,0,93
Jim Miller,2016-07-09,Takanori Gomi,KO/TKO,100,7,0,107
Jim Miller,2009-09-19,Steve Lopez,KO/TKO,100,24,0,124
Jim Miller,2016-03-05,Diego Sanchez,Decision - Unanimous,0,8,0,8
Jim Miller,2010-03-27,Mark Bocek,Decision - Unanimous,80,6,0,86
Jim Miller,2019-04-27,Jason Gonzalez,Submission,90,0,0,90
Jim Miller,2013-12-28,Fabricio Camoes,Submission,90,0,0,90
Jim Miller,2024-11-16,Damon Jackson,Submission,90,0,0,90
Jim Miller,2015-04-18,Beneil Dariush,Decision - Unanimous,0,0,0,0
Jim Miller,2011-03-19,Kamal Shalorus,KO/TKO,100,17,0,117
Jim Miller,2017-07-08,Anthony Pettis,Decision - Unanimous,0,0,0,0
Jim Miller,2010-09-15,Gleison Tibau,Decision - Unanimous,80,6,0,86
Jim Miller,2018-04-21,Dan Hooker,KO/TKO,0,0,0,0
Jim Miller,2020-08-15,Vinc Pichel,Decision - Unanimous,0,0,0,0
Jim Miller,2015-12-10,Michael Chiesa,Submission,0,0,0,0
Ruan Potts,2015-02-28,Derrick Lewis,KO/TKO,0,0,0,0
Ruan Potts,2014-08-30,Anthony Hamilton,KO/TKO,0,0,0,0
Ruan Potts,2014-05-10,Soa Palelei,KO/TKO,0,0,0,0
Aaron Phillips,2020-07-15,Jack Shore,Submission,0,0,0,0
Aaron Phillips,2014-08-23,Matt Hobar,Decision - Unanimous,0,0,0,0
Aaron Phillips,2014-05-24,Sam Sicilia,Decision - Unanimous,0,0,0,0
Aaron Phillips,2023-04-15,Gaston Bolanos,Decision - Unanimous,0,0,0,0
Akihiro Gono,2006-04-02,Dae Won Kim,Submission,90,7,0,97
Akihiro Gono,2005-09-25,Dan Henderson,KO/TKO,0,0,0,0
Akihiro Gono,2007-11-17,Tamdan McCrory,Submission,90,0,0,90
Akihiro Gono,2009-01-31,Jon Fitch,Decision - Unanimous,0,0,0,0
Akihiro Gono,2006-11-05,Denis Kang,Decision - Unanimous,0,0,0,0
Akihiro Gono,2009-12-31,Hayato Sakurai,Submission,90,6,0,96
Akihiro Gono,2006-12-31,Yuki Kondo,Decision - Split,70,17,0,87
Akihiro Gono,2006-08-27,Gegard Mousasi,Submission,90,0,0,90
Akihiro Gono,2005-05-22,Crosley Gracie,Decision - Unanimous,80,0,0,80
Akihiro Gono,2005-09-25,Daniel Acacio,Decision - Unanimous,80,8,0,88
Akihiro Gono,2004-02-15,Mauricio Rua,KO/TKO,0,0,0,0
Akihiro Gono,2006-06-04,Hector Lombard,Decision - Unanimous,80,6,0,86
Akihiro Gono,2008-10-18,Dan Hardy,Decision - Split,0,0,0,0
Dae Won Kim,2006-04-02,Akihiro Gono,Submission,0,0,0,0
Dae Won Kim,2008-05-11,Melvin Manhoef,KO/TKO,0,0,0,0
Movsar Evloev,2021-01-23,Nik Lentz,Decision - Split,70,36,0,106
Movsar Evloev,2024-12-07,Aljamain Sterling,Decision - Unanimous,80,0,0,80
Movsar Evloev,2021-06-12,Hakeem Dawodu,Decision - Unanimous,80,3,0,83
Movsar Evloev,2022-06-04,Dan Ige,Decision - Unanimous,80,26,0,106
Movsar Evloev,2019-10-26,Enrique Barzola,Decision - Unanimous,80,0,0,80
Movsar Evloev,2020-07-25,Mike Grundy,Decision - Unanimous,80,59,0,139
Movsar Evloev,2019-04-20,SeungWoo Choi,Decision - Unanimous,80,24,0,104
Movsar Evloev,2024-01-20,Arnold Allen,Decision - Unanimous,80,0,0,80
Movsar Evloev,2023-05-06,Diego Lopes,Decision - Unanimous,80,51,0,131
Bryan Barberena,2022-03-26,Matt Brown,Decision - Split,70,30,0,100
Bryan Barberena,2022-12-03,Rafael Dos Anjos,Submission,0,0,0,0
Bryan Barberena,2016-01-30,Sage Northcutt,Submission,90,8,0,98
Bryan Barberena,2018-08-25,Jake Ellenberger,KO/TKO,100,7,0,107
Bryan Barberena,2021-07-31,Jason Witt,Decision - Majority,0,15,0,15
Bryan Barberena,2016-05-14,Warlley Alves,Decision - Unanimous,80,41,0,121
Bryan Barberena,2023-07-22,Makhmud Muradov,Decision - Unanimous,0,0,0,0
Bryan Barberena,2017-04-22,Joe Proctor,KO/TKO,100,20,0,120
Bryan Barberena,2014-12-13,Joe Ellenberger,KO/TKO,100,39,0,139
Bryan Barberena,2017-09-02,Leon Edwards,Decision - Unanimous,0,21,0,21
Bryan Barberena,2016-12-17,Colby Covington,Decision - Unanimous,0,0,0,0
Bryan Barberena,2024-03-16,Gerald Meerschaert,Submission,0,1,0,1
Bryan Barberena,2015-04-25,Chad Laprise,Decision - Unanimous,0,10,0,10
Bryan Barberena,2020-09-12,Anthony Ivy,Decision - Unanimous,80,27,0,107
Bryan Barberena,2019-06-22,Randy Brown,KO/TKO,0,0,0,0
Bryan Barberena,2021-12-04,Darian Weeks,Decision - Unanimous,80,0,0,80
Bryan Barberena,2019-02-17,Vicente Luque,KO/TKO,0,6,0,6
Bryan Barberena,2022-07-02,Robbie Lawler,KO/TKO,100,66,0,166
Bryan Barberena,2023-03-18,Gunnar Nelson,Submission,0,0,0,0
Wes Albritton,1997-05-30,Tito Ortiz,KO/TKO,0,0,0,0
Niko Price,2018-09-08,Abdul Razak Alhassan,KO/TKO,0,0,0,0
Niko Price,2019-10-12,James Vick,KO/TKO,100,2,0,102
Niko Price,2019-07-27,Geoff Neal,KO/TKO,0,0,0,0
Niko Price,2016-12-30,Brandon Thatch,Submission,90,0,0,90
Niko Price,2017-08-05,Alan Jouban,KO/TKO,100,5,0,105
Niko Price,2024-06-01,Alex Morono,Decision - Unanimous,80,12,0,92
Niko Price,2019-03-09,Tim Means,KO/TKO,100,1,0,101
Niko Price,2018-07-14,Randy Brown,KO/TKO,100,0,0,100
Niko Price,2021-10-02,Alex Oliveira,Decision - Unanimous,80,0,0,80
Niko Price,2021-07-10,Michel Pereira,Decision - Unanimous,0,0,0,0
Niko Price,2022-12-03,Phil Rowe,KO/TKO,0,47,0,47
Niko Price,2024-10-12,Themba Gorimbo,Decision - Unanimous,0,0,0,0
Niko Price,2018-01-27,George Sullivan,Submission,90,3,0,93
Niko Price,2017-10-28,Vicente Luque,Submission,0,0,0,0
Niko Price,2020-05-09,Vicente Luque,TKO - Doctor's Stoppage,0,0,0,0
Niko Price,2023-07-08,Robbie Lawler,KO/TKO,0,0,0,0
Khalil Rountree Jr.,2017-02-04,Daniel Jolly,KO/TKO,100,3,0,103
Khalil Rountree Jr.,2019-04-13,Eryk Anders,Decision - Unanimous,80,63,0,143
Khalil Rountree Jr.,2016-11-26,Tyson Pedro,Submission,0,0,0,0
Khalil Rountree Jr.,2021-01-23,Marcin Prachnio,Decision - Unanimous,0,0,0,0
Khalil Rountree Jr.,2023-08-12,Chris Daukaus,KO/TKO,100,8,0,108
Khalil Rountree Jr.,2019-09-28,Ion Cutelaba,KO/TKO,0,0,0,0
Khalil Rountree Jr.,2021-09-04,Modestas Bukauskas,KO/TKO,100,15,0,115
Khalil Rountree Jr.,2016-07-08,Andrew Sanchez,Decision - Unanimous,0,0,0,0
Khalil Rountree Jr.,2022-10-29,Dustin Jacoby,Decision - Split,70,0,0,70
Khalil Rountree Jr.,2023-12-09,Anthony Smith,KO/TKO,100,6,0,106
Khalil Rountree Jr.,2024-10-05,Alex Pereira,KO/TKO,0,0,25,25
Khalil Rountree Jr.,2018-07-07,Gokhan Saki,KO/TKO,100,4,0,104
Khalil Rountree Jr.,2018-11-17,Johnny Walker,KO/TKO,0,0,0,0
Khalil Rountree Jr.,2022-03-12,Karl Roberson,KO/TKO,100,9,0,109
Khalil Rountree Jr.,2017-07-16,Paul Craig,KO/TKO,100,0,0,100
Daniel Jolly,2017-02-04,Khalil Rountree Jr.,KO/TKO,0,0,0,0
Daniel Jolly,2017-07-25,Alonzo Menifield,TKO - Doctor's Stoppage,0,0,0,0
Daniel Jolly,2015-08-23,Misha Cirkunov,KO/TKO,0,0,0,0
Cathal Pendred,2014-07-19,Mike King,Submission,90,0,0,90
Cathal Pendred,2015-06-13,Augusto Montano,Decision - Unanimous,80,0,0,80
Cathal Pendred,2014-10-04,Gasan Umalatov,Decision - Split,70,17,0,87
Cathal Pendred,2015-01-18,Sean Spencer,Decision - Unanimous,80,0,0,80
Cathal Pendred,2015-07-11,John Howard,Decision - Split,0,0,0,0
Cathal Pendred,2015-10-24,Tom Breese,KO/TKO,0,0,0,0
Mike King,2014-07-19,Cathal Pendred,Submission,0,27,0,27
Assuerio Silva,2001-07-29,Valentijn Overeem,Submission,90,0,0,90
Assuerio Silva,2006-05-27,Brandon Vera,Submission,0,1,0,1
Assuerio Silva,2001-09-24,Yoshihisa Yamamoto,KO/TKO,100,3,0,103
Assuerio Silva,2007-04-21,Cheick Kongo,Decision - Majority,0,0,0,0
Assuerio Silva,2003-10-05,Aleksander Emelianenko,Decision - Split,0,0,0,0
Assuerio Silva,2006-01-16,Tim Sylvia,Decision - Unanimous,0,0,0,0
Valentijn Overeem,2001-07-29,Assuerio Silva,Submission,0,12,0,12
Valentijn Overeem,2011-02-12,Ray Sefo,Submission,90,0,0,90
Valentijn Overeem,2002-12-23,Ron Waterman,Submission,0,0,0,0
Valentijn Overeem,2001-12-23,Igor Vovchanchyn,Submission,0,0,0,0
Valentijn Overeem,2011-06-18,Chad Griggs,KO/TKO,0,0,0,0
Valentijn Overeem,2001-05-27,Gary Goodridge,KO/TKO,0,0,0,0
Alexander Volkanovski,2018-02-10,Jeremy Kennedy,KO/TKO,100,65,0,165
Alexander Volkanovski,2019-12-14,Max Holloway,Decision - Unanimous,80,23,25,128
Alexander Volkanovski,2017-06-10,Mizuto Hirota,Decision - Unanimous,80,41,0,121
Alexander Volkanovski,2022-04-09,Chan Sung Jung,KO/TKO,100,90,25,215
Alexander Volkanovski,2024-02-17,Ilia Topuria,KO/TKO,0,12,25,37
Alexander Volkanovski,2018-12-29,Chad Mendes,KO/TKO,100,26,0,126
Alexander Volkanovski,2020-07-11,Max Holloway,Decision - Split,70,35,25,130
Alexander Volkanovski,2019-05-11,Jose Aldo,Decision - Unanimous,80,66,0,146
Alexander Volkanovski,2018-07-14,Darren Elkins,Decision - Unanimous,80,18,0,98
Alexander Volkanovski,2023-07-08,Yair Rodriguez,KO/TKO,100,26,25,151
Alexander Volkanovski,2022-07-02,Max Holloway,Decision - Unanimous,80,72,25,177
Alexander Volkanovski,2016-11-26,Yusuke Kasuya,KO/TKO,100,46,0,146
Alexander Volkanovski,2023-02-11,Islam Makhachev,Decision - Unanimous,0,13,25,38
Alexander Volkanovski,2021-09-25,Brian Ortega,Decision - Unanimous,80,126,25,231
Alexander Volkanovski,2023-10-21,Islam Makhachev,KO/TKO,0,0,25,25
Alexander Volkanovski,2017-11-18,Shane Young,Decision - Unanimous,80,50,0,130
Aaron Rosa,2009-05-15,Anthony Ruiz,Submission,90,0,0,90
Aaron Rosa,2011-06-11,Joey Beltran,KO/TKO,0,0,0,0
Aaron Rosa,2009-11-20,Rafael Cavalcante,KO/TKO,0,0,0,0
Aaron Rosa,2011-11-12,Matt Lucas,Decision - Majority,75,40,0,115
Aaron Rosa,2012-03-02,James Te Huna,KO/TKO,0,0,0,0
Anthony Ruiz,2009-05-15,Aaron Rosa,Submission,0,3,0,3
Anthony Ruiz,2008-06-27,Bobby Southworth,Decision - Unanimous,0,1,25,26
Anthony Ruiz,2007-11-16,Bobby Southworth,TKO - Doctor's Stoppage,0,15,0,15
Anthony Ruiz,2008-09-20,Trevor Prangley,Decision - Unanimous,0,0,0,0
Anthony Ruiz,2006-08-17,Jeremy  Freitag,KO/TKO,100,65,0,165
Anthony Ruiz,2006-10-07,Trevor Prangley,Submission,0,0,0,0
Alex Hunter,1997-07-27,Sam Fulton,Submission,90,6,0,96
Alex Hunter,1997-10-17,Harry Moskowitz,Decision - Split,70,0,0,70
Sam Fulton,1997-07-27,Alex Hunter,Submission,0,0,0,0
Samy Schiavo,2008-04-02,Clay Guida,KO/TKO,0,0,0,0
Samy Schiavo,2008-10-18,Per Eklund,Submission,0,0,0,0
Gilbert Yvel,2001-09-24,Don Frye,DQ,0,2,0,2
Gilbert Yvel,2000-12-09,Kazuyuki Fujita,Decision - Unanimous,0,1,0,1
Gilbert Yvel,2001-05-27,Igor Vovchanchyn,Submission,0,0,0,0
Gilbert Yvel,2010-06-12,Ben Rothwell,Decision - Unanimous,0,0,0,0
Gilbert Yvel,2002-06-23,Jeremy Horn,Decision - Unanimous,0,6,0,6
Gilbert Yvel,2010-10-23,Jon Madsen,KO/TKO,0,0,0,0
Gilbert Yvel,2009-01-24,Josh Barnett,KO/TKO,0,0,0,0
Gilbert Yvel,2006-05-05,Roman Zentsov,KO/TKO,0,0,0,0
Gilbert Yvel,2000-06-04,Vitor Belfort,Decision - Unanimous,0,0,0,0
Gilbert Yvel,2005-04-03,Ikuhisa Minowa,Submission,0,1,0,1
Gilbert Yvel,2010-01-02,Junior Dos Santos,KO/TKO,0,0,0,0
Gilbert Yvel,2000-08-27,Gary Goodridge,KO/TKO,100,1,0,101
Gilbert Yvel,2007-04-08,Akira Shoji,KO/TKO,100,10,0,110
Jesse Forbes,2010-01-11,Nick Catone,Decision - Split,0,0,0,0
Jesse Forbes,2007-09-05,Bryan Baker,KO/TKO,0,0,0,0
Jesse Forbes,2010-05-29,Ryan Jensen,Submission,0,0,0,0
Jesse Forbes,2006-06-24,Matt Hamill,KO/TKO,0,0,0,0
Roman Dolidze,2022-10-29,Phil Hawes,KO/TKO,100,7,0,107
Roman Dolidze,2022-06-18,Kyle Daukaus,KO/TKO,100,4,0,104
Roman Dolidze,2020-07-18,Khadis Ibragimov,KO/TKO,100,15,0,115
Roman Dolidze,2024-06-29,Anthony Smith,Decision - Unanimous,80,49,0,129
Roman Dolidze,2021-06-05,Laureano Staropoli,Decision - Unanimous,80,5,0,85
Roman Dolidze,2022-12-03,Jack Hermansson,KO/TKO,100,0,0,100
Roman Dolidze,2024-02-03,Nassourdine Imavov,Decision - Majority,0,0,25,25
Roman Dolidze,2021-03-20,Trevin Giles,Decision - Unanimous,0,5,0,5
Roman Dolidze,2023-03-18,Marvin Vettori,Decision - Unanimous,0,0,0,0
Roman Dolidze,2024-10-05,Kevin Holland,KO/TKO,100,1,0,101
Roman Dolidze,2020-12-05,John Allan,Decision - Split,70,22,0,92
Frank Shamrock,1998-03-13,Igor Zinoviev,KO/TKO,100,2,0,102
Frank Shamrock,1997-12-21,Kevin Jackson,Submission,90,0,0,90
Frank Shamrock,1998-10-16,John Lober,Submission,90,19,0,109
Frank Shamrock,1999-09-24,Tito Ortiz,KO/TKO,100,11,25,136
Frank Shamrock,2008-03-29,Cung Le,TKO - Doctor's Stoppage,0,0,25,25
Frank Shamrock,2007-02-10,Renzo Gracie,DQ,0,3,0,3
Frank Shamrock,2009-04-11,Nick Diaz,KO/TKO,0,0,0,0
Frank Shamrock,2003-03-27,Bryan Pardoe,Submission,90,1,25,116
Frank Shamrock,2007-06-22,Phil Baroni,Submission,90,58,25,173
Frank Shamrock,2006-03-10,Cesar Gracie,KO/TKO,100,6,0,106
Frank Shamrock,1998-05-15,Jeremy Horn,Submission,90,6,0,96
Igor Zinoviev,1998-03-13,Frank Shamrock,KO/TKO,0,0,0,0
Kamal Shalorus,2010-01-10,Dave Jansen,Decision - Unanimous,80,3,0,83
Kamal Shalorus,2010-12-16,Bart Palaszewski,Decision - Split,70,13,0,83
Kamal Shalorus,2012-05-15,Rafael Dos Anjos,Submission,0,0,0,0
Kamal Shalorus,2012-01-20,Khabib Nurmagomedov,Submission,0,0,0,0
Kamal Shalorus,2011-03-19,Jim Miller,KO/TKO,0,0,0,0
Kamal Shalorus,2009-11-18,Will Kerr,KO/TKO,100,15,0,115
Dave Jansen,2010-01-10,Kamal Shalorus,Decision - Unanimous,0,0,0,0
Dave Jansen,2009-10-10,Richard Crunkilton,Decision - Unanimous,80,0,0,80
Dave Jansen,2010-08-18,Ricardo Lamas,Decision - Unanimous,0,2,0,2
Karine Silva,2023-08-19,Maryna Moroz,Submission,90,14,0,104
Karine Silva,2024-11-16,Viviane Araujo,Decision - Unanimous,0,10,0,10
Karine Silva,2023-06-03,Ketlen Souza,Submission,90,3,0,93
Karine Silva,2024-04-27,Ariane da Silva,Decision - Unanimous,80,0,0,80
Karine Silva,2022-06-04,Poliana Botelho,Submission,90,0,0,90
Karine Silva,2021-10-26,Yan Qihui,Submission,90,0,0,90
Rogerio Nogueira,2008-02-01,Todd Gouwenberg,KO/TKO,100,23,0,123
Rogerio Nogueira,2005-02-20,Alistair Overeem,Decision - Unanimous,80,12,0,92
Rogerio Nogueira,2003-03-16,Kazuhiro Nakamura,Submission,90,15,0,105
Rogerio Nogueira,2005-06-26,Mauricio Rua,Decision - Unanimous,0,0,0,0
Rogerio Nogueira,2005-04-23,Dan Henderson,Submission,90,0,0,90
Rogerio Nogueira,2008-11-01,Moise Rimbon,Decision - Unanimous,80,3,0,83
Rogerio Nogueira,2009-05-09,Dion Staring,Submission,90,45,0,135
Rogerio Nogueira,2015-08-01,Mauricio Rua,Decision - Unanimous,0,10,0,10
Rogerio Nogueira,2007-02-24,Rameau Thierry Sokoudjou,KO/TKO,0,0,0,0
Rogerio Nogueira,2008-07-19,Edwin DeWees,KO/TKO,100,13,0,113
Rogerio Nogueira,2020-07-25,Mauricio Rua,Decision - Split,0,0,0,0
Rogerio Nogueira,2010-09-25,Ryan Bader,Decision - Unanimous,0,0,0,0
Rogerio Nogueira,2003-12-31,Kazushi Sakuraba,Decision - Unanimous,80,21,0,101
Rogerio Nogueira,2011-12-10,Tito Ortiz,KO/TKO,100,45,0,145
Rogerio Nogueira,2009-01-24,Vladimir Matyushenko,KO/TKO,100,10,0,110
Rogerio Nogueira,2019-05-11,Ryan Spann,KO/TKO,0,0,0,0
Rogerio Nogueira,2002-04-28,Yusuke Imamura,Submission,90,0,0,90
Rogerio Nogueira,2016-05-14,Patrick Cummins,KO/TKO,100,18,0,118
Rogerio Nogueira,2004-07-19,Kazuhiro Nakamura,Decision - Split,70,17,0,87
Rogerio Nogueira,2006-07-01,Alistair Overeem,KO/TKO,100,0,0,100
Rogerio Nogueira,2011-03-26,Phil Davis,Decision - Unanimous,0,0,0,0
Rogerio Nogueira,2010-05-29,Jason Brilz,Decision - Split,70,5,0,75
Rogerio Nogueira,2014-07-26,Anthony Johnson,KO/TKO,0,0,0,0
Rogerio Nogueira,2002-12-23,Guy Mezger,Decision - Split,70,0,0,70
Rogerio Nogueira,2018-09-22,Sam Alvey,KO/TKO,100,0,0,100
Rogerio Nogueira,2009-11-21,Luiz Cane,KO/TKO,100,11,0,111
Rogerio Nogueira,2016-11-19,Ryan Bader,KO/TKO,0,0,25,25
Rogerio Nogueira,2013-02-02,Rashad Evans,Decision - Unanimous,80,18,0,98
Todd Gouwenberg,2008-02-01,Rogerio Nogueira,KO/TKO,0,0,0,0
Alexis Davis,2017-04-22,Cindy Dandois,Decision - Unanimous,80,4,0,84
Alexis Davis,2019-07-27,Viviane Araujo,Decision - Unanimous,0,1,0,1
Alexis Davis,2011-09-10,Amanda Nunes,KO/TKO,100,25,0,125
Alexis Davis,2018-07-28,Katlyn Cerminara,Decision - Unanimous,0,8,0,8
Alexis Davis,2021-02-27,Sabina Mazo,Decision - Unanimous,80,0,0,80
Alexis Davis,2016-12-03,Sara McMann,Submission,0,7,0,7
Alexis Davis,2019-03-23,Jennifer Maia,Decision - Unanimous,0,12,0,12
Alexis Davis,2015-04-25,Sarah Kaufman,Submission,90,0,0,90
Alexis Davis,2022-02-05,Julija Stoliarenko,Decision - Unanimous,80,29,0,109
Alexis Davis,2014-07-05,Ronda Rousey,KO/TKO,0,0,25,25
Alexis Davis,2013-11-06,Liz Carmouche,Decision - Unanimous,80,7,0,87
Alexis Davis,2013-06-15,Rosi Sexton,Decision - Unanimous,80,10,0,90
Alexis Davis,2014-02-22,Jessica Eye,Decision - Split,70,6,0,76
Alexis Davis,2021-06-12,Pannie Kianzad,Decision - Unanimous,0,8,0,8
Alexis Davis,2017-12-09,Liz Carmouche,Decision - Split,70,0,0,70
Alexis Davis,2012-03-03,Sarah Kaufman,Decision - Majority,0,4,0,4
Cindy Dandois,2017-04-22,Alexis Davis,Decision - Unanimous,0,0,0,0
Taila Santos,2020-12-19,Gillian Robertson,Decision - Unanimous,80,18,0,98
Taila Santos,2021-09-25,Roxanne Modafferi,Decision - Unanimous,80,37,0,117
Taila Santos,2021-11-20,Joanne Wood,Submission,90,3,0,93
Taila Santos,2019-02-02,Mara Romero Borella,Decision - Split,0,7,0,7
Taila Santos,2023-08-26,Erin Blanchfield,Decision - Unanimous,0,0,0,0
Taila Santos,2018-08-11,Estefani Almeida,Decision - Unanimous,80,44,0,124
Taila Santos,2020-07-15,Molly McCann,Decision - Unanimous,80,9,0,89
Taila Santos,2022-06-11,Valentina Shevchenko,Decision - Split,0,0,25,25
Gillian Robertson,2020-12-19,Taila Santos,Decision - Unanimous,0,0,0,0
Gillian Robertson,2024-01-20,Polyana Viana,KO/TKO,100,11,0,111
Gillian Robertson,2022-09-17,Mariya Agapova,Submission,90,0,0,90
Gillian Robertson,2024-11-09,Luana Pinheiro,Decision - Unanimous,80,10,0,90
Gillian Robertson,2023-06-24,Tabatha Ricci,Decision - Unanimous,0,0,0,0
Gillian Robertson,2020-10-17,Poliana Botelho,Decision - Unanimous,80,35,0,115
Gillian Robertson,2020-06-20,Cortney Casey,Submission,90,0,0,90
Gillian Robertson,2021-03-27,Miranda Maverick,Decision - Unanimous,0,0,0,0
Gillian Robertson,2019-10-18,Maycee Barber,KO/TKO,0,0,0,0
Gillian Robertson,2019-07-27,Sarah Frota,KO/TKO,100,20,0,120
Gillian Robertson,2023-04-15,Piera Rodriguez,Submission,90,14,0,104
Gillian Robertson,2021-12-11,Priscila Cachoeira,Submission,90,12,0,102
Gillian Robertson,2019-02-23,Veronica Hardy,Submission,90,0,0,90
Gillian Robertson,2018-05-27,Molly McCann,Submission,90,7,0,97
Gillian Robertson,2022-03-12,JJ Aldrich,Decision - Unanimous,0,0,0,0
Gillian Robertson,2024-06-29,Michelle Waterson-Gomez,Decision - Unanimous,80,56,0,136
Gillian Robertson,2017-12-01,Emily Whitmire,Submission,90,0,0,90
Gillian Robertson,2018-09-22,Mayra Bueno Silva,Submission,0,0,0,0
Mike Perry,2020-06-27,Mickey Gall,Decision - Unanimous,80,21,0,101
Mike Perry,2019-12-14,Geoff Neal,KO/TKO,0,0,0,0
Mike Perry,2021-04-10,Daniel Rodriguez,Decision - Unanimous,0,0,0,0
Mike Perry,2016-10-08,Danny Roberts,KO/TKO,100,9,0,109
Mike Perry,2019-08-10,Vicente Luque,Decision - Split,0,3,0,3
Mike Perry,2018-07-07,Paul Felder,Decision - Split,70,6,0,76
Mike Perry,2016-08-20,Hyun Gyu Lim,KO/TKO,100,23,0,123
Mike Perry,2016-12-17,Alan Jouban,Decision - Unanimous,0,0,0,0
Mike Perry,2018-11-10,Donald Cerrone,Submission,0,2,0,2
Mike Perry,2018-02-24,Max Griffin,Decision - Unanimous,0,0,0,0
Mike Perry,2017-09-16,Alex Reyes,KO/TKO,100,5,0,105
Mike Perry,2017-04-22,Jake Ellenberger,KO/TKO,100,9,0,109
Mike Perry,2019-04-27,Alex Oliveira,Decision - Unanimous,80,17,0,97
Mike Perry,2020-11-21,Tim Means,Decision - Unanimous,0,0,0,0
Mike Perry,2017-12-16,Santiago Ponzinibbio,Decision - Unanimous,0,0,0,0
Court McGee,2023-05-13,Matt Brown,KO/TKO,0,0,0,0
Court McGee,2013-08-28,Robert Whittaker,Decision - Split,70,40,0,110
Court McGee,2021-05-22,Claudio Silva,Decision - Unanimous,80,16,0,96
Court McGee,2013-02-23,Josh Neer,Decision - Unanimous,80,103,0,183
Court McGee,2015-12-12,Marcio Alexandre Junior,Decision - Unanimous,80,35,0,115
Court McGee,2017-11-11,Sean Strickland,Decision - Unanimous,0,0,0,0
Court McGee,2013-12-14,Ryan LaFlare,Decision - Unanimous,0,0,0,0
Court McGee,2022-06-18,Jeremiah Wells,KO/TKO,0,0,0,0
Court McGee,2017-01-15,Ben Saunders,Decision - Unanimous,0,5,0,5
Court McGee,2010-06-19,Kris McCray,Submission,90,3,0,93
Court McGee,2018-10-27,Alex Garcia,Decision - Unanimous,80,24,0,104
Court McGee,2024-10-05,Tim Means,Submission,90,9,0,99
Court McGee,2019-04-27,Dhiego Lima,Decision - Split,0,0,0,0
Court McGee,2016-08-06,Dominique Steele,Decision - Unanimous,80,0,0,80
Court McGee,2010-10-23,Ryan Jensen,Submission,90,24,0,114
Court McGee,2012-07-21,Nick Ring,Decision - Unanimous,0,40,0,40
Court McGee,2022-01-15,Ramiz Brahimaj,Decision - Unanimous,80,22,0,102
Court McGee,2019-10-18,Sean Brady,Decision - Unanimous,0,0,0,0
Court McGee,2020-10-03,Carlos Condit,Decision - Unanimous,0,0,0,0
Court McGee,2016-04-16,Santiago Ponzinibbio,KO/TKO,0,0,0,0
Court McGee,2024-04-06,Alex Morono,Decision - Unanimous,0,22,0,22
Court McGee,2011-09-17,Dongi Yang,Decision - Unanimous,80,12,0,92
Court McGee,2012-03-02,Constantinos Philippou,Decision - Unanimous,0,0,0,0
Alex Caceres,2020-06-06,Chase Hooper,Decision - Unanimous,80,50,0,130
Alex Caceres,2023-08-26,Giga Chikadze,Decision - Unanimous,0,0,0,0
Alex Caceres,2012-07-11,Damacio Page,Submission,90,2,0,92
Alex Caceres,2020-08-29,Austin Springer,Submission,90,4,0,94
Alex Caceres,2012-02-04,Edwin Figueroa,Decision - Split,0,14,0,14
Alex Caceres,2019-02-17,Kron Gracie,Submission,0,2,0,2
Alex Caceres,2015-06-06,Francisco Rivera,KO/TKO,0,0,0,0
Alex Caceres,2017-06-17,Rolando Dy,TKO - Doctor's Stoppage,0,31,0,31
Alex Caceres,2014-09-20,Masanori Kanehara,Decision - Unanimous,0,0,0,0
Alex Caceres,2013-09-21,Roland Delorme,Decision - Split,70,59,0,129
Alex Caceres,2011-11-12,Cole Escovedo,Decision - Unanimous,80,78,0,158
Alex Caceres,2022-12-17,Julian Erosa,KO/TKO,100,6,0,106
Alex Caceres,2021-10-23,SeungWoo Choi,Submission,90,13,0,103
Alex Caceres,2019-07-20,Steven Peterson,Decision - Unanimous,80,27,0,107
Alex Caceres,2024-05-11,Sean Woodson,Decision - Unanimous,0,0,0,0
Alex Caceres,2023-06-03,Daniel Pineda,Decision - Unanimous,80,33,0,113
Alex Caceres,2022-03-12,Sodiq Yusuff,Decision - Unanimous,0,2,0,2
Alex Caceres,2014-01-25,Sergio Pettis,Submission,90,4,0,94
Alex Caceres,2021-02-27,Kevin Croom,Decision - Unanimous,80,32,0,112
Alex Caceres,2018-07-06,Martin Bravo,Decision - Split,70,4,0,74
Alex Caceres,2017-11-25,Wang Guan,Decision - Split,0,0,0,0
Alex Caceres,2016-01-30,Masio Fullen,Decision - Unanimous,80,38,0,118
Alex Caceres,2016-06-04,Cole Miller,Decision - Unanimous,80,64,0,144
Alex Caceres,2016-08-06,Yair Rodriguez,Decision - Split,0,0,25,25
Alex Caceres,2017-01-28,Jason Knight,Submission,0,0,0,0
Alex Caceres,2011-08-14,Jimy Hettes,Submission,0,11,0,11
Alex Caceres,2011-03-26,Mackens Semerzier,Submission,0,0,0,0
Alex Caceres,2014-07-05,Urijah Faber,Submission,0,0,0,0
Alex Caceres,2012-11-10,Motonobu Tezuka,Decision - Split,70,42,0,112
Chase Hooper,2020-06-06,Alex Caceres,Decision - Unanimous,0,0,0,0
Chase Hooper,2023-05-20,Nick Fiore,Decision - Unanimous,80,98,0,178
Chase Hooper,2018-07-24,Canaan Kawaihae,Decision - Unanimous,80,46,0,126
Chase Hooper,2019-12-14,Daniel Teymur,KO/TKO,100,18,0,118
Chase Hooper,2022-10-29,Steve Garcia,KO/TKO,0,0,0,0
Chase Hooper,2021-06-12,Steven Peterson,Decision - Unanimous,0,0,0,0
Chase Hooper,2024-12-07,Clay Guida,Submission,90,2,0,92
Chase Hooper,2023-11-18,Jordan Leavitt,Submission,90,0,0,90
Chase Hooper,2022-05-21,Felipe Colares,KO/TKO,100,39,0,139
Chase Hooper,2024-05-11,Viacheslav Borshchev,Submission,90,60,0,150
Chase Hooper,2020-12-12,Peter Barrett,Submission,90,9,0,99
Chase Sherman,2021-04-17,Andrei Arlovski,Decision - Unanimous,0,0,0,0
Chase Sherman,2017-05-13,Rashad Coulter,KO/TKO,100,67,0,167
Chase Sherman,2018-09-22,Augusto Sakai,KO/TKO,0,0,0,0
Chase Sherman,2022-04-30,Alexandr Romanov,Submission,0,0,0,0
Chase Sherman,2022-07-09,Jared Vanderaa,KO/TKO,100,28,0,128
Chase Sherman,2018-04-21,Justin Willis,Decision - Unanimous,0,0,0,0
Chase Sherman,2020-05-13,Ike Villanueva,KO/TKO,100,35,0,135
Chase Sherman,2017-07-22,Damian Grabowski,Decision - Unanimous,80,43,0,123
Chase Sherman,2017-11-25,Shamil Abdurakhimov,KO/TKO,0,0,0,0
Chase Sherman,2021-08-21,Parker Porter,Decision - Unanimous,0,0,0,0
Chase Sherman,2017-01-15,Walt Harris,KO/TKO,0,0,0,0
Chase Sherman,2022-01-15,Jake Collier,Submission,0,0,0,0
Chase Sherman,2023-05-13,Karl Williams,Decision - Unanimous,0,0,0,0
Chase Sherman,2022-11-19,Waldo Cortes-Acosta,Decision - Unanimous,0,0,0,0
Chase Sherman,2016-08-06,Justin Ledet,Decision - Unanimous,0,0,0,0
Devonte Smith,2018-08-07,Joe Lowry,KO/TKO,100,17,0,117
Devonte Smith,2021-10-02,Jamie Mullarkey,KO/TKO,0,0,0,0
Devonte Smith,2018-11-10,Julian Erosa,KO/TKO,100,9,0,109
Devonte Smith,2019-02-09,Dong Hyun Ma,KO/TKO,100,18,0,118
Devonte Smith,2021-02-06,Justin Jaynes,TKO - Doctor's Stoppage,0,23,0,23
Devonte Smith,2022-03-05,Ludovit Klein,Decision - Split,0,0,0,0
Devonte Smith,2019-08-17,Khama Worthy,KO/TKO,0,0,0,0
Joe Lowry,2018-08-07,Devonte Smith,KO/TKO,0,0,0,0
Joe Lowry,2020-11-10,Nikolas Motta,Decision - Unanimous,0,12,0,12
Phillipe Nover,2015-12-10,Zubaira Tukhugov,Decision - Split,0,0,0,0
Phillipe Nover,2017-02-11,Ricky Glenn,Decision - Split,0,0,0,0
Phillipe Nover,2009-05-23,Kyle Bradley,KO/TKO,0,0,0,0
Phillipe Nover,2008-12-13,Efrain Escudero,Decision - Unanimous,0,0,0,0
Phillipe Nover,2010-02-06,Rob Emerson,Decision - Unanimous,0,0,0,0
Phillipe Nover,2016-09-24,Renan Barao,Decision - Unanimous,0,0,0,0
Phillipe Nover,2015-05-16,Yui Chul Nam,Decision - Split,70,0,0,70
Sam Spengler,2006-10-07,Frank Megallon,KO/TKO,100,11,0,111
Sam Spengler,2007-06-22,Seth Kleinbeck,KO/TKO,0,0,0,0
Frank Megallon,2006-10-07,Sam Spengler,KO/TKO,0,0,0,0
Dan Severn,1994-12-16,Royce Gracie,Submission,0,4,0,4
Dan Severn,1994-12-16,Marcus Bossett,Submission,90,0,0,90
Dan Severn,1995-07-14,Ken Shamrock,Submission,0,0,0,0
Dan Severn,1995-04-07,Oleg Taktarov,TKO - Doctor's Stoppage,0,9,0,9
Dan Severn,1995-12-16,Paul Varelans,Submission,90,0,0,90
Dan Severn,2000-09-22,Pedro Rizzo,KO/TKO,0,0,0,0
Dan Severn,1995-04-07,Dave Beneteau,Submission,90,0,0,90
Dan Severn,1996-05-17,Ken Shamrock,Decision - Split,70,0,0,70
Dan Severn,1995-12-16,Oleg Taktarov,Decision - Unanimous,80,16,0,96
Dan Severn,1997-02-07,Mark Coleman,Submission,0,0,0,0
Dan Severn,1995-04-07,Joe Charles,Submission,90,1,0,91
Dan Severn,1995-12-16,David Abbott,Decision - Unanimous,80,54,0,134
Dan Severn,1994-12-16,Anthony Macias,Submission,90,0,0,90
Juliana Lima,2014-07-26,Joanna Jedrzejczyk,Decision - Unanimous,0,0,0,0
Juliana Lima,2017-07-07,Tecia Pennington,Submission,0,0,0,0
Juliana Lima,2014-11-08,Nina Nunes,Decision - Unanimous,80,0,0,80
Juliana Lima,2016-12-09,JJ Aldrich,Decision - Unanimous,80,25,0,105
Juliana Lima,2018-01-27,Randa Markos,Decision - Unanimous,0,0,0,0
Juliana Lima,2016-04-23,Carla Esparza,Decision - Unanimous,0,0,0,0
Juliana Lima,2015-05-30,Ericka Almeida,Decision - Unanimous,80,28,0,108
Chad Griggs,2011-02-12,Gian Villante,KO/TKO,100,13,0,113
Chad Griggs,2012-04-21,Travis Browne,Submission,0,0,0,0
Chad Griggs,2011-06-18,Valentijn Overeem,KO/TKO,100,11,0,111
Chad Griggs,2010-08-21,Bobby Lashley,KO/TKO,100,0,0,100
Chad Griggs,2012-11-17,Cyrille Diabate,Submission,0,0,0,0
Gian Villante,2011-02-12,Chad Griggs,KO/TKO,0,0,0,0
Gian Villante,2021-11-06,Chris Barnett,KO/TKO,0,0,0,0
Gian Villante,2013-11-16,Cody Donovan,KO/TKO,100,0,0,100
Gian Villante,2015-07-25,Tom Lawlor,KO/TKO,0,9,0,9
Gian Villante,2011-06-24,Lorenz Larkin,Decision - Unanimous,0,0,0,0
Gian Villante,2020-12-05,Jake Collier,Decision - Unanimous,0,0,0,0
Gian Villante,2012-01-07,Trevor Smith,KO/TKO,100,10,0,110
Gian Villante,2020-06-27,Maurice Greene,Submission,0,9,0,9
Gian Villante,2014-03-23,Fabio Maldonado,Decision - Unanimous,0,0,0,0
Gian Villante,2017-07-22,Patrick Cummins,Decision - Split,0,0,0,0
Gian Villante,2015-04-18,Corey Anderson,KO/TKO,100,0,0,100
Gian Villante,2018-01-20,Francimar Barroso,Decision - Split,70,0,0,70
Gian Villante,2018-10-27,Ed Herman,Decision - Split,70,0,0,70
Gian Villante,2013-04-27,Ovince Saint Preux,Decision - Majority,0,0,0,0
Gian Villante,2012-05-19,Derrick Mehmen,Decision - Unanimous,80,39,0,119
Gian Villante,2019-02-23,Michal Oleksiejczuk,KO/TKO,0,0,0,0
Gian Villante,2017-03-11,Mauricio Rua,KO/TKO,0,0,0,0
Gian Villante,2016-12-09,Saparbeg Safarov,KO/TKO,100,23,0,123
Gian Villante,2014-06-28,Sean O'Connell,Decision - Split,70,0,0,70
Gian Villante,2015-11-14,Anthony Perosh,KO/TKO,100,13,0,113
Gian Villante,2018-06-01,Sam Alvey,Decision - Split,0,0,0,0
Gian Villante,2016-03-05,Ilir Latifi,Decision - Unanimous,0,0,0,0
Jean Matsumoto,2023-09-12,Kasey Tanner,Decision - Unanimous,80,1,0,81
Jean Matsumoto,2024-10-19,Brad Katona,Decision - Unanimous,80,0,0,80
Jean Matsumoto,2024-04-06,Dan Argueta,Submission,90,5,0,95
Kasey Tanner,2023-09-12,Jean Matsumoto,Decision - Unanimous,0,0,0,0
Hailey Cowan,2022-08-16,Claudia Leite,Decision - Split,70,7,0,77
Hailey Cowan,2023-04-29,Jamey-Lyn Horth,Decision - Unanimous,0,0,0,0
Claudia Leite,2022-08-16,Hailey Cowan,Decision - Split,0,0,0,0
Richard Walsh,2015-11-14,Steve Kennedy,Decision - Unanimous,80,55,0,135
Richard Walsh,2014-04-16,Chris Indich,Decision - Unanimous,80,59,0,139
Richard Walsh,2016-03-19,Viscardi Andrade,Decision - Unanimous,0,8,0,8
Richard Walsh,2015-02-28,Alan Jouban,KO/TKO,0,0,0,0
Richard Walsh,2016-11-26,Jonathan Meunier,Decision - Unanimous,0,0,0,0
Richard Walsh,2014-09-20,Kiichi Kunimoto,Decision - Split,0,23,0,23
Steve Kennedy,2015-11-14,Richard Walsh,Decision - Unanimous,0,0,0,0
Steve Kennedy,2015-06-20,Peter Sobotta,Submission,0,0,0,0
Patrick Cummins,2019-05-18,Ed Herman,KO/TKO,0,11,0,11
Patrick Cummins,2017-04-08,Jan Blachowicz,Decision - Unanimous,80,20,0,100
Patrick Cummins,2014-12-20,Antonio Carlos Junior,Decision - Unanimous,80,50,0,130
Patrick Cummins,2015-04-18,Ovince Saint Preux,KO/TKO,0,0,0,0
Patrick Cummins,2014-02-22,Daniel Cormier,KO/TKO,0,0,0,0
Patrick Cummins,2018-10-27,Misha Cirkunov,Submission,0,0,0,0
Patrick Cummins,2018-04-21,Corey Anderson,Decision - Unanimous,0,0,0,0
Patrick Cummins,2017-07-22,Gian Villante,Decision - Split,70,14,0,84
Patrick Cummins,2016-05-14,Rogerio Nogueira,KO/TKO,0,0,0,0
Patrick Cummins,2014-07-26,Kyle Kingsbury,Decision - Unanimous,80,51,0,131
Patrick Cummins,2015-11-07,Glover Teixeira,KO/TKO,0,0,0,0
Patrick Cummins,2015-08-01,Rafael Cavalcante,KO/TKO,100,26,0,126
Patrick Cummins,2014-06-07,Roger Narvaez,KO/TKO,100,29,0,129
Brad Blackburn,2008-12-27,Ryo Chonan,Decision - Unanimous,80,16,0,96
Brad Blackburn,2010-01-11,Amir Sadollah,Decision - Unanimous,0,0,0,0
Brad Blackburn,2010-04-10,DaMarques Johnson,KO/TKO,0,25,0,25
Brad Blackburn,2008-07-19,James Giboo,KO/TKO,100,44,0,144
Brad Blackburn,2009-06-20,Edgar Garcia,Decision - Split,70,27,0,97
Tafon Nchukwi,2020-09-08,Al Matavao,KO/TKO,100,0,0,100
Tafon Nchukwi,2022-03-12,Azamat Murzakanov,KO/TKO,0,15,0,15
Tafon Nchukwi,2021-09-18,Mike Rodriguez,Decision - Unanimous,80,67,0,147
Tafon Nchukwi,2021-05-08,JunYong Park,Decision - Majority,0,0,0,0
Tafon Nchukwi,2023-08-12,AJ Dobson,Decision - Unanimous,0,0,0,0
Tafon Nchukwi,2022-06-25,Carlos Ulberg,KO/TKO,0,0,0,0
Tafon Nchukwi,2020-12-19,Jamie Pickett,Decision - Unanimous,80,80,0,160
Al Matavao,2020-09-08,Tafon Nchukwi,KO/TKO,0,8,0,8
Marcos Vinicius,2012-06-23,Wagner Campos,KO/TKO,100,11,0,111
Marcos Vinicius,2013-09-04,Ali Bagautinov,KO/TKO,0,0,0,0
Marcos Vinicius,2012-12-15,Johnny Bedford,KO/TKO,0,0,0,0
Wagner Campos,2012-06-23,Marcos Vinicius,KO/TKO,0,0,0,0
Rashad Coulter,2017-05-13,Chase Sherman,KO/TKO,0,0,0,0
Rashad Coulter,2017-11-18,Tai Tuivasa,KO/TKO,0,0,0,0
Rashad Coulter,2018-11-24,Hu Yaozong,Decision - Unanimous,80,6,0,86
Rashad Coulter,2018-06-09,Chris de la Rocha,KO/TKO,0,0,0,0
Rashid Magomedov,2017-04-15,Bobby Green,Decision - Split,70,0,0,70
Rashid Magomedov,2015-11-07,Gilbert Burns,Decision - Unanimous,80,52,0,132
Rashid Magomedov,2014-02-01,Anthony Rocco Martin,Decision - Unanimous,80,28,0,108
Rashid Magomedov,2014-12-20,Elias Silverio,KO/TKO,100,35,0,135
Rashid Magomedov,2014-05-31,Rodrigo Damm,Decision - Unanimous,80,26,0,106
Rashid Magomedov,2016-11-05,Beneil Dariush,Decision - Unanimous,0,0,0,0
Pete Spratt,2007-04-07,Marcus Davis,Submission,0,1,0,1
Pete Spratt,2008-10-03,Donnie Liles,Submission,0,0,0,0
Pete Spratt,2003-04-25,Robbie Lawler,Submission,90,4,0,94
Pete Spratt,2003-11-29,Georges St-Pierre,Submission,0,0,0,0
Pete Spratt,2006-11-11,Jeremy Jackson,Submission,90,7,0,97
Pete Spratt,2002-11-22,Carlos Newton,Submission,0,1,0,1
Pete Spratt,2005-08-06,Josh Koscheck,Submission,0,0,0,0
Pete Spratt,2002-06-22,Zach Light,Submission,90,1,0,91
Pete Spratt,2007-06-12,Tamdan McCrory,Submission,0,11,0,11
John Hathaway,2009-06-13,Rick Story,Decision - Unanimous,80,10,0,90
John Hathaway,2014-03-01,Dong Hyun Kim,KO/TKO,0,0,25,25
John Hathaway,2009-11-14,Paul Taylor,Decision - Unanimous,80,75,0,155
John Hathaway,2010-10-16,Mike Pyle,Decision - Unanimous,0,0,0,0
John Hathaway,2012-05-05,Pascal Krauss,Decision - Unanimous,80,35,0,115
John Hathaway,2012-09-29,John Maguire,Decision - Unanimous,80,28,0,108
John Hathaway,2010-05-29,Diego Sanchez,Decision - Unanimous,80,60,0,140
John Hathaway,2011-03-26,Kris McCray,Decision - Split,70,0,0,70
John Hathaway,2009-01-17,Tom Egan,KO/TKO,100,18,0,118
Chris Lytle,2008-10-18,Paul Taylor,Decision - Unanimous,80,17,0,97
Chris Lytle,2005-10-07,Joe Riggs,TKO - Doctor's Stoppage,0,0,0,0
Chris Lytle,2004-04-02,Tiki Ghosn,Submission,90,7,0,97
Chris Lytle,2009-01-17,Marcus Davis,Decision - Split,0,14,0,14
Chris Lytle,2005-05-19,Pat Healy,Decision - Split,70,0,0,70
Chris Lytle,2011-02-26,Brian Ebersole,Decision - Unanimous,0,0,0,0
Chris Lytle,2008-02-02,Kyle Bradley,KO/TKO,100,12,0,112
Chris Lytle,2008-07-05,Josh Koscheck,Decision - Unanimous,0,0,0,0
Chris Lytle,2011-08-14,Dan Hardy,Submission,90,66,0,156
Chris Lytle,2003-11-21,Robbie Lawler,Decision - Unanimous,0,7,0,7
Chris Lytle,2006-11-11,Matt Serra,Decision - Split,0,22,0,22
Chris Lytle,2004-08-21,Ronald Jhun,Submission,90,4,0,94
Chris Lytle,2010-09-25,Matt Serra,Decision - Unanimous,80,29,0,109
Chris Lytle,2010-07-03,Matt Brown,Submission,90,0,0,90
Chris Lytle,2000-11-17,Ben Earwood,Decision - Unanimous,0,0,0,0
Chris Lytle,2009-06-20,Kevin Burns,Decision - Unanimous,80,32,0,112
Chris Lytle,2005-02-05,Karo Parisyan,Decision - Unanimous,0,0,0,0
Chris Lytle,2010-02-20,Brian Foster,Submission,90,0,0,90
Chris Lytle,2007-07-07,Jason Gilliam,Submission,90,2,0,92
Chris Lytle,2007-03-03,Matt Hughes,Decision - Unanimous,0,0,0,0
Chris Lytle,2007-11-17,Thiago Alves,TKO - Doctor's Stoppage,0,3,0,3
Chris Lytle,2006-01-13,Trenell Young,KO/TKO,100,41,0,141
Paul Taylor,2008-10-18,Chris Lytle,Decision - Unanimous,0,0,0,0
Paul Taylor,2008-01-19,Paul Kelly,Decision - Unanimous,0,0,0,0
Paul Taylor,2009-11-14,John Hathaway,Decision - Unanimous,0,0,0,0
Paul Taylor,2007-09-08,Marcus Davis,Submission,0,0,0,0
Paul Taylor,2008-06-07,Jess Liaudin,Decision - Split,70,10,0,80
Paul Taylor,2011-02-05,Gabe Ruediger,KO/TKO,100,20,0,120
Paul Taylor,2010-10-23,Sam Stout,Decision - Split,0,33,0,33
Paul Taylor,2009-06-13,Peter Sobotta,Decision - Unanimous,80,28,0,108
Paul Taylor,2007-04-21,Edilberto de Oliveira,KO/TKO,100,32,0,132
Oleg Taktarov,1997-10-11,Gary Goodridge,KO/TKO,0,0,0,0
Oleg Taktarov,1995-04-07,Ernie Verdicia,Submission,90,0,0,90
Oleg Taktarov,1995-12-16,Dave Beneteau,Submission,90,0,0,90
Oleg Taktarov,1995-04-07,Dan Severn,TKO - Doctor's Stoppage,0,0,0,0
Oleg Taktarov,1995-12-16,Marco Ruas,Decision - Unanimous,80,0,0,80
Oleg Taktarov,1995-07-14,David Abbott,Submission,90,0,0,90
Oleg Taktarov,1995-07-14,Dave Beneteau,Submission,90,0,0,90
Oleg Taktarov,1995-12-16,Dan Severn,Decision - Unanimous,0,0,0,0
Oleg Taktarov,1995-07-14,Anthony Macias,Submission,90,0,0,90
Khamzat Chimaev,2023-10-21,Kamaru Usman,Decision - Majority,75,2,0,77
Khamzat Chimaev,2024-10-26,Robert Whittaker,Submission,90,1,25,116
Khamzat Chimaev,2021-10-30,Li Jingliang,Submission,90,25,0,115
Khamzat Chimaev,2020-07-15,John Phillips,Submission,90,42,0,132
Khamzat Chimaev,2020-07-25,Rhys McKee,KO/TKO,100,40,0,140
Khamzat Chimaev,2020-09-19,Gerald Meerschaert,KO/TKO,100,4,0,104
Khamzat Chimaev,2022-04-09,Gilbert Burns,Decision - Unanimous,80,0,0,80
Khamzat Chimaev,2022-09-10,Kevin Holland,Submission,90,0,25,115
Taylor Lapilus,2016-09-03,Leandro Issa,Decision - Unanimous,80,44,0,124
Taylor Lapilus,2024-09-28,Vince Morales,Decision - Unanimous,80,55,0,135
Taylor Lapilus,2015-04-11,Rocky Lee,Decision - Unanimous,80,43,0,123
Taylor Lapilus,2015-11-21,Erik Perez,Decision - Unanimous,0,0,0,0
Taylor Lapilus,2024-06-08,Cody Stamann,Decision - Unanimous,80,41,0,121
Taylor Lapilus,2024-01-13,Farid Basharat,Decision - Unanimous,0,0,0,0
Taylor Lapilus,2015-06-20,Yuta Sasaki,KO/TKO,100,15,0,115
Taylor Lapilus,2023-09-02,Caolan Loughran,Decision - Unanimous,80,36,0,116
John Renken,2000-06-04,Akira Shoji,Submission,0,0,0,0
Caol Uno,2001-11-02,BJ Penn,KO/TKO,0,0,0,0
Caol Uno,2010-12-31,Kazuyuki Miyata,Decision - Unanimous,0,0,0,0
Caol Uno,2009-06-13,Spencer Fisher,Decision - Unanimous,0,0,0,0
Caol Uno,2008-07-21,Shinya Aoki,Decision - Unanimous,0,13,0,13
Caol Uno,2001-02-23,Jens Pulver,Decision - Unanimous,0,0,25,25
Caol Uno,2002-09-27,Din Thomas,Decision - Unanimous,80,24,0,104
Caol Uno,2011-09-24,Takeshi Inoue,KO/TKO,0,0,0,0
Caol Uno,2001-06-29,Fabiano Iha,KO/TKO,100,2,0,102
Caol Uno,2008-05-11,Mitsuhiro Ishida,Submission,90,13,0,103
Caol Uno,2011-05-29,Akiyo Nishiura,Decision - Unanimous,80,0,0,80
Caol Uno,2010-03-31,Gleison Tibau,KO/TKO,0,0,0,0
Caol Uno,2002-05-10,Yves Edwards,Decision - Unanimous,80,6,0,86
Caol Uno,2003-09-26,Hermes Franca,KO/TKO,0,19,0,19
Cortney Casey,2018-08-25,Angela Hill,Decision - Split,70,0,0,70
Cortney Casey,2016-08-20,Randa Markos,Submission,90,17,0,107
Cortney Casey,2021-03-13,JJ Aldrich,Decision - Split,0,10,0,10
Cortney Casey,2015-07-18,Joanne Wood,Decision - Unanimous,0,0,0,0
Cortney Casey,2017-05-13,Jessica Aguilar,Decision - Unanimous,80,46,0,126
Cortney Casey,2020-05-16,Mara Romero Borella,Submission,90,1,0,91
Cortney Casey,2020-06-20,Gillian Robertson,Submission,0,1,0,1
Cortney Casey,2022-07-09,Antonina Shevchenko,Decision - Split,0,0,0,0
Cortney Casey,2021-11-13,Liana Jojua,Decision - Unanimous,80,55,0,135
Cortney Casey,2018-04-14,Michelle Waterson-Gomez,Decision - Split,0,0,0,0
Cortney Casey,2016-11-19,Claudia Gadelha,Decision - Unanimous,0,0,0,0
Cortney Casey,2019-02-17,Cynthia Calvillo,Decision - Unanimous,0,0,0,0
Cortney Casey,2016-07-13,Cristina Stanciu,KO/TKO,100,14,0,114
Cortney Casey,2017-12-02,Felice Herrig,Decision - Split,0,15,0,15
Cortney Casey,2015-11-28,Seo Hee Ham,Decision - Unanimous,0,7,0,7
Drew Dober,2018-01-27,Frank Camacho,Decision - Unanimous,80,39,0,119
Drew Dober,2014-12-13,Jamie Varner,Submission,90,1,0,91
Drew Dober,2022-12-17,Bobby Green,KO/TKO,100,0,0,100
Drew Dober,2021-03-06,Islam Makhachev,Submission,0,0,0,0
Drew Dober,2019-03-09,Beneil Dariush,Submission,0,0,0,0
Drew Dober,2016-01-02,Scott Holtzman,Decision - Unanimous,80,0,0,80
Drew Dober,2019-06-29,Marco Polo Reyes,KO/TKO,100,11,0,111
Drew Dober,2022-07-30,Rafael Alves,KO/TKO,100,25,0,125
Drew Dober,2021-06-12,Brad Riddell,Decision - Unanimous,0,0,0,0
Drew Dober,2024-02-03,Renato Moicano,Decision - Unanimous,0,0,0,0
Drew Dober,2023-10-07,Ricky Glenn,KO/TKO,100,25,0,125
Drew Dober,2013-11-30,Sean Spencer,Decision - Unanimous,0,0,0,0
Drew Dober,2020-01-18,Nasrat Haqparast,KO/TKO,100,6,0,106
Drew Dober,2016-09-10,Jason Gonzalez,KO/TKO,100,10,0,110
Drew Dober,2024-07-13,Jean Silva,TKO - Doctor's Stoppage,0,6,0,6
Drew Dober,2015-06-13,Efrain Escudero,Submission,0,0,0,0
Drew Dober,2020-05-13,Alexander Hernandez,KO/TKO,100,27,0,127
Drew Dober,2022-03-12,Terrance McKinney,KO/TKO,100,0,0,100
Drew Dober,2023-05-06,Matt Frevola,KO/TKO,0,0,0,0
Drew Dober,2017-07-29,Joshua Burkman,KO/TKO,100,4,0,104
Drew Dober,2016-12-10,Olivier Aubin-Mercier,Submission,0,0,0,0
Drew Dober,2018-08-25,Jon Tuck,Decision - Unanimous,80,27,0,107
Drew Dober,2014-05-31,Nick Hein,Decision - Unanimous,0,0,0,0
Daniel Kelly,2015-05-09,Sam Alvey,KO/TKO,0,0,0,0
Daniel Kelly,2017-03-04,Rashad Evans,Decision - Split,70,21,0,91
Daniel Kelly,2015-11-14,Steve Montgomery,Decision - Unanimous,80,0,0,80
Daniel Kelly,2016-03-19,Antonio Carlos Junior,KO/TKO,100,4,0,104
Daniel Kelly,2017-06-10,Derek Brunson,KO/TKO,0,0,0,0
Daniel Kelly,2018-05-27,Tom Breese,KO/TKO,0,0,0,0
Daniel Kelly,2016-11-26,Chris Camozzi,Decision - Unanimous,80,0,0,80
Daniel Kelly,2015-02-14,Patrick Walsh,Decision - Unanimous,80,11,0,91
Daniel Kelly,2017-11-18,Elias Theodorou,Decision - Unanimous,0,0,0,0
Daniel Kelly,2014-11-07,Luke Zachrich,Submission,90,2,0,92
Enson Inoue,2000-08-27,Igor Vovchanchyn,TKO - Doctor's Stoppage,0,0,0,0
Enson Inoue,2000-01-30,Mark Kerr,Decision - Unanimous,0,0,0,0
Enson Inoue,1999-04-29,Soichi Nishida,Submission,90,4,0,94
Enson Inoue,2002-02-24,Antonio Rodrigo Nogueira,Submission,0,13,0,13
Enson Inoue,1997-05-30,Royce Alger,Submission,90,0,0,90
Enson Inoue,2000-12-09,Heath Herring,KO/TKO,0,0,0,0
Enson Inoue,1998-10-25,Randy Couture,Submission,90,4,0,94
Kenny Robertson,2014-07-05,Ildemar Alcantara,Decision - Unanimous,80,48,0,128
Kenny Robertson,2015-07-25,Ben Saunders,Decision - Split,0,0,0,0
Kenny Robertson,2015-01-24,Sultan Aliev,KO/TKO,100,6,0,106
Kenny Robertson,2011-02-05,Mike Pierce,KO/TKO,0,0,0,0
Kenny Robertson,2014-03-23,Thiago Perpetuo,Submission,90,9,0,99
Kenny Robertson,2013-02-23,Brock Jardine,Submission,90,8,0,98
Kenny Robertson,2012-07-11,Aaron Simpson,Decision - Unanimous,0,0,0,0
Kenny Robertson,2013-06-15,Sean Pierson,Decision - Majority,0,29,0,29
Kenny Robertson,2016-09-17,Roan Carneiro,Decision - Split,0,0,0,0
Ildemar Alcantara,2014-07-05,Kenny Robertson,Decision - Unanimous,0,0,0,0
Ildemar Alcantara,2013-01-19,Wagner Prado,Submission,90,0,0,90
Ildemar Alcantara,2013-06-08,Leandro Silva,Decision - Unanimous,80,0,0,80
Ildemar Alcantara,2015-07-15,Kevin Casey,Decision - Unanimous,0,0,0,0
Ildemar Alcantara,2013-10-09,Igor Araujo,Decision - Unanimous,0,0,0,0
Ildemar Alcantara,2015-01-31,Richardson Moreira,Decision - Split,70,6,0,76
Ildemar Alcantara,2014-02-15,Albert Tumenov,Decision - Split,70,18,0,88
Rich Attonito,2010-09-15,Rafael Natal,Decision - Unanimous,80,0,0,80
Rich Attonito,2011-12-10,Jake Hecht,KO/TKO,0,0,0,0
Rich Attonito,2011-06-26,Daniel Roberts,Decision - Unanimous,80,43,0,123
Rich Attonito,2010-12-04,David Branch,Decision - Unanimous,0,0,0,0
Rich Attonito,2010-06-19,Jamie Yager,KO/TKO,100,0,0,100
Branko Cikatic,1998-03-05,Mark Kerr,DQ,0,1,0,1
Branko Cikatic,1999-09-12,Maurice Smith,Submission,0,0,0,0
Mitch Raposo,2024-06-01,Andre Lima,Decision - Split,0,0,0,0
Mitch Raposo,2021-10-12,Jake Hadley,Submission,0,0,0,0
Ramazan Temirov,2024-10-12,CJ Vergara,KO/TKO,100,19,0,119
Chad Anheliger,2024-03-16,Charalampos Grigoriou,Decision - Unanimous,80,64,0,144
Chad Anheliger,2022-02-19,Jesse Strader,KO/TKO,100,3,0,103
Chad Anheliger,2021-09-07,Muin Gafurov,Decision - Split,70,16,0,86
Chad Anheliger,2024-11-02,Cody Gibson,Decision - Unanimous,0,0,0,0
Chad Anheliger,2023-11-18,Jose Johnson,Submission,0,0,0,0
Chad Anheliger,2022-09-10,Alatengheili,Decision - Unanimous,0,0,0,0
Charalampos Grigoriou,2024-03-16,Chad Anheliger,Decision - Unanimous,0,0,0,0
Charalampos Grigoriou,2023-08-15,Cameron Smotherman,KO/TKO,100,9,0,109
Charalampos Grigoriou,2024-08-10,Toshiomi Kazama,Submission,0,24,0,24
Jason Tan,2007-06-16,Marcus Davis,KO/TKO,0,0,0,0
Jason Tan,2008-05-24,Dong Hyun Kim,KO/TKO,0,0,0,0
Daria Zhelezniakova,2024-03-23,Montserrat Rendon,Decision - Unanimous,80,32,0,112
Daria Zhelezniakova,2024-09-28,Ailin Perez,Submission,0,0,0,0
Montserrat Rendon,2024-03-23,Daria Zhelezniakova,Decision - Unanimous,0,0,0,0
Montserrat Rendon,2023-09-23,Tamires Vidal,Decision - Split,70,9,0,79
Jack Marshman,2016-11-19,Magnus Cedenblad,KO/TKO,100,6,0,106
Jack Marshman,2019-07-06,Edmen Shahbazyan,Submission,0,0,0,0
Jack Marshman,2017-02-19,Thiago Santos,KO/TKO,0,0,0,0
Jack Marshman,2017-07-16,Ryan Janes,Decision - Unanimous,80,0,0,80
Jack Marshman,2018-11-03,Karl Roberson,Decision - Unanimous,0,0,0,0
Jack Marshman,2017-10-28,Antonio Carlos Junior,Submission,0,0,0,0
Jack Marshman,2019-03-16,John Phillips,Decision - Split,70,0,0,70
Jack Marshman,2020-10-31,Sean Strickland,Decision - Unanimous,0,0,0,0
Magnus Cedenblad,2016-11-19,Jack Marshman,KO/TKO,0,0,0,0
Magnus Cedenblad,2012-04-14,Francis Carmont,Submission,0,0,0,0
Magnus Cedenblad,2013-08-31,Jared Hamman,Submission,90,1,0,91
Magnus Cedenblad,2016-05-08,Garreth McLellan,KO/TKO,100,9,0,109
Magnus Cedenblad,2014-05-31,Krzysztof Jotko,Submission,90,2,0,92
Magnus Cedenblad,2014-10-04,Scott Askham,Decision - Unanimous,80,0,0,80
Jong Man Kim,2009-12-31,Hideo Tokoro,Decision - Unanimous,0,0,0,0
Chepe Mariscal,2023-06-24,Trevor Peek,Decision - Unanimous,80,20,0,100
Chepe Mariscal,2024-08-10,Damon Jackson,Decision - Unanimous,80,41,0,121
Chepe Mariscal,2024-04-06,Morgan Charriere,Decision - Split,70,22,0,92
Chepe Mariscal,2023-09-09,Jack Jenkins,KO/TKO,100,0,0,100
Trevor Peek,2023-06-24,Chepe Mariscal,Decision - Unanimous,0,0,0,0
Trevor Peek,2023-02-25,Erick Gonzalez,KO/TKO,100,44,0,144
Trevor Peek,2024-09-07,Yanal Ashmouz,Decision - Unanimous,0,13,0,13
Trevor Peek,2022-09-13,Malik Lewis,KO/TKO,100,0,0,100
Trevor Peek,2024-04-06,Charlie Campbell,Decision - Unanimous,0,0,0,0
Trevor Peek,2023-10-21,Mohammad Yahya,Decision - Unanimous,80,18,0,98
Abongo Humphrey,2010-03-26,George Bush,Submission,90,0,0,90
Abongo Humphrey,2011-01-07,Ovince Saint Preux,Decision - Unanimous,0,0,0,0
Abongo Humphrey,2010-07-23,Mike Kyle,Submission,0,0,0,0
Abongo Humphrey,2009-04-11,Brett Rogers,KO/TKO,0,0,0,0
George Bush,2010-03-26,Abongo Humphrey,Submission,0,7,0,7
Rafael Dos Anjos,2022-12-03,Bryan Barberena,Submission,90,6,0,96
Rafael Dos Anjos,2009-04-01,Tyson Griffin,Decision - Unanimous,0,0,0,0
Rafael Dos Anjos,2018-06-09,Colby Covington,Decision - Unanimous,0,6,25,31
Rafael Dos Anjos,2023-08-12,Vicente Luque,Decision - Unanimous,0,0,25,25
Rafael Dos Anjos,2017-12-16,Robbie Lawler,Decision - Unanimous,80,86,25,191
Rafael Dos Anjos,2014-12-13,Nate Diaz,Decision - Unanimous,80,64,0,144
Rafael Dos Anjos,2019-05-18,Kevin Lee,Submission,90,25,25,140
Rafael Dos Anjos,2013-08-28,Donald Cerrone,Decision - Unanimous,80,0,0,80
Rafael Dos Anjos,2010-01-11,Kyle Bradley,Decision - Unanimous,80,21,0,101
Rafael Dos Anjos,2022-07-09,Rafael Fiziev,KO/TKO,0,0,25,25
Rafael Dos Anjos,2016-07-07,Eddie Alvarez,KO/TKO,0,0,25,25
Rafael Dos Anjos,2014-06-07,Jason High,KO/TKO,100,12,0,112
Rafael Dos Anjos,2017-09-09,Neil Magny,Submission,90,12,0,102
Rafael Dos Anjos,2012-05-15,Kamal Shalorus,Submission,90,3,0,93
Rafael Dos Anjos,2017-06-17,Tarec Saffiedine,Decision - Unanimous,80,21,0,101
Rafael Dos Anjos,2012-11-17,Mark Bocek,Decision - Unanimous,80,35,0,115
Rafael Dos Anjos,2011-11-19,Gleison Tibau,Decision - Split,0,0,0,0
Rafael Dos Anjos,2008-11-15,Jeremy Stephens,KO/TKO,0,0,0,0
Rafael Dos Anjos,2014-04-19,Khabib Nurmagomedov,Decision - Unanimous,0,0,0,0
Rafael Dos Anjos,2016-11-05,Tony Ferguson,Decision - Unanimous,0,0,25,25
Rafael Dos Anjos,2024-03-09,Mateusz Gamrot,Decision - Unanimous,0,0,0,0
Rafael Dos Anjos,2022-03-05,Renato Moicano,Decision - Unanimous,80,61,25,166
Rafael Dos Anjos,2015-12-19,Donald Cerrone,KO/TKO,100,22,25,147
Rafael Dos Anjos,2019-07-20,Leon Edwards,Decision - Unanimous,0,0,25,25
Rafael Dos Anjos,2020-11-14,Paul Felder,Decision - Split,70,0,25,95
Rafael Dos Anjos,2011-07-02,George Sotiropoulos,KO/TKO,100,0,0,100
Rafael Dos Anjos,2015-03-14,Anthony Pettis,Decision - Unanimous,80,36,25,141
Rafael Dos Anjos,2010-04-10,Terry Etim,Submission,90,18,0,108
Rafael Dos Anjos,2010-08-07,Clay Guida,Submission,0,0,0,0
Rafael Dos Anjos,2014-08-23,Benson Henderson,KO/TKO,100,8,25,133
Rafael Dos Anjos,2012-07-11,Anthony Njokuani,Decision - Unanimous,80,19,0,99
Rafael Dos Anjos,2009-09-19,Rob Emerson,Decision - Unanimous,80,25,0,105
Rafael Dos Anjos,2020-01-25,Michael Chiesa,Decision - Unanimous,0,5,0,5
Rafael Dos Anjos,2024-10-26,Geoff Neal,KO/TKO,0,0,0,0
Rafael Dos Anjos,2018-11-30,Kamaru Usman,Decision - Unanimous,0,0,25,25
Rafael Dos Anjos,2013-05-18,Evan Dunham,Decision - Unanimous,80,0,0,80
Augusto Sakai,2018-08-10,Marcos Conrado Jr.,KO/TKO,100,66,0,166
Augusto Sakai,2018-09-22,Chase Sherman,KO/TKO,100,32,0,132
Augusto Sakai,2023-02-25,Don'Tale Mayes,Decision - Unanimous,80,24,0,104
Augusto Sakai,2020-05-30,Blagoy Ivanov,Decision - Split,70,12,0,82
Augusto Sakai,2019-09-14,Marcin Tybura,KO/TKO,100,9,0,109
Augusto Sakai,2021-12-11,Tai Tuivasa,KO/TKO,0,0,0,0
Augusto Sakai,2019-04-27,Andrei Arlovski,Decision - Split,70,0,0,70
Augusto Sakai,2021-06-05,Jairzinho Rozenstruik,KO/TKO,0,0,25,25
Augusto Sakai,2020-09-05,Alistair Overeem,KO/TKO,0,7,25,32
Augusto Sakai,2022-08-06,Serghei Spivac,KO/TKO,0,0,0,0
Marcos Conrado Jr.,2018-08-10,Augusto Sakai,KO/TKO,0,0,0,0
Jaqueline Amorim,2024-09-07,Vanessa Demopoulos,Submission,90,0,0,90
Jaqueline Amorim,2023-08-12,Montserrat Conejo Ruiz,KO/TKO,100,80,0,180
Jaqueline Amorim,2024-03-16,Cory McKenna,Submission,90,0,0,90
Jaqueline Amorim,2023-04-08,Sam Hughes,Decision - Unanimous,0,0,0,0
Vanessa Demopoulos,2024-09-07,Jaqueline Amorim,Submission,0,0,0,0
Vanessa Demopoulos,2022-11-19,Maria Oliveira,Decision - Unanimous,80,0,0,80
Vanessa Demopoulos,2020-08-11,Cory McKenna,Decision - Unanimous,0,0,0,0
Vanessa Demopoulos,2023-10-07,Kanako Murata,Decision - Unanimous,80,0,0,80
Vanessa Demopoulos,2022-01-22,Silvana Gomez Juarez,Submission,90,0,0,90
Vanessa Demopoulos,2023-05-20,Karolina Kowalkiewicz,Decision - Unanimous,0,0,0,0
Vanessa Demopoulos,2021-08-28,JJ Aldrich,Decision - Unanimous,0,0,0,0
Vanessa Demopoulos,2022-06-25,Jinh Yu Frey,Decision - Split,70,4,0,74
Vanessa Demopoulos,2024-05-18,Emily Ducote,Decision - Split,70,0,0,70
Dennis Siver,2011-10-29,Donald Cerrone,Submission,0,3,0,3
Dennis Siver,2009-01-17,Nate Mohr,KO/TKO,100,0,0,100
Dennis Siver,2013-07-06,Cub Swanson,KO/TKO,0,0,0,0
Dennis Siver,2015-06-20,Tatsuya Kawajiri,Decision - Unanimous,0,0,0,0
Dennis Siver,2011-07-02,Matt Wiman,Decision - Unanimous,80,5,0,85
Dennis Siver,2007-04-21,Jess Liaudin,Submission,0,1,0,1
Dennis Siver,2009-06-13,Dale Hartt,Submission,90,3,0,93
Dennis Siver,2010-06-19,Spencer Fisher,Decision - Unanimous,80,25,0,105
Dennis Siver,2008-01-23,Gray Maynard,Decision - Unanimous,0,0,0,0
Dennis Siver,2009-11-14,Paul Kelly,KO/TKO,100,26,0,126
Dennis Siver,2010-11-13,Andre Winner,Submission,90,17,0,107
Dennis Siver,2007-09-08,Naoyuki Kotani,KO/TKO,100,19,0,119
Dennis Siver,2012-12-08,Nam Phan,Decision - Unanimous,80,104,0,184
Dennis Siver,2015-01-18,Conor McGregor,KO/TKO,0,0,25,25
Dennis Siver,2017-06-25,BJ Penn,Decision - Majority,75,46,0,121
Dennis Siver,2011-02-26,George Sotiropoulos,Decision - Unanimous,80,36,0,116
Dennis Siver,2012-04-14,Diego Nunes,Decision - Unanimous,80,19,0,99
Dennis Siver,2014-10-04,Charles Rosa,Decision - Unanimous,80,11,0,91
Dennis Siver,2010-03-31,Ross Pearson,Decision - Unanimous,0,0,0,0
Dennis Siver,2008-07-05,Melvin Guillard,KO/TKO,0,0,0,0
Joe Riggs,2005-10-07,Chris Lytle,TKO - Doctor's Stoppage,0,12,0,12
Joe Riggs,2006-02-04,Nick Diaz,Decision - Unanimous,80,13,0,93
Joe Riggs,2006-05-27,Mike Swick,Submission,0,0,0,0
Joe Riggs,2006-12-13,Diego Sanchez,KO/TKO,0,0,0,0
Joe Riggs,2010-08-13,Louis Taylor,KO/TKO,100,0,0,100
Joe Riggs,2007-09-29,Eugene Jackson,KO/TKO,100,18,0,118
Joe Riggs,2008-11-21,Luke Stewart,KO/TKO,100,34,0,134
Joe Riggs,2008-02-23,Cory Devela,KO/TKO,0,0,0,0
Joe Riggs,2010-01-30,Jay Hieron,Decision - Unanimous,0,0,0,0
Joe Riggs,2016-02-21,Chris Camozzi,KO/TKO,0,0,0,0
Joe Riggs,2009-06-06,Phil Baroni,Decision - Unanimous,80,42,0,122
Joe Riggs,2006-08-17,Jason Von Flue,Submission,90,1,0,91
Joe Riggs,2015-09-05,Ron Stallings,DQ,0,11,0,11
Joe Riggs,2005-11-19,Matt Hughes,Submission,0,0,0,0
Joe Riggs,2008-09-20,Kazuo Misaki,KO/TKO,0,0,0,0
Joe Riggs,2004-08-21,Joe Doerksen,KO/TKO,100,23,0,123
Joe Riggs,2005-04-16,Ivan Salaverry,Submission,0,4,0,4
Joe Riggs,2015-04-25,Patrick Cote,Decision - Unanimous,0,0,0,0
Joe Riggs,2014-12-13,Ben Saunders,Submission,0,0,0,0
Matt Hobar,2014-05-31,Pedro Munhoz,KO/TKO,0,0,0,0
Matt Hobar,2014-08-23,Aaron Phillips,Decision - Unanimous,80,25,0,105
Matt Hobar,2014-12-06,Sergio Pettis,Decision - Unanimous,0,0,0,0
Ricardo Funch,2012-01-14,Mike Pyle,KO/TKO,0,0,0,0
Ricardo Funch,2012-06-22,Dan Miller,Submission,0,15,0,15
Ricardo Funch,2009-12-12,Johny Hendricks,Decision - Unanimous,0,0,0,0
Ricardo Funch,2010-06-12,Claude Patrick,Submission,0,0,0,0
Ramsey Nijem,2013-08-17,James Vick,Submission,0,0,0,0
Ramsey Nijem,2011-06-04,Tony Ferguson,KO/TKO,0,0,0,0
Ramsey Nijem,2014-04-11,Beneil Dariush,KO/TKO,100,25,0,125
Ramsey Nijem,2014-01-15,Justin Edwards,Decision - Unanimous,80,21,0,101
Ramsey Nijem,2011-10-29,Danny Downes,Decision - Unanimous,80,53,0,133
Ramsey Nijem,2012-12-08,Joe Proctor,Decision - Unanimous,80,28,0,108
Ramsey Nijem,2013-04-20,Myles Jury,KO/TKO,0,1,0,1
Ramsey Nijem,2015-07-25,Andrew Holbrook,Decision - Split,0,9,0,9
Ramsey Nijem,2014-08-30,Diego Ferreira,KO/TKO,0,0,0,0
Ramsey Nijem,2012-06-22,CJ Keith,KO/TKO,100,0,0,100
Jeremy Larsen,2013-10-19,Andre Fili,KO/TKO,0,0,0,0
Jeremy Larsen,2013-05-18,Lucas Martins,KO/TKO,0,13,0,13
Jeremy Larsen,2012-06-01,Joe Proctor,KO/TKO,0,3,0,3
Vernon White,2006-07-22,Lyoto Machida,Decision - Unanimous,0,0,0,0
Vernon White,2004-08-21,Chuck Liddell,KO/TKO,0,0,0,0
Vernon White,2000-06-04,Allan Goes,Decision - Unanimous,0,0,0,0
Vernon White,1998-03-05,Kazushi Sakuraba,Submission,0,0,0,0
Rafael Cavalcante,2011-09-10,Yoel Romero,KO/TKO,100,0,0,100
Rafael Cavalcante,2013-11-09,Igor Pokrajac,KO/TKO,100,7,0,107
Rafael Cavalcante,2011-03-05,Dan Henderson,KO/TKO,0,0,25,25
Rafael Cavalcante,2008-02-16,John Doyle,KO/TKO,100,16,0,116
Rafael Cavalcante,2014-06-14,Ryan Bader,Decision - Unanimous,0,0,0,0
Rafael Cavalcante,2009-11-20,Aaron Rosa,KO/TKO,100,16,0,116
Rafael Cavalcante,2008-06-14,Wayne Cole,KO/TKO,100,27,0,127
Rafael Cavalcante,2016-02-06,Ovince Saint Preux,Decision - Unanimous,0,0,0,0
Rafael Cavalcante,2013-06-08,Thiago Silva,KO/TKO,0,0,0,0
Rafael Cavalcante,2015-08-01,Patrick Cummins,KO/TKO,0,0,0,0
Rafael Cavalcante,2008-07-26,Travis Galbraith,KO/TKO,100,2,0,102
Rafael Cavalcante,2010-08-21,Muhammed Lawal,KO/TKO,100,0,25,125
Rafael Cavalcante,2010-05-15,Antwain Britt,KO/TKO,100,0,0,100
Tyson Griffin,2009-04-01,Rafael Dos Anjos,Decision - Unanimous,80,43,0,123
Tyson Griffin,2008-02-02,Gleison Tibau,Decision - Unanimous,80,37,0,117
Tyson Griffin,2008-10-25,Sean Sherk,Decision - Unanimous,0,0,0,0
Tyson Griffin,2009-09-19,Hermes Franca,KO/TKO,100,56,0,156
Tyson Griffin,2010-08-01,Takanori Gomi,KO/TKO,0,0,0,0
Tyson Griffin,2011-10-29,Bart Palaszewski,KO/TKO,0,0,0,0
Tyson Griffin,2010-11-20,Nik Lentz,Decision - Split,0,0,0,0
Tyson Griffin,2010-06-12,Evan Dunham,Decision - Split,0,0,0,0
Tyson Griffin,2011-06-26,Manvel Gamburyan,Decision - Unanimous,80,35,0,115
Tyson Griffin,2006-06-09,Duane Ludwig,KO/TKO,100,12,0,112
Tyson Griffin,2007-09-22,Thiago Tavares,Decision - Unanimous,80,23,0,103
Tyson Griffin,2008-07-05,Marcus Aurelio,Decision - Unanimous,80,72,0,152
Tyson Griffin,2006-09-23,David Lee,Submission,90,0,0,90
Tyson Griffin,2007-06-16,Clay Guida,Decision - Split,70,14,0,84
Tyson Griffin,2007-02-03,Frankie Edgar,Decision - Unanimous,0,0,0,0
Morgan Charriere,2024-09-28,Gabriel Miranda,KO/TKO,100,8,0,108
Morgan Charriere,2024-04-06,Chepe Mariscal,Decision - Split,0,0,0,0
Morgan Charriere,2023-09-02,Manolo Zecchini,KO/TKO,100,17,0,117
Gabriel Miranda,2024-09-28,Morgan Charriere,KO/TKO,0,0,0,0
Gabriel Miranda,2023-09-09,Shane Young,Submission,90,1,0,91
Gabriel Miranda,2022-09-03,Benoit Saint Denis,KO/TKO,0,0,0,0
Jack Della Maddalena,2022-06-11,Ramazan Emeev,KO/TKO,100,11,0,111
Jack Della Maddalena,2021-09-14,Ange Loosa,Decision - Unanimous,80,44,0,124
Jack Della Maddalena,2022-11-19,Danny Roberts,KO/TKO,100,28,0,128
Jack Della Maddalena,2023-09-16,Kevin Holland,Decision - Split,70,0,0,70
Jack Della Maddalena,2024-03-09,Gilbert Burns,KO/TKO,100,40,0,140
Jack Della Maddalena,2023-02-11,Randy Brown,Submission,90,3,0,93
Jack Della Maddalena,2023-07-15,Bassil Hafez,Decision - Split,70,51,0,121
Jack Della Maddalena,2022-01-22,Pete Rodriguez,KO/TKO,100,18,0,118
Ramazan Emeev,2022-06-11,Jack Della Maddalena,KO/TKO,0,0,0,0
Ramazan Emeev,2021-10-16,Danny Roberts,Decision - Split,0,6,0,6
Ramazan Emeev,2017-10-21,Sam Alvey,Decision - Unanimous,80,9,0,89
Ramazan Emeev,2020-07-25,Niklas Stolze,Decision - Unanimous,80,0,0,80
Ramazan Emeev,2018-09-15,Stefan Sekulic,Decision - Unanimous,80,14,0,94
Ramazan Emeev,2018-05-12,Alberto Mina,Decision - Unanimous,80,27,0,107
Ramazan Emeev,2021-01-16,David Zawada,Decision - Split,70,9,0,79
Ramazan Emeev,2019-11-09,Anthony Rocco Martin,Decision - Unanimous,0,0,0,0
Ronny Markes,2012-02-15,Aaron Simpson,Decision - Split,70,7,0,77
Ronny Markes,2013-01-19,Andrew Craig,Decision - Unanimous,80,0,0,80
Ronny Markes,2013-11-06,Yoel Romero,KO/TKO,0,0,0,0
Ronny Markes,2011-08-14,Karlos Vemola,Decision - Unanimous,80,32,0,112
Ronny Markes,2014-03-23,Thiago Santos,KO/TKO,0,0,0,0
Aaron Simpson,2012-02-15,Ronny Markes,Decision - Split,0,0,0,0
Aaron Simpson,2011-07-02,Brad Tavares,Decision - Unanimous,80,30,0,110
Aaron Simpson,2008-11-05,David Avellan,KO/TKO,100,2,0,102
Aaron Simpson,2009-04-01,Tim McKenzie,KO/TKO,100,15,0,115
Aaron Simpson,2010-01-11,Tom Lawlor,Decision - Split,70,0,0,70
Aaron Simpson,2011-10-08,Eric Schafer,Decision - Unanimous,80,44,0,124
Aaron Simpson,2010-06-19,Chris Leben,KO/TKO,0,1,0,1
Aaron Simpson,2010-11-20,Mark Munoz,Decision - Unanimous,0,0,0,0
Aaron Simpson,2011-03-26,Mario Miranda,Decision - Unanimous,80,45,0,125
Aaron Simpson,2012-10-05,Mike Pierce,KO/TKO,0,18,0,18
Aaron Simpson,2009-08-29,Ed Herman,KO/TKO,100,18,0,118
Aaron Simpson,2012-07-11,Kenny Robertson,Decision - Unanimous,80,19,0,99
Shana Dobson,2017-12-01,Ariel Beck,KO/TKO,100,0,0,100
Shana Dobson,2018-04-14,Lauren Mueller,Decision - Unanimous,0,10,0,10
Shana Dobson,2019-08-17,Sabina Mazo,Decision - Unanimous,0,0,0,0
Shana Dobson,2020-08-22,Mariya Agapova,KO/TKO,100,2,0,102
Shana Dobson,2021-02-20,Casey O'Neill,KO/TKO,0,0,0,0
Shana Dobson,2020-02-22,Priscila Cachoeira,KO/TKO,0,0,0,0
Ariel Beck,2017-12-01,Shana Dobson,KO/TKO,0,1,0,1
Lucas Alexander,2023-11-18,Jeka Saragih,KO/TKO,0,7,0,7
Lucas Alexander,2023-03-25,Steven Peterson,Decision - Unanimous,80,59,0,139
Lucas Alexander,2022-10-15,Joanderson Brito,Submission,0,0,0,0
Thiago Alves,2010-12-11,John Howard,Decision - Unanimous,80,36,0,116
Thiago Alves,2016-11-12,Jim Miller,Decision - Unanimous,0,8,0,8
Thiago Alves,2006-10-10,John Alessio,Decision - Unanimous,80,50,0,130
Thiago Alves,2018-09-15,Aleksei Kunchenko,Decision - Unanimous,0,12,0,12
Thiago Alves,2006-12-30,Tony DeSouza,KO/TKO,100,25,0,125
Thiago Alves,2010-08-07,Jon Fitch,Decision - Unanimous,0,0,0,0
Thiago Alves,2007-09-19,Kuniyoshi Hironaka,KO/TKO,100,33,0,133
Thiago Alves,2012-03-02,Martin Kampmann,Submission,0,15,0,15
Thiago Alves,2008-06-07,Matt Hughes,KO/TKO,100,1,0,101
Thiago Alves,2009-07-11,Georges St-Pierre,Decision - Unanimous,0,0,25,25
Thiago Alves,2017-04-08,Patrick Cote,Decision - Unanimous,80,35,0,115
Thiago Alves,2005-10-03,Spencer Fisher,Submission,0,6,0,6
Thiago Alves,2015-05-30,Carlos Condit,TKO - Doctor's Stoppage,0,0,25,25
Thiago Alves,2011-05-28,Rick Story,Decision - Unanimous,0,0,0,0
Thiago Alves,2008-04-02,Karo Parisyan,KO/TKO,100,7,0,107
Thiago Alves,2005-11-19,Ansar Chalangov,KO/TKO,100,6,0,106
Thiago Alves,2008-10-25,Josh Koscheck,Decision - Unanimous,80,41,0,121
Thiago Alves,2019-02-02,Max Griffin,Decision - Split,70,0,0,70
Thiago Alves,2019-12-07,Tim Means,Submission,0,0,0,0
Thiago Alves,2019-05-11,Laureano Staropoli,Decision - Unanimous,0,4,0,4
Thiago Alves,2018-02-18,Curtis Millender,KO/TKO,0,0,0,0
Thiago Alves,2011-11-05,Papy Abedi,Submission,90,11,0,101
Thiago Alves,2014-04-19,Seth Baczynski,Decision - Unanimous,80,26,0,106
Thiago Alves,2007-11-17,Chris Lytle,TKO - Doctor's Stoppage,0,0,0,0
Thiago Alves,2006-06-28,Jon Fitch,KO/TKO,0,0,0,0
Thiago Alves,2006-04-15,Derrick Noble,KO/TKO,100,0,0,100
Thiago Alves,2015-01-31,Jordan Mein,KO/TKO,100,0,0,100
Greg Hardy,2020-05-09,Yorgan De Castro,Decision - Unanimous,80,31,0,111
Greg Hardy,2020-10-31,Maurice Greene,KO/TKO,100,29,0,129
Greg Hardy,2022-03-05,Serghei Spivac,KO/TKO,0,0,0,0
Greg Hardy,2020-12-19,Marcin Tybura,KO/TKO,0,0,0,0
Greg Hardy,2019-04-27,Dmitrii Smoliakov,KO/TKO,100,13,0,113
Greg Hardy,2019-01-19,Allen Crowder,DQ,0,17,0,17
Greg Hardy,2019-07-20,Juan Adams,KO/TKO,100,33,0,133
Greg Hardy,2021-07-10,Tai Tuivasa,KO/TKO,0,0,0,0
Greg Hardy,2018-06-12,Austen Lane,KO/TKO,100,1,0,101
Greg Hardy,2019-11-09,Alexander Volkov,Decision - Unanimous,0,0,0,0
Greg Hardy,2018-08-07,Tebaris Gordon,KO/TKO,100,13,0,113
Yorgan De Castro,2020-05-09,Greg Hardy,Decision - Unanimous,0,0,0,0
Yorgan De Castro,2020-10-03,Carlos Felipe,Decision - Unanimous,0,0,0,0
Yorgan De Castro,2019-10-05,Justin Tafa,KO/TKO,100,0,0,100
Yorgan De Castro,2019-06-18,Sanford Alton Meeks,KO/TKO,100,16,0,116
Yorgan De Castro,2021-04-10,Jarjis Danho,KO/TKO,0,0,0,0
Tanner Boser,2020-11-07,Andrei Arlovski,Decision - Unanimous,0,34,0,34
Tanner Boser,2021-06-26,Ovince Saint Preux,KO/TKO,100,24,0,124
Tanner Boser,2023-04-15,Ion Cutelaba,KO/TKO,0,0,0,0
Tanner Boser,2020-07-25,Raphael Pessoa,KO/TKO,100,31,0,131
Tanner Boser,2020-06-27,Philipe Lins,KO/TKO,100,9,0,109
Tanner Boser,2022-09-17,Rodrigo Nascimento,Decision - Split,0,26,0,26
Tanner Boser,2019-12-21,Ciryl Gane,Decision - Unanimous,0,0,0,0
Tanner Boser,2023-08-05,Aleksa Camur,Decision - Unanimous,80,52,0,132
Tanner Boser,2019-10-18,Daniel Spitz,Decision - Unanimous,80,61,0,141
Tanner Boser,2021-06-05,Ilir Latifi,Decision - Split,0,35,0,35
Buddy Roberts,2012-08-11,Yushin Okami,KO/TKO,0,0,0,0
Buddy Roberts,2012-06-08,Caio Magalhaes,Decision - Unanimous,80,13,0,93
Scott Jorgensen,2012-12-08,John Albert,Submission,90,7,0,97
Scott Jorgensen,2012-06-08,Eddie Wineland,KO/TKO,0,0,0,0
Scott Jorgensen,2015-07-15,Manvel Gamburyan,Decision - Unanimous,0,0,0,0
Scott Jorgensen,2010-04-24,Antonio Banuelos,Decision - Unanimous,80,48,0,128
Scott Jorgensen,2014-06-07,Danny Martinez,Decision - Unanimous,80,0,0,80
Scott Jorgensen,2013-04-13,Urijah Faber,Submission,0,0,25,25
Scott Jorgensen,2014-10-25,Wilson Reis,Submission,0,0,0,0
Scott Jorgensen,2014-03-23,Jussier Formiga,Submission,0,0,0,0
Scott Jorgensen,2010-03-06,Chad George,Submission,90,0,0,90
Scott Jorgensen,2012-02-04,Renan Barao,Decision - Unanimous,0,0,0,0
Scott Jorgensen,2008-02-13,Damacio Page,Decision - Unanimous,0,3,0,3
Scott Jorgensen,2013-12-14,Zach Makovsky,Decision - Unanimous,0,5,0,5
Scott Jorgensen,2011-06-04,Ken Stone,KO/TKO,100,0,0,100
Scott Jorgensen,2015-11-21,Alejandro Perez,KO/TKO,0,0,0,0
Scott Jorgensen,2009-10-10,Noah Thomas,KO/TKO,100,22,0,122
Scott Jorgensen,2010-12-16,Dominick Cruz,Decision - Unanimous,0,0,25,25
Scott Jorgensen,2009-01-25,Frank Gomez,Submission,90,1,0,91
Scott Jorgensen,2011-10-29,Jeff Curran,Decision - Unanimous,80,1,0,81
Scott Jorgensen,2009-06-07,Antonio Banuelos,Decision - Split,0,20,0,20
Scott Jorgensen,2010-08-18,Brad Pickett,Decision - Unanimous,80,39,0,119
Scott Jorgensen,2008-08-03,Kenji Osawa,Decision - Unanimous,80,28,0,108
Scott Jorgensen,2009-12-19,Takeya Mizugaki,Decision - Unanimous,80,9,0,89
John Albert,2012-12-08,Scott Jorgensen,Submission,0,0,0,0
John Albert,2013-07-27,Yaotzin Meza,Submission,0,0,0,0
John Albert,2012-06-01,Erik Perez,Submission,0,0,0,0
John Albert,2012-02-15,Ivan Menjivar,Submission,0,6,0,6
John Albert,2011-12-03,Dustin Pague,KO/TKO,100,18,0,118
Kazuyuki Miyata,2010-12-31,Caol Uno,Decision - Unanimous,80,7,0,87
Kazuyuki Miyata,2011-12-31,Tatsuya Kawajiri,Submission,0,0,0,0
Kazuyuki Miyata,2011-07-16,Hiroyuki Takaya,Decision - Split,0,21,0,21
Kazuyuki Miyata,2008-03-15,Luiz Firmino,Submission,0,0,0,0
Kazuyuki Miyata,2009-10-06,Daiki Hata,Decision - Unanimous,80,10,0,90
Kazuyuki Miyata,2010-05-29,Takafumi Otsuka,Decision - Split,70,7,0,77
Kazuyuki Miyata,2010-09-25,Takeshi Inoue,Decision - Unanimous,80,0,0,80
Yan Xiaonan,2024-11-23,Tabatha Ricci,Decision - Unanimous,80,63,0,143
Yan Xiaonan,2018-11-24,Syuri Kondo,Decision - Unanimous,80,64,0,144
Yan Xiaonan,2018-06-23,Viviane Pereira,Decision - Unanimous,80,27,0,107
Yan Xiaonan,2022-10-01,Mackenzie Dern,Decision - Majority,75,52,25,152
Yan Xiaonan,2020-11-07,Claudia Gadelha,Decision - Unanimous,80,38,0,118
Yan Xiaonan,2019-06-08,Angela Hill,Decision - Unanimous,80,23,0,103
Yan Xiaonan,2022-03-05,Marina Rodriguez,Decision - Split,0,0,0,0
Yan Xiaonan,2024-04-13,Zhang Weili,Decision - Unanimous,0,0,25,25
Yan Xiaonan,2017-11-25,Kailin Curran,Decision - Unanimous,80,44,0,124
Yan Xiaonan,2021-05-22,Carla Esparza,KO/TKO,0,0,0,0
Yan Xiaonan,2023-05-06,Jessica Andrade,KO/TKO,100,14,0,114
Yan Xiaonan,2020-02-22,Karolina Kowalkiewicz,Decision - Unanimous,80,55,0,135
Tabatha Ricci,2024-11-23,Yan Xiaonan,Decision - Unanimous,0,0,0,0
Tabatha Ricci,2023-03-04,Jessica Penne,Submission,90,30,0,120
Tabatha Ricci,2023-06-24,Gillian Robertson,Decision - Unanimous,80,24,0,104
Tabatha Ricci,2023-11-11,Loopy Godinez,Decision - Split,0,0,0,0
Tabatha Ricci,2024-08-24,Angela Hill,Decision - Unanimous,80,0,0,80
Tabatha Ricci,2022-05-21,Polyana Viana,Decision - Unanimous,80,0,0,80
Tabatha Ricci,2021-06-05,Manon Fiorot,KO/TKO,0,0,0,0
Tabatha Ricci,2021-10-23,Maria Oliveira,Decision - Unanimous,80,0,0,80
Tabatha Ricci,2024-05-11,Tecia Pennington,Decision - Split,70,0,0,70
Miesha Tate,2021-07-17,Marion Reneau,KO/TKO,100,40,0,140
Miesha Tate,2009-05-15,Sarah Kaufman,Decision - Unanimous,0,0,0,0
Miesha Tate,2014-04-19,Liz Carmouche,Decision - Unanimous,80,9,0,89
Miesha Tate,2011-07-30,Marloes Coenen,Submission,90,0,25,115
Miesha Tate,2010-03-26,Zoila Frausto,Submission,90,8,0,98
Miesha Tate,2008-06-27,Elaina Maxwell,Decision - Unanimous,80,0,0,80
Miesha Tate,2016-11-12,Raquel Pennington,Decision - Unanimous,0,0,0,0
Miesha Tate,2016-03-05,Holly Holm,Submission,90,0,25,115
Miesha Tate,2015-01-31,Sara McMann,Decision - Majority,75,0,0,75
Miesha Tate,2023-12-02,Julia Avila,Submission,90,29,0,119
Miesha Tate,2010-08-13,Hitomi Akano,Decision - Unanimous,80,4,0,84
Miesha Tate,2012-03-03,Ronda Rousey,Submission,0,0,25,25
Miesha Tate,2022-07-16,Lauren Murphy,Decision - Unanimous,0,0,0,0
Miesha Tate,2014-09-20,Rin Nakai,Decision - Unanimous,80,39,0,119
Miesha Tate,2013-12-28,Ronda Rousey,Submission,0,0,25,25
Miesha Tate,2013-04-13,Cat Zingano,KO/TKO,0,0,0,0
Miesha Tate,2010-08-13,Maiju Kujala,Decision - Unanimous,80,18,0,98
Miesha Tate,2021-11-20,Ketlen Vieira,Decision - Unanimous,0,9,25,34
Miesha Tate,2016-07-09,Amanda Nunes,Submission,0,0,25,25
Miesha Tate,2015-07-25,Jessica Eye,Decision - Unanimous,80,2,0,82
Miesha Tate,2012-08-18,Julie Kedzie,Submission,90,0,0,90
Eric Wisely,2011-08-12,Pat Healy,Decision - Unanimous,0,0,0,0
Eric Wisely,2012-01-28,Charles Oliveira,Submission,0,0,0,0
Eric Wisely,2012-04-14,Jason Young,Decision - Unanimous,0,0,0,0
Brock Lesnar,2008-02-02,Frank Mir,Submission,0,14,0,14
Brock Lesnar,2010-07-03,Shane Carwin,Submission,90,0,25,115
Brock Lesnar,2008-08-09,Heath Herring,Decision - Unanimous,80,36,0,116
Brock Lesnar,2010-10-23,Cain Velasquez,KO/TKO,0,0,25,25
Brock Lesnar,2009-07-11,Frank Mir,KO/TKO,100,43,25,168
Brock Lesnar,2008-11-15,Randy Couture,KO/TKO,100,20,25,145
Brock Lesnar,2011-12-30,Alistair Overeem,KO/TKO,0,0,25,25
Brock Lesnar,2007-06-02,Min Soo Kim,KO/TKO,100,3,0,103
Pat Miletich,2000-06-09,John Alessio,Submission,90,8,0,98
Pat Miletich,1999-07-16,Andre Pederneiras,TKO - Doctor's Stoppage,0,3,25,28
Pat Miletich,2001-06-29,Shonie Carter,KO/TKO,100,0,0,100
Pat Miletich,2000-12-16,Kenichi Yamamoto,Submission,90,13,25,128
Pat Miletich,1999-01-08,Jorge Patino,Decision - Unanimous,80,8,0,88
Pat Miletich,1998-03-13,Townsend Saunders,Decision - Split,70,5,0,75
Pat Miletich,2002-03-22,Matt Lindland,KO/TKO,0,0,0,0
Pat Miletich,2001-05-04,Carlos Newton,Submission,0,14,25,39
Pat Miletich,1998-03-13,Chris Brennan,Submission,90,4,0,94
Pat Miletich,1998-10-16,Mikey Burnett,Decision - Split,70,0,0,70
John Alessio,2000-06-09,Pat Miletich,Submission,0,0,0,0
John Alessio,2006-10-10,Thiago Alves,Decision - Unanimous,0,0,0,0
John Alessio,2007-12-12,Todd Moore,Decision - Unanimous,80,18,0,98
John Alessio,2006-05-27,Diego Sanchez,Decision - Unanimous,0,8,0,8
John Alessio,2009-04-05,Andre Galvao,Submission,0,0,0,0
John Alessio,2012-04-21,Mark Bocek,Decision - Unanimous,0,0,0,0
John Alessio,2006-08-17,Alex Serdyukov,Submission,90,0,0,90
John Alessio,2008-03-26,Brock Larson,DQ,0,0,0,0
John Alessio,2012-07-07,Shane Roller,Decision - Unanimous,0,4,0,4
John Alessio,2007-03-24,Carlos Condit,Submission,0,0,25,25
John Alessio,2007-01-20,Brian Gassaway,Submission,90,7,0,97
John Alessio,2007-09-05,Marcelo Brito,Decision - Unanimous,80,44,0,124
John Alessio,2007-06-03,Alex Serdyukov,Submission,90,4,0,94
Ryan Jimmo,2014-04-16,Sean O'Connell,KO/TKO,100,5,0,105
Ryan Jimmo,2012-07-21,Anthony Perosh,KO/TKO,100,2,0,102
Ryan Jimmo,2014-06-14,Ovince Saint Preux,KO/TKO,0,1,0,1
Ryan Jimmo,2013-10-26,Jimi Manuwa,KO/TKO,0,0,0,0
Ryan Jimmo,2015-05-30,Francimar Barroso,Decision - Unanimous,0,0,0,0
Ryan Jimmo,2013-02-16,James Te Huna,Decision - Unanimous,0,0,0,0
Ryan Jimmo,2013-06-15,Igor Pokrajac,Decision - Unanimous,80,53,0,133
Sean O'Connell,2014-04-16,Ryan Jimmo,KO/TKO,0,0,0,0
Sean O'Connell,2016-06-18,Steve Bosse,Decision - Unanimous,0,0,0,0
Sean O'Connell,2015-01-18,Matt Van Buren,KO/TKO,100,0,0,100
Sean O'Connell,2016-01-17,Ilir Latifi,KO/TKO,0,0,0,0
Sean O'Connell,2014-06-28,Gian Villante,Decision - Split,0,16,0,16
Sean O'Connell,2016-12-09,Corey Anderson,KO/TKO,0,0,0,0
Sean O'Connell,2015-05-09,Anthony Perosh,KO/TKO,100,17,0,117
Sherron Leggett,2007-05-12,Charlie Kohler,KO/TKO,100,26,0,126
Sherron Leggett,2007-08-05,Jamie Varner,KO/TKO,0,0,0,0
Charlie Kohler,2007-05-12,Sherron Leggett,KO/TKO,0,0,0,0
Gilbert Burns,2015-11-07,Rashid Magomedov,Decision - Unanimous,0,0,0,0
Gilbert Burns,2024-09-07,Sean Brady,Decision - Unanimous,0,0,25,25
Gilbert Burns,2023-05-06,Belal Muhammad,Decision - Unanimous,0,0,25,25
Gilbert Burns,2020-05-30,Tyron Woodley,Decision - Unanimous,80,55,25,160
Gilbert Burns,2016-07-07,Lukasz Sajewski,Submission,90,0,0,90
Gilbert Burns,2019-04-27,Mike Davis,Submission,90,36,0,126
Gilbert Burns,2021-02-13,Kamaru Usman,KO/TKO,0,0,25,25
Gilbert Burns,2018-07-07,Dan Hooker,KO/TKO,0,0,0,0
Gilbert Burns,2021-07-10,Stephen Thompson,Decision - Unanimous,80,10,0,90
Gilbert Burns,2019-09-28,Gunnar Nelson,Decision - Unanimous,80,10,0,90
Gilbert Burns,2023-04-08,Jorge Masvidal,Decision - Unanimous,80,3,0,83
Gilbert Burns,2016-09-24,Michel Prazeres,Decision - Unanimous,0,0,0,0
Gilbert Burns,2024-03-09,Jack Della Maddalena,KO/TKO,0,0,0,0
Gilbert Burns,2014-07-26,Andreas Stahl,Decision - Unanimous,80,3,0,83
Gilbert Burns,2020-03-14,Demian Maia,KO/TKO,100,9,0,109
Gilbert Burns,2018-04-14,Dan Moret,KO/TKO,100,11,0,111
Gilbert Burns,2015-03-21,Alex Oliveira,Submission,90,0,0,90
Gilbert Burns,2022-04-09,Khamzat Chimaev,Decision - Unanimous,0,11,0,11
Gilbert Burns,2017-09-16,Jason Saggo,KO/TKO,100,7,0,107
Gilbert Burns,2014-10-25,Christos Giagos,Submission,90,3,0,93
Gilbert Burns,2018-12-08,Olivier Aubin-Mercier,Decision - Unanimous,80,36,0,116
Gilbert Burns,2023-01-21,Neil Magny,Submission,90,1,0,91
Gilbert Burns,2019-08-10,Aleksei Kunchenko,Decision - Unanimous,80,0,0,80
Tecia Pennington,2017-07-07,Juliana Lima,Submission,90,9,0,99
Tecia Pennington,2014-12-12,Angela Magana,Decision - Unanimous,80,59,0,139
Tecia Pennington,2019-03-02,Zhang Weili,Decision - Unanimous,0,0,0,0
Tecia Pennington,2017-02-04,Bec Rawlings,Decision - Unanimous,80,44,0,124
Tecia Pennington,2017-12-02,Michelle Waterson-Gomez,Decision - Unanimous,80,39,0,119
Tecia Pennington,2019-08-10,Marina Rodriguez,Decision - Unanimous,0,0,0,0
Tecia Pennington,2022-04-09,Mackenzie Dern,Decision - Split,0,26,0,26
Tecia Pennington,2021-08-07,Angela Hill,Decision - Unanimous,80,48,0,128
Tecia Pennington,2020-12-12,Sam Hughes,TKO - Doctor's Stoppage,0,32,0,32
Tecia Pennington,2024-10-05,Carla Esparza,Decision - Unanimous,80,41,0,121
Tecia Pennington,2018-02-24,Jessica Andrade,Decision - Unanimous,0,0,0,0
Tecia Pennington,2015-06-13,Angela Hill,Decision - Unanimous,80,5,0,85
Tecia Pennington,2016-04-16,Rose Namajunas,Decision - Unanimous,0,15,0,15
Tecia Pennington,2020-06-20,Brianna Fortino,Decision - Unanimous,80,40,0,120
Tecia Pennington,2024-05-11,Tabatha Ricci,Decision - Split,0,26,0,26
Tecia Pennington,2015-12-12,Jocelyn Jones-Lybarger,Decision - Unanimous,80,48,0,128
Tecia Pennington,2018-07-28,Joanna Jedrzejczyk,Decision - Unanimous,0,0,0,0
Michel Pereira,2024-03-09,Michal Oleksiejczuk,Submission,90,10,0,100
Michel Pereira,2019-09-14,Tristan Connelly,Decision - Unanimous,0,0,0,0
Michel Pereira,2024-10-19,Anthony Hernandez,KO/TKO,0,0,25,25
Michel Pereira,2020-02-15,Diego Sanchez,DQ,0,28,0,28
Michel Pereira,2021-07-10,Niko Price,Decision - Unanimous,80,16,0,96
Michel Pereira,2023-10-14,Andre Petroski,KO/TKO,100,6,0,106
Michel Pereira,2022-05-21,Santiago Ponzinibbio,Decision - Split,70,5,0,75
Michel Pereira,2022-01-22,Andre Fialho,Decision - Unanimous,80,62,0,142
Michel Pereira,2024-05-04,Ihor Potieria,Submission,90,4,0,94
Michel Pereira,2020-12-19,Khaos Williams,Decision - Unanimous,80,0,0,80
Michel Pereira,2020-09-05,Zelim Imadaev,Submission,90,65,0,155
Michel Pereira,2019-05-18,Danny Roberts,KO/TKO,100,4,0,104
Michal Oleksiejczuk,2024-03-09,Michel Pereira,Submission,0,0,0,0
Michal Oleksiejczuk,2022-08-06,Sam Alvey,KO/TKO,100,19,0,119
Michal Oleksiejczuk,2023-04-29,Caio Borralho,Submission,0,0,0,0
Michal Oleksiejczuk,2022-12-17,Cody Brundage,KO/TKO,100,15,0,115
Michal Oleksiejczuk,2022-03-05,Dustin Jacoby,Decision - Unanimous,0,0,0,0
Michal Oleksiejczuk,2019-09-28,Ovince Saint Preux,Submission,0,23,0,23
Michal Oleksiejczuk,2024-08-03,Shara Magomedov,Decision - Unanimous,0,0,0,0
Michal Oleksiejczuk,2021-10-30,Shamil Gamzatov,KO/TKO,100,0,0,100
Michal Oleksiejczuk,2024-06-01,Kevin Holland,Submission,0,0,0,0
Michal Oleksiejczuk,2021-03-27,Modestas Bukauskas,Decision - Split,70,0,0,70
Michal Oleksiejczuk,2019-04-20,Gadzhimurad Antigulov,KO/TKO,100,2,0,102
Michal Oleksiejczuk,2019-02-23,Gian Villante,KO/TKO,100,5,0,105
Michal Oleksiejczuk,2020-02-22,Jimmy Crute,Submission,0,1,0,1
Michal Oleksiejczuk,2023-08-26,Chidi Njokuani,KO/TKO,100,15,0,115
Julia Polastri,2023-09-12,Patricia Alujas,Submission,90,31,0,121
Julia Polastri,2021-09-14,Jasmine Jasudavicius,Decision - Unanimous,0,0,0,0
Julia Polastri,2024-10-12,Cory McKenna,Decision - Split,70,48,0,118
Julia Polastri,2024-06-15,Josefine Knutsson,Decision - Unanimous,0,0,0,0
Patricia Alujas,2023-09-12,Julia Polastri,Submission,0,0,0,0
Nicolas Dalby,2023-01-21,Warlley Alves,Decision - Split,70,53,0,123
Nicolas Dalby,2020-11-21,Daniel Rodriguez,Decision - Unanimous,80,0,0,80
Nicolas Dalby,2024-06-22,Rinat Fakhretdinov,Decision - Split,0,0,0,0
Nicolas Dalby,2021-06-26,Tim Means,Decision - Unanimous,0,1,0,1
Nicolas Dalby,2019-09-28,Alex Oliveira,Decision - Unanimous,80,13,0,93
Nicolas Dalby,2023-06-17,Muslim Salikhov,Decision - Unanimous,80,29,0,109
Nicolas Dalby,2015-05-30,Elizeu Zaleski dos Santos,Decision - Split,70,0,0,70
Nicolas Dalby,2016-09-03,Peter Sobotta,Decision - Unanimous,0,0,0,0
Nicolas Dalby,2016-04-10,Zak Cummings,Decision - Unanimous,0,1,0,1
Nicolas Dalby,2023-11-04,Gabriel Bonfim,KO/TKO,100,14,0,114
Nicolas Dalby,2022-07-23,Claudio Silva,Decision - Unanimous,80,34,0,114
David Zawada,2021-09-04,Alex Morono,Decision - Unanimous,0,0,0,0
David Zawada,2021-01-16,Ramazan Emeev,Decision - Split,0,0,0,0
David Zawada,2018-07-22,Danny Roberts,Decision - Split,0,0,0,0
David Zawada,2018-11-24,Li Jingliang,KO/TKO,0,0,0,0
David Zawada,2019-11-09,Abubakar Nurmagomedov,Submission,90,0,0,90
Ramona Pascual,2022-02-26,Josiane Nunes,Decision - Unanimous,0,0,0,0
Ramona Pascual,2022-11-05,Tamires Vidal,KO/TKO,0,0,0,0
Ramona Pascual,2022-06-11,Joselyne Edwards,Decision - Unanimous,0,0,0,0
Chris Daukaus,2021-09-25,Shamil Abdurakhimov,KO/TKO,100,15,0,115
Chris Daukaus,2023-08-12,Khalil Rountree Jr.,KO/TKO,0,0,0,0
Chris Daukaus,2022-03-26,Curtis Blaydes,KO/TKO,0,0,25,25
Chris Daukaus,2021-02-20,Aleksei Oleinik,KO/TKO,100,29,0,129
Chris Daukaus,2021-12-18,Derrick Lewis,KO/TKO,0,0,25,25
Chris Daukaus,2020-08-15,Parker Porter,KO/TKO,100,20,0,120
Chris Daukaus,2020-10-10,Rodrigo Nascimento,KO/TKO,100,12,0,112
Chris Daukaus,2022-12-10,Jairzinho Rozenstruik,KO/TKO,0,0,0,0
Jamey-Lyn Horth,2024-11-02,Ivana Petrovic,Decision - Split,70,4,0,74
Jamey-Lyn Horth,2024-12-14,Miranda Maverick,Decision - Unanimous,0,0,0,0
Jamey-Lyn Horth,2023-04-29,Hailey Cowan,Decision - Unanimous,80,13,0,93
Jamey-Lyn Horth,2023-12-02,Veronica Hardy,Decision - Split,0,0,0,0
Ivana Petrovic,2024-11-02,Jamey-Lyn Horth,Decision - Split,0,0,0,0
Ivana Petrovic,2023-07-01,Luana Carolina,Decision - Unanimous,0,0,0,0
Ivana Petrovic,2024-04-27,Liang Na,Submission,90,12,0,102
Darren Uyenoyama,2011-11-12,Norifumi Yamamoto,Decision - Unanimous,80,0,0,80
Darren Uyenoyama,2013-04-20,Joseph Benavidez,KO/TKO,0,0,0,0
Darren Uyenoyama,2008-06-15,Hideo Tokoro,Decision - Unanimous,0,0,0,0
Darren Uyenoyama,2012-10-05,Phil Harris,Submission,90,0,0,90
Darren Uyenoyama,2013-12-14,Alptekin Ozkilic,Decision - Split,0,6,0,6
Norifumi Yamamoto,2011-11-12,Darren Uyenoyama,Decision - Unanimous,0,0,0,0
Norifumi Yamamoto,2012-02-25,Vaughan Lee,Submission,0,7,0,7
Norifumi Yamamoto,2010-05-29,Federico Lopez,KO/TKO,100,6,0,106
Norifumi Yamamoto,2009-05-26,Joe Warren,Decision - Split,0,7,0,7
Norifumi Yamamoto,2009-12-31,Masanori Kanehara,Decision - Unanimous,0,5,0,5
Norifumi Yamamoto,2011-02-05,Demetrious Johnson,Decision - Unanimous,0,0,0,0
Nate Mohr,2009-01-17,Dennis Siver,KO/TKO,0,0,0,0
Nate Mohr,2007-06-12,Luke Caudillo,Decision - Unanimous,80,42,0,122
Nate Mohr,2007-04-05,Kurt Pellegrino,Submission,0,2,0,2
Nate Mohr,2007-12-29,Manvel Gamburyan,Submission,0,0,0,0
Brian Bowles,2011-03-03,Damacio Page,Submission,90,2,0,92
Brian Bowles,2010-03-06,Dominick Cruz,TKO - Doctor's Stoppage,0,0,25,25
Brian Bowles,2011-07-02,Takeya Mizugaki,Decision - Unanimous,80,15,0,95
Brian Bowles,2009-08-09,Miguel Torres,KO/TKO,100,4,25,129
Brian Bowles,2011-11-19,Urijah Faber,Submission,0,0,0,0
Brian Bowles,2007-06-03,Charlie Valencia,Submission,90,1,0,91
Brian Bowles,2007-12-12,Marcos Galvao,KO/TKO,100,8,0,108
Brian Bowles,2008-08-03,Damacio Page,Submission,90,0,0,90
Brian Bowles,2008-12-03,Will Ribeiro,Submission,90,0,0,90
Brian Bowles,2013-05-25,George Roop,KO/TKO,0,0,0,0
Damacio Page,2011-03-03,Brian Bowles,Submission,0,0,0,0
Damacio Page,2009-03-01,Marcos Galvao,KO/TKO,100,7,0,107
Damacio Page,2012-07-11,Alex Caceres,Submission,0,0,0,0
Damacio Page,2009-10-10,Will Campuzano,Submission,90,2,0,92
Damacio Page,2012-04-14,Brad Pickett,Submission,0,0,0,0
Damacio Page,2008-02-13,Scott Jorgensen,Decision - Unanimous,80,0,0,80
Damacio Page,2010-11-11,Demetrious Johnson,Submission,0,0,0,0
Damacio Page,2008-08-03,Brian Bowles,Submission,0,2,0,2
Davey Grant,2019-11-09,Grigory Popov,Decision - Split,70,0,0,70
Davey Grant,2016-02-27,Marlon Vera,Decision - Unanimous,80,49,0,129
Davey Grant,2023-07-22,Daniel Marcos,Decision - Split,0,22,0,22
Davey Grant,2024-12-14,Ramon Taveras,Decision - Unanimous,80,78,0,158
Davey Grant,2021-06-19,Marlon Vera,Decision - Unanimous,0,0,0,0
Davey Grant,2013-11-30,Chris Holdsworth,Submission,0,3,0,3
Davey Grant,2021-11-20,Adrian Yanez,Decision - Split,0,0,0,0
Davey Grant,2023-03-11,Raphael Assuncao,Submission,90,23,0,113
Davey Grant,2021-03-13,Jonathan Martinez,KO/TKO,100,19,0,119
Davey Grant,2020-07-11,Martin Day,KO/TKO,100,12,0,112
Davey Grant,2022-05-14,Louis Smolka,KO/TKO,100,10,0,110
Davey Grant,2016-10-08,Damian Stasiak,Submission,0,26,0,26
Davey Grant,2018-07-22,Manny Bermudez,Submission,0,1,0,1
Grigory Popov,2019-11-09,Davey Grant,Decision - Split,0,5,0,5
Grigory Popov,2019-06-08,Eddie Wineland,KO/TKO,0,0,0,0
Christian Leroy Duncan,2024-07-27,Gregory Rodrigues,Decision - Unanimous,0,0,0,0
Christian Leroy Duncan,2023-06-17,Armen Petrosyan,Decision - Unanimous,0,0,0,0
Christian Leroy Duncan,2024-03-02,Claudio Ribeiro,KO/TKO,100,61,0,161
Christian Leroy Duncan,2023-03-18,Dusko Todorovic,KO/TKO,100,5,0,105
Christian Leroy Duncan,2023-11-18,Denis Tiuliulin,KO/TKO,100,35,0,135
Rob Font,2024-10-19,Kyler Phillips,Decision - Unanimous,80,23,0,103
Rob Font,2021-05-22,Cody Garbrandt,Decision - Unanimous,80,113,25,218
Rob Font,2014-07-05,George Roop,KO/TKO,100,2,0,102
Rob Font,2019-12-07,Ricky Simon,Decision - Unanimous,80,31,0,111
Rob Font,2017-07-08,Douglas Silva de Andrade,Submission,90,42,0,132
Rob Font,2020-12-19,Marlon Moraes,KO/TKO,100,21,0,121
Rob Font,2018-01-20,Thomas Almeida,KO/TKO,100,17,0,117
Rob Font,2023-04-08,Adrian Yanez,KO/TKO,100,8,0,108
Rob Font,2016-12-03,Matt Schnell,KO/TKO,100,12,0,112
Rob Font,2022-04-30,Marlon Vera,Decision - Unanimous,0,112,25,137
Rob Font,2023-08-05,Cory Sandhagen,Decision - Unanimous,0,0,25,25
Rob Font,2018-12-15,Sergio Pettis,Decision - Unanimous,80,40,0,120
Rob Font,2021-12-04,Jose Aldo,Decision - Unanimous,0,63,25,88
Rob Font,2023-12-02,Deiveson Figueiredo,Decision - Unanimous,0,1,0,1
Rob Font,2016-01-17,Joey Gomez,KO/TKO,100,37,0,137
Rob Font,2018-07-07,Raphael Assuncao,Decision - Unanimous,0,0,0,0
Rob Font,2017-10-28,Pedro Munhoz,Submission,0,10,0,10
Rob Font,2016-05-14,John Lineker,Decision - Unanimous,0,0,0,0
Kyler Phillips,2024-10-19,Rob Font,Decision - Unanimous,0,0,0,0
Kyler Phillips,2024-03-09,Pedro Munhoz,Decision - Unanimous,80,62,0,142
Kyler Phillips,2023-08-05,Raoni Barcelos,Decision - Unanimous,80,26,0,106
Kyler Phillips,2020-10-03,Cameron Else,KO/TKO,100,21,0,121
Kyler Phillips,2017-08-01,James Gray,KO/TKO,100,12,0,112
Kyler Phillips,2022-02-12,Marcelo Rojo,Submission,90,25,0,115
Kyler Phillips,2021-03-06,Song Yadong,Decision - Unanimous,80,0,0,80
Kyler Phillips,2021-07-24,Raulian Paiva,Decision - Majority,0,23,0,23
Kyler Phillips,2020-02-29,Gabriel Silva,Decision - Unanimous,80,58,0,138
Nate Landwehr,2020-05-16,Darren Elkins,Decision - Unanimous,80,0,0,80
Nate Landwehr,2022-08-13,David Onama,Decision - Majority,75,20,0,95
Nate Landwehr,2021-02-20,Julian Erosa,KO/TKO,0,0,0,0
Nate Landwehr,2023-03-25,Austin Lingo,Submission,90,16,0,106
Nate Landwehr,2021-10-16,Ludovit Klein,Submission,90,29,0,119
Nate Landwehr,2020-01-25,Herbert Burns,KO/TKO,0,0,0,0
Nate Landwehr,2024-03-30,Jamall Emmers,KO/TKO,100,0,0,100
Nate Landwehr,2023-06-10,Dan Ige,Decision - Unanimous,0,0,0,0
Nate Landwehr,2024-12-07,Dooho Choi,KO/TKO,0,0,0,0
Daermisi Zhawupasi,2024-05-19,Ren Ozaki,Decision - Unanimous,80,0,0,80
Daermisi Zhawupasi,2023-05-28,Eperaim Ginting,Submission,90,0,0,90
Daermisi Zhawupasi,2023-08-27,ChangHo Lee,KO/TKO,0,0,0,0
Daermisi Zhawupasi,2024-08-23,SuYoung You,Decision - Split,0,2,0,2
Ren Ozaki,2024-05-19,Daermisi Zhawupasi,Decision - Unanimous,0,2,0,2
Melvin Manhoef,2008-05-11,Dae Won Kim,KO/TKO,100,3,0,103
Melvin Manhoef,2012-12-31,Denis Kang,KO/TKO,100,4,0,104
Melvin Manhoef,2009-12-31,Kazuo Misaki,KO/TKO,100,5,0,105
Melvin Manhoef,2009-07-20,Paulo Filho,Submission,0,22,0,22
Melvin Manhoef,2011-03-05,Tim Kennedy,Submission,0,0,0,0
Melvin Manhoef,2008-12-31,Mark Hunt,KO/TKO,100,5,0,105
Melvin Manhoef,2006-10-09,Yoshihiro Akiyama,Submission,0,5,0,5
Melvin Manhoef,2010-01-30,Robbie Lawler,KO/TKO,0,20,0,20
Melvin Manhoef,2010-07-10,Tatsuya Mizuno,Submission,0,0,0,0
Melvin Manhoef,2008-09-23,Gegard Mousasi,Submission,0,0,0,0
Melvin Manhoef,2008-06-15,Kazushi Sakuraba,KO/TKO,100,21,0,121
Lyman Good,2020-06-20,Belal Muhammad,Decision - Unanimous,0,0,0,0
Lyman Good,2019-02-02,Demian Maia,Submission,0,0,0,0
Lyman Good,2015-07-15,Andrew Craig,KO/TKO,100,35,0,135
Lyman Good,2018-11-03,Ben Saunders,KO/TKO,100,2,0,102
Lyman Good,2019-11-02,Chance Rencountre,KO/TKO,100,45,0,145
Lyman Good,2017-07-22,Elizeu Zaleski dos Santos,Decision - Split,0,0,0,0
Paul Felder,2017-02-19,Alex Ricci,KO/TKO,100,2,0,102
Paul Felder,2015-01-03,Danny Castillo,KO/TKO,100,12,0,112
Paul Felder,2015-07-25,Edson Barboza,Decision - Unanimous,0,0,0,0
Paul Felder,2017-12-02,Charles Oliveira,KO/TKO,100,25,0,125
Paul Felder,2017-07-16,Stevie Ray,KO/TKO,100,18,0,118
Paul Felder,2019-02-17,James Vick,Decision - Unanimous,80,0,0,80
Paul Felder,2016-09-24,Francisco Trinaldo,TKO - Doctor's Stoppage,0,1,0,1
Paul Felder,2020-11-14,Rafael Dos Anjos,Decision - Split,0,6,25,31
Paul Felder,2018-07-07,Mike Perry,Decision - Split,0,0,0,0
Paul Felder,2016-05-29,Joshua Burkman,Decision - Unanimous,80,1,0,81
Paul Felder,2020-02-22,Dan Hooker,Decision - Split,0,0,25,25
Paul Felder,2016-01-17,Daron Cruickshank,Submission,90,14,0,104
Paul Felder,2014-10-04,Jason Saggo,Decision - Split,70,22,0,92
Paul Felder,2019-09-07,Edson Barboza,Decision - Split,70,0,0,70
Paul Felder,2015-09-05,Ross Pearson,Decision - Split,0,0,0,0
Joe Stevenson,2007-08-25,Kurt Pellegrino,Decision - Unanimous,80,15,0,95
Joe Stevenson,2010-12-11,Mac Danzig,KO/TKO,0,0,0,0
Joe Stevenson,2007-04-05,Melvin Guillard,Submission,90,1,0,91
Joe Stevenson,2002-06-22,Jeremy Jackson,KO/TKO,100,11,0,111
Joe Stevenson,2006-11-18,Dokonjonosuke Mishima,Submission,90,0,0,90
Joe Stevenson,2005-11-05,Luke Cummo,Decision - Unanimous,80,0,0,80
Joe Stevenson,2008-01-19,BJ Penn,Submission,0,0,25,25
Joe Stevenson,1999-10-30,Chris Brennan,Submission,0,0,0,0
Joe Stevenson,2006-04-06,Josh Neer,Decision - Unanimous,0,0,0,0
Joe Stevenson,2011-03-03,Danny Castillo,Decision - Unanimous,0,0,0,0
Joe Stevenson,2010-02-20,George Sotiropoulos,Decision - Unanimous,0,0,0,0
Joe Stevenson,2008-11-15,Kenny Florian,Submission,0,0,0,0
Joe Stevenson,2003-05-16,Thomas Denny,Submission,90,0,0,90
Joe Stevenson,2009-02-21,Diego Sanchez,Decision - Unanimous,0,0,0,0
Joe Stevenson,2004-02-20,Joe Camacho,Submission,90,45,0,135
Joe Stevenson,2008-07-05,Gleison Tibau,Submission,90,8,0,98
Joe Stevenson,2011-06-26,Javier Vazquez,Decision - Unanimous,0,0,0,0
Joe Stevenson,2006-07-08,Yves Edwards,TKO - Doctor's Stoppage,0,10,0,10
Joe Stevenson,1999-06-01,Jens Pulver,KO/TKO,0,0,0,0
Joe Stevenson,2009-10-24,Spencer Fisher,KO/TKO,100,14,0,114
Joe Stevenson,2009-06-20,Nate Diaz,Decision - Unanimous,80,21,0,101
Joe Stevenson,2002-10-19,Romie Aram,Decision - Unanimous,0,0,0,0
Kurt Pellegrino,2007-08-25,Joe Stevenson,Decision - Unanimous,0,0,0,0
Kurt Pellegrino,2010-03-27,Fabricio Camoes,Submission,90,8,0,98
Kurt Pellegrino,2011-03-19,Gleison Tibau,Decision - Split,0,3,0,3
Kurt Pellegrino,2009-08-08,Josh Neer,Decision - Unanimous,80,0,0,80
Kurt Pellegrino,2010-07-03,George Sotiropoulos,Decision - Unanimous,0,0,0,0
Kurt Pellegrino,2007-04-05,Nate Mohr,Submission,90,0,0,90
Kurt Pellegrino,2006-07-08,Drew Fickett,Submission,0,7,0,7
Kurt Pellegrino,2008-09-06,Thiago Tavares,Decision - Unanimous,80,43,0,123
Kurt Pellegrino,2006-10-14,Junior Assuncao,Submission,90,4,0,94
Kurt Pellegrino,2008-01-23,Alberto Crane,KO/TKO,100,19,0,119
Kurt Pellegrino,2009-02-07,Rob Emerson,Submission,90,0,0,90
Kurt Pellegrino,2008-04-02,Nate Diaz,Submission,0,14,0,14
Anderson Silva,2007-07-07,Nate Marquardt,KO/TKO,100,7,25,132
Anderson Silva,2009-08-08,Forrest Griffin,KO/TKO,100,10,0,110
Anderson Silva,2000-05-27,Luiz Azeredo,Decision,0,3,0,3
Anderson Silva,2017-02-11,Derek Brunson,Decision - Unanimous,80,0,0,80
Anderson Silva,2006-06-28,Chris Leben,KO/TKO,100,16,0,116
Anderson Silva,2010-08-07,Chael Sonnen,Submission,90,0,25,115
Anderson Silva,2001-08-26,Hayato Sakurai,Decision - Unanimous,80,42,0,122
Anderson Silva,2008-03-01,Dan Henderson,Submission,90,27,25,142
Anderson Silva,2019-05-11,Jared Cannonier,KO/TKO,0,0,0,0
Anderson Silva,2006-01-20,Yushin Okami,DQ,0,16,0,16
Anderson Silva,2013-07-06,Chris Weidman,KO/TKO,0,0,25,25
Anderson Silva,2004-06-27,Jeremy Horn,Decision - Unanimous,80,47,0,127
Anderson Silva,2003-06-08,Daiju Takase,Submission,0,1,0,1
Anderson Silva,2005-04-30,Jorge Rivera,KO/TKO,100,33,0,133
Anderson Silva,2011-08-27,Yushin Okami,KO/TKO,100,27,25,152
Anderson Silva,2011-02-05,Vitor Belfort,KO/TKO,100,0,25,125
Anderson Silva,2000-12-16,Claudionor Fontinelle,KO/TKO,100,35,0,135
Anderson Silva,2006-10-14,Rich Franklin,KO/TKO,100,21,25,146
Anderson Silva,2012-07-07,Chael Sonnen,KO/TKO,100,0,25,125
Anderson Silva,2002-09-29,Alexander Otsuka,Decision - Unanimous,80,0,0,80
Anderson Silva,2009-04-18,Thales Leites,Decision - Unanimous,80,84,25,189
Anderson Silva,2005-12-03,Curtis Stout,KO/TKO,100,10,0,110
Anderson Silva,2010-04-10,Demian Maia,Decision - Unanimous,80,51,25,156
Anderson Silva,2001-03-02,Tetsuji Kato,Decision - Unanimous,80,3,0,83
Anderson Silva,2012-10-13,Stephan Bonnar,KO/TKO,100,7,0,107
Anderson Silva,2008-07-19,James Irvin,KO/TKO,100,13,0,113
Anderson Silva,2019-02-09,Israel Adesanya,Decision - Unanimous,0,0,0,0
Anderson Silva,2002-06-23,Alex Stiebling,TKO - Doctor's Stoppage,0,2,0,2
Anderson Silva,2016-07-09,Daniel Cormier,Decision - Unanimous,0,0,0,0
Anderson Silva,2007-10-20,Rich Franklin,KO/TKO,100,17,25,142
Anderson Silva,2001-06-09,Israel Albuquerque,KO/TKO,100,19,0,119
Anderson Silva,2007-02-03,Travis Lutter,Submission,90,1,0,91
Anderson Silva,2000-08-12,Jose Barreto,KO/TKO,100,12,0,112
Anderson Silva,2002-01-31,Roan Carneiro,KO/TKO,100,20,0,120
Anderson Silva,2013-12-28,Chris Weidman,KO/TKO,0,0,25,25
Anderson Silva,2008-10-25,Patrick Cote,KO/TKO,100,13,25,138
Anderson Silva,2004-09-11,Lee Murray,Decision - Unanimous,80,47,0,127
Anderson Silva,2006-04-22,Tony Fryklund,KO/TKO,100,15,0,115
Anderson Silva,2003-03-16,Carlos Newton,KO/TKO,100,0,0,100
Anderson Silva,2016-02-27,Michael Bisping,Decision - Unanimous,0,0,25,25
Anderson Silva,2020-10-31,Uriah Hall,KO/TKO,0,0,25,25
Anderson Silva,2004-12-31,Ryo Chonan,Submission,0,1,0,1
Luana Carolina,2018-08-12,Mabelly Lima,Decision - Unanimous,80,39,0,119
Luana Carolina,2023-07-01,Ivana Petrovic,Decision - Unanimous,80,19,0,99
Luana Carolina,2020-07-18,Ariane da Silva,Submission,0,0,0,0
Luana Carolina,2024-07-20,Lucie Pudilova,Decision - Unanimous,80,51,0,131
Luana Carolina,2024-02-03,Julija Stoliarenko,KO/TKO,100,50,0,150
Luana Carolina,2021-10-16,Loopy Godinez,Decision - Unanimous,80,30,0,110
Luana Carolina,2023-03-18,Joanne Wood,Decision - Split,0,0,0,0
Luana Carolina,2019-05-11,Priscila Cachoeira,Decision - Unanimous,80,42,0,122
Luana Carolina,2022-03-19,Molly McCann,KO/TKO,0,0,0,0
Luana Carolina,2021-05-01,Poliana Botelho,Decision - Split,70,0,0,70
Mabelly Lima,2018-08-12,Luana Carolina,Decision - Unanimous,0,0,0,0
Murad Chunkaiev,2005-10-23,Murilo Rua,Submission,0,0,0,0
Vicente Luque,2021-08-07,Michael Chiesa,Submission,90,3,0,93
Vicente Luque,2023-08-12,Rafael Dos Anjos,Decision - Unanimous,80,6,25,111
Vicente Luque,2015-12-19,Hayder Hassan,Submission,90,0,0,90
Vicente Luque,2024-03-30,Joaquin Buckley,KO/TKO,0,0,0,0
Vicente Luque,2016-07-07,Alvaro Herrera Mendoza,Submission,90,13,0,103
Vicente Luque,2022-08-06,Geoff Neal,KO/TKO,0,0,0,0
Vicente Luque,2017-03-18,Leon Edwards,Decision - Unanimous,0,0,0,0
Vicente Luque,2019-08-10,Mike Perry,Decision - Split,70,0,0,70
Vicente Luque,2022-04-16,Belal Muhammad,Decision - Unanimous,0,24,25,49
Vicente Luque,2016-09-24,Hector Urbina,KO/TKO,100,6,0,106
Vicente Luque,2024-12-07,Themba Gorimbo,Submission,90,0,0,90
Vicente Luque,2018-10-06,Jalin Turner,KO/TKO,100,10,0,110
Vicente Luque,2017-10-28,Niko Price,Submission,90,36,0,126
Vicente Luque,2018-05-19,Chad Laprise,KO/TKO,100,1,0,101
Vicente Luque,2015-07-12,Michael Graves,Decision - Unanimous,0,1,0,1
Vicente Luque,2020-05-09,Niko Price,TKO - Doctor's Stoppage,0,1,0,1
Vicente Luque,2021-03-27,Tyron Woodley,Submission,90,7,0,97
Vicente Luque,2020-08-01,Randy Brown,KO/TKO,100,3,0,103
Vicente Luque,2019-11-02,Stephen Thompson,Decision - Unanimous,0,0,0,0
Vicente Luque,2019-02-17,Bryan Barberena,KO/TKO,100,0,0,100
Vicente Luque,2016-11-12,Belal Muhammad,KO/TKO,100,6,0,106
Vicente Luque,2019-05-18,Derrick Krantz,KO/TKO,100,12,0,112
Sean O'Malley,2018-03-03,Andre Soukhamthath,Decision - Unanimous,80,38,0,118
Sean O'Malley,2023-08-19,Aljamain Sterling,KO/TKO,100,8,25,133
Sean O'Malley,2021-07-10,Kris Moutinho,KO/TKO,100,160,0,260
Sean O'Malley,2020-03-07,Jose Quinonez,KO/TKO,100,18,0,118
Sean O'Malley,2017-12-01,Terrion Ware,Decision - Unanimous,80,53,0,133
Sean O'Malley,2021-12-11,Raulian Paiva,KO/TKO,100,28,0,128
Sean O'Malley,2024-03-09,Marlon Vera,Decision - Unanimous,80,141,25,246
Sean O'Malley,2020-08-15,Marlon Vera,KO/TKO,0,0,0,0
Sean O'Malley,2022-10-22,Petr Yan,Decision - Split,70,26,0,96
Sean O'Malley,2020-06-06,Eddie Wineland,KO/TKO,100,9,0,109
Sean O'Malley,2024-09-14,Merab Dvalishvili,Decision - Unanimous,0,0,25,25
Sean O'Malley,2017-07-18,Alfred Khashakyan,KO/TKO,100,1,0,101
Sean O'Malley,2021-03-27,Thomas Almeida,KO/TKO,100,61,0,161
David Onama,2022-08-13,Nate Landwehr,Decision - Majority,0,0,0,0
David Onama,2021-10-23,Mason Jones,Decision - Unanimous,0,3,0,3
David Onama,2024-11-16,Roberto Romero,Decision - Unanimous,80,47,0,127
David Onama,2022-07-09,Garrett Armfield,Submission,90,8,0,98
David Onama,2024-04-27,Jonathan Pearce,Decision - Unanimous,80,1,0,81
David Onama,2023-06-24,Gabriel Santos,KO/TKO,100,14,0,114
David Onama,2022-02-19,Gabriel Benitez,KO/TKO,100,0,0,100
Benoit Saint Denis,2021-10-30,Elizeu Zaleski dos Santos,Decision - Unanimous,0,0,0,0
Benoit Saint Denis,2022-06-04,Niklas Stolze,Submission,90,0,0,90
Benoit Saint Denis,2023-09-02,Thiago Moises,KO/TKO,100,77,0,177
Benoit Saint Denis,2023-07-01,Ismael Bonfim,Submission,90,0,0,90
Benoit Saint Denis,2023-11-11,Matt Frevola,KO/TKO,100,1,0,101
Benoit Saint Denis,2024-09-28,Renato Moicano,TKO - Doctor's Stoppage,0,0,25,25
Benoit Saint Denis,2024-03-09,Dustin Poirier,KO/TKO,0,22,25,47
Benoit Saint Denis,2022-09-03,Gabriel Miranda,KO/TKO,100,22,0,122
Maheshate,2022-12-17,Rafa Garcia,Decision - Unanimous,0,0,0,0
Maheshate,2021-11-02,Achilles Estremadura,Decision - Unanimous,80,1,0,81
Maheshate,2024-11-23,Nikolas Motta,Decision - Unanimous,0,0,0,0
Maheshate,2022-06-11,Steve Garcia,KO/TKO,100,0,0,100
Maheshate,2023-05-20,Viacheslav Borshchev,KO/TKO,0,0,0,0
Maheshate,2024-04-27,Gabriel Benitez,Decision - Split,70,0,0,70
Alexander Otsuka,2003-03-16,Kenichi Yamamoto,Decision - Unanimous,80,9,0,89
Alexander Otsuka,2000-05-01,Ken Shamrock,KO/TKO,0,0,0,0
Alexander Otsuka,2002-12-23,Yoshihisa Yamamoto,KO/TKO,0,18,0,18
Alexander Otsuka,2000-01-30,Igor Vovchanchyn,Decision - Unanimous,0,0,0,0
Alexander Otsuka,2000-12-09,Guy Mezger,KO/TKO,0,0,0,0
Alexander Otsuka,2002-09-29,Anderson Silva,Decision - Unanimous,0,4,0,4
Alexander Otsuka,2004-02-01,Murilo Rua,Submission,0,0,0,0
Alexander Otsuka,2000-10-31,Mike Bourke,Submission,90,3,0,93
Alexander Otsuka,2002-04-28,Sanae Kikuta,Decision - Unanimous,0,0,0,0
Alexander Otsuka,1999-11-21,Renzo Gracie,Decision - Unanimous,0,0,0,0
Alexander Otsuka,1998-10-11,Marco Ruas,KO/TKO,100,6,0,106
Alexander Otsuka,2001-12-23,Wanderlei Silva,TKO - Doctor's Stoppage,0,0,0,0
Kenichi Yamamoto,2003-03-16,Alexander Otsuka,Decision - Unanimous,0,0,0,0
Kenichi Yamamoto,1999-11-19,Daiju Takase,Decision - Unanimous,80,15,0,95
Kenichi Yamamoto,1999-11-19,Katsuhisa Fujii,Submission,90,0,0,90
Kenichi Yamamoto,2000-12-16,Pat Miletich,Submission,0,0,25,25
Kenichi Yamamoto,2002-11-24,Kevin Randleman,KO/TKO,0,0,0,0
Kenichi Yamamoto,2004-07-19,Ikuhisa Minowa,KO/TKO,0,0,0,0
Matt Lindland,2001-05-04,Ricardo Almeida,DQ,0,13,0,13
Matt Lindland,2006-07-22,Quinton Jackson,Decision - Split,0,0,0,0
Matt Lindland,2002-09-27,Ivan Salaverry,Decision - Unanimous,80,0,0,80
Matt Lindland,2001-11-02,Phil Baroni,Decision - Majority,75,39,0,114
Matt Lindland,2009-12-19,Jacare Souza,Submission,0,0,0,0
Matt Lindland,2000-12-16,Yoji Anjo,KO/TKO,100,17,0,117
Matt Lindland,2005-08-20,Joe Doerksen,Decision - Unanimous,80,11,0,91
Matt Lindland,2003-11-21,Falaniko Vitale,KO/TKO,100,32,0,132
Matt Lindland,2009-01-24,Vitor Belfort,KO/TKO,0,0,0,0
Matt Lindland,2003-02-28,Phil Baroni,Decision - Unanimous,80,0,0,80
Matt Lindland,2004-08-21,David Terrell,KO/TKO,0,0,0,0
Matt Lindland,2007-04-14,Fedor Emelianenko,Submission,0,3,0,3
Matt Lindland,2010-12-04,Robbie Lawler,KO/TKO,0,0,0,0
Matt Lindland,2003-06-06,Falaniko Vitale,KO/TKO,0,0,0,0
Matt Lindland,2002-03-22,Pat Miletich,KO/TKO,100,19,0,119
Matt Lindland,2005-04-16,Travis Lutter,Submission,90,11,0,101
Matt Lindland,2008-07-19,Fabio Nascimento,Decision - Unanimous,80,28,0,108
Matt Lindland,2002-05-10,Murilo Bustamante,Submission,0,18,25,43
Matt Lindland,2010-05-21,Kevin Casey,KO/TKO,100,47,0,147
Brian Foster,2009-11-21,Brock Larson,KO/TKO,100,22,0,122
Brian Foster,2010-09-15,Forrest Petz,KO/TKO,100,16,0,116
Brian Foster,2009-09-19,Rick Story,Submission,0,0,0,0
Brian Foster,2010-02-20,Chris Lytle,Submission,0,3,0,3
Brian Foster,2010-11-20,Matt Brown,Submission,90,12,0,102
Brock Larson,2009-11-21,Brian Foster,KO/TKO,0,0,0,0
Brock Larson,2007-03-24,Erik Apple,Submission,90,2,0,92
Brock Larson,2009-05-23,Mike Pyle,Submission,90,3,0,93
Brock Larson,2006-12-13,Keita Nakamura,Decision - Unanimous,80,6,0,86
Brock Larson,2008-08-03,Carlo Prater,KO/TKO,100,8,0,108
Brock Larson,2008-03-26,John Alessio,DQ,0,5,0,5
Brock Larson,2005-10-03,Jon Fitch,Decision - Unanimous,0,0,0,0
Brock Larson,2009-04-01,Jesse Sanders,Submission,90,13,0,103
Brock Larson,2007-08-05,Carlos Condit,Submission,0,0,25,25
Brock Larson,2007-06-03,Kevin Knabjian,KO/TKO,100,7,0,107
Brock Larson,2009-09-16,Mike Pierce,Decision - Unanimous,0,0,0,0
Lorenz Larkin,2013-11-06,Chris Camozzi,Decision - Unanimous,80,0,0,80
Lorenz Larkin,2016-08-20,Neil Magny,KO/TKO,100,24,0,124
Lorenz Larkin,2011-06-24,Gian Villante,Decision - Unanimous,80,42,0,122
Lorenz Larkin,2014-08-30,Derek Brunson,Decision - Unanimous,0,8,0,8
Lorenz Larkin,2012-07-14,Robbie Lawler,Decision - Unanimous,80,26,0,106
Lorenz Larkin,2011-04-01,Scott Lighty,KO/TKO,100,11,0,111
Lorenz Larkin,2015-01-18,John Howard,KO/TKO,100,19,0,119
Lorenz Larkin,2016-05-29,Jorge Masvidal,Decision - Split,70,0,0,70
Lorenz Larkin,2014-01-15,Brad Tavares,Decision - Unanimous,0,0,0,0
Lorenz Larkin,2015-06-27,Santiago Ponzinibbio,KO/TKO,100,31,0,131
Lorenz Larkin,2011-09-23,Nick Rossborough,Decision - Unanimous,80,23,0,103
Lorenz Larkin,2013-04-20,Francis Carmont,Decision - Unanimous,0,20,0,20
Lorenz Larkin,2014-05-10,Constantinos Philippou,KO/TKO,0,1,0,1
Lorenz Larkin,2016-01-02,Albert Tumenov,Decision - Split,0,0,0,0
Ryan LaFlare,2018-04-21,Alex Garcia,Decision - Unanimous,80,13,0,93
Ryan LaFlare,2017-07-22,Alex Oliveira,KO/TKO,0,0,0,0
Ryan LaFlare,2013-12-14,Court McGee,Decision - Unanimous,80,14,0,94
Ryan LaFlare,2015-03-21,Demian Maia,Decision - Unanimous,0,0,25,25
Ryan LaFlare,2014-04-11,John Howard,Decision - Unanimous,80,29,0,109
Ryan LaFlare,2013-04-06,Ben Alloway,Decision - Unanimous,80,28,0,108
Ryan LaFlare,2018-10-06,Anthony Rocco Martin,KO/TKO,0,0,0,0
Ryan LaFlare,2015-12-11,Mike Pierce,Decision - Unanimous,80,23,0,103
Ryan LaFlare,2013-11-09,Santiago Ponzinibbio,Decision - Unanimous,80,50,0,130
Ryan LaFlare,2017-02-11,Roan Carneiro,Decision - Unanimous,80,10,0,90
Alex Garcia,2018-04-21,Ryan LaFlare,Decision - Unanimous,0,0,0,0
Alex Garcia,2017-06-25,Tim Means,Decision - Unanimous,0,0,0,0
Alex Garcia,2014-03-15,Sean Spencer,Decision - Split,70,3,0,73
Alex Garcia,2017-11-25,Muslim Salikhov,Submission,90,0,0,90
Alex Garcia,2014-08-23,Neil Magny,Decision - Unanimous,0,0,0,0
Alex Garcia,2018-10-27,Court McGee,Decision - Unanimous,0,0,0,0
Alex Garcia,2015-07-11,Mike Swick,Decision - Unanimous,80,5,0,85
Alex Garcia,2016-02-21,Sean Strickland,KO/TKO,0,0,0,0
Alex Garcia,2016-12-30,Mike Pyle,KO/TKO,100,9,0,109
Alex Garcia,2013-12-06,Ben Wall,KO/TKO,100,8,0,108
Matt Serra,2002-03-22,Kelly Dullanty,Submission,90,2,0,92
Matt Serra,2005-06-04,Karo Parisyan,Decision - Unanimous,0,0,0,0
Matt Serra,2009-05-23,Matt Hughes,Decision - Unanimous,0,0,0,0
Matt Serra,2002-09-27,BJ Penn,Decision - Unanimous,0,0,0,0
Matt Serra,2007-04-07,Georges St-Pierre,KO/TKO,100,14,25,139
Matt Serra,2006-11-11,Chris Lytle,Decision - Split,70,0,0,70
Matt Serra,2003-02-28,Din Thomas,Decision - Split,0,0,0,0
Matt Serra,2008-04-19,Georges St-Pierre,KO/TKO,0,0,25,25
Matt Serra,2004-01-31,Jeff Curran,Decision - Unanimous,80,36,0,116
Matt Serra,2010-09-25,Chris Lytle,Decision - Unanimous,0,0,0,0
Matt Serra,2004-06-19,Ivan Menjivar,Decision - Unanimous,80,6,0,86
Matt Serra,2001-09-28,Yves Edwards,Decision - Majority,75,0,0,75
Matt Serra,2010-02-06,Frank Trigg,KO/TKO,100,6,0,106
Matt Serra,2001-05-04,Shonie Carter,KO/TKO,0,0,0,0
Kelly Dullanty,2002-03-22,Matt Serra,Submission,0,0,0,0
Juan Andres Luna,2022-07-26,Alessandro Costa,Decision - Split,0,4,0,4
Tamdan McCrory,2009-08-08,John Howard,Decision - Split,0,0,0,0
Tamdan McCrory,2007-11-17,Akihiro Gono,Submission,0,4,0,4
Tamdan McCrory,2008-08-09,Luke Cummo,Decision - Unanimous,80,15,0,95
Tamdan McCrory,2008-11-15,Dustin Hazelett,Submission,0,5,0,5
Tamdan McCrory,2016-10-01,Nate Marquardt,KO/TKO,0,0,0,0
Tamdan McCrory,2015-12-19,Josh Samman,Submission,90,29,0,119
Tamdan McCrory,2016-06-18,Krzysztof Jotko,KO/TKO,0,0,0,0
Tamdan McCrory,2009-03-07,Ryan Madigan,KO/TKO,100,12,0,112
Tamdan McCrory,2007-06-12,Pete Spratt,Submission,90,0,0,90
Bea Malecki,2020-03-14,Veronica Hardy,Decision - Unanimous,80,37,0,117
Bea Malecki,2019-06-01,Duda Santana,Submission,90,0,0,90
Bea Malecki,2021-08-21,Josiane Nunes,KO/TKO,0,0,0,0
Veronica Hardy,2020-03-14,Bea Malecki,Decision - Unanimous,0,0,0,0
Veronica Hardy,2023-12-02,Jamey-Lyn Horth,Decision - Split,70,0,0,70
Veronica Hardy,2024-05-11,JJ Aldrich,Decision - Unanimous,80,9,0,89
Veronica Hardy,2016-09-03,Ashlee Evans-Smith,KO/TKO,0,0,0,0
Veronica Hardy,2018-05-19,Andrea Lee,Decision - Unanimous,0,0,0,0
Veronica Hardy,2023-03-18,Juliana Miller,Decision - Unanimous,80,32,0,112
Veronica Hardy,2019-02-23,Gillian Robertson,Submission,0,18,0,18
Veronica Hardy,2019-08-10,Polyana Viana,Submission,90,0,0,90
Veronica Hardy,2024-11-16,Eduarda Moura,Decision - Unanimous,0,20,0,20
Remco Pardoel,1995-09-08,Ryan Parker,Submission,90,0,0,90
Remco Pardoel,1994-03-11,Orlando Wiet,KO/TKO,100,6,0,106
Remco Pardoel,1994-03-11,Royce Gracie,Submission,0,0,0,0
Remco Pardoel,1995-09-08,Marco Ruas,Submission,0,0,0,0
Remco Pardoel,1994-03-11,Alberta Cerra Leon,Submission,90,3,0,93
Ryan Parker,1995-09-08,Remco Pardoel,Submission,0,0,0,0
Yazmin Jauregui,2023-07-08,Denise Gomes,KO/TKO,0,0,0,0
Yazmin Jauregui,2024-09-14,Ketlen Souza,Submission,0,14,0,14
Yazmin Jauregui,2022-08-13,Iasmin Lucindo,Decision - Unanimous,80,20,0,100
Yazmin Jauregui,2024-02-24,Sam Hughes,Decision - Unanimous,80,11,0,91
Yazmin Jauregui,2022-12-03,Istela Nunes,KO/TKO,100,31,0,131
Roy Nelson,2014-09-20,Mark Hunt,KO/TKO,0,0,25,25
Roy Nelson,2013-10-19,Daniel Cormier,Decision - Unanimous,0,0,0,0
Roy Nelson,2009-12-05,Brendan Schaub,KO/TKO,100,0,0,100
Roy Nelson,2011-05-28,Frank Mir,Decision - Unanimous,0,0,0,0
Roy Nelson,2017-04-15,Alexander Volkov,Decision - Unanimous,0,0,0,0
Roy Nelson,2013-06-15,Stipe Miocic,Decision - Unanimous,0,0,0,0
Roy Nelson,2016-02-06,Jared Rosholt,Decision - Unanimous,80,6,0,86
Roy Nelson,2016-07-07,Derrick Lewis,Decision - Split,0,0,0,0
Roy Nelson,2007-04-07,Ben Rothwell,Decision - Split,0,0,0,0
Roy Nelson,2011-10-29,Mirko Filipovic,KO/TKO,100,2,0,102
Roy Nelson,2015-03-14,Alistair Overeem,Decision - Unanimous,0,0,0,0
Roy Nelson,2012-02-04,Fabricio Werdum,Decision - Unanimous,0,0,0,0
Roy Nelson,2016-09-24,Antonio Silva,KO/TKO,100,9,0,109
Roy Nelson,2012-12-15,Matt Mitrione,KO/TKO,100,10,25,135
Roy Nelson,2015-09-26,Josh Barnett,Decision - Unanimous,0,0,25,25
Roy Nelson,2010-08-07,Junior Dos Santos,Decision - Unanimous,0,0,0,0
Roy Nelson,2014-04-11,Antonio Rodrigo Nogueira,KO/TKO,100,7,25,132
Roy Nelson,2008-10-04,Andrei Arlovski,KO/TKO,0,0,0,0
Roy Nelson,2010-03-31,Stefan Struve,KO/TKO,100,7,0,107
Roy Nelson,2013-04-27,Cheick Kongo,KO/TKO,100,0,0,100
Roy Nelson,2012-05-26,Dave Herman,KO/TKO,100,0,0,100
Alexander Hernandez,2018-07-28,Olivier Aubin-Mercier,Decision - Unanimous,80,20,0,100
Alexander Hernandez,2024-10-05,Austin Hubbard,Decision - Split,70,16,0,86
Alexander Hernandez,2019-07-20,Francisco Trinaldo,Decision - Unanimous,80,0,0,80
Alexander Hernandez,2023-10-07,Bill Algeo,Decision - Unanimous,0,0,0,0
Alexander Hernandez,2022-12-10,Billy Quarantillo,KO/TKO,0,0,0,0
Alexander Hernandez,2021-10-02,Mike Breeden,KO/TKO,100,14,0,114
Alexander Hernandez,2018-03-03,Beneil Dariush,KO/TKO,100,4,0,104
Alexander Hernandez,2024-04-06,Damon Jackson,Decision - Split,0,0,0,0
Alexander Hernandez,2020-10-31,Chris Gruetzemacher,KO/TKO,100,21,0,121
Alexander Hernandez,2023-02-18,Jim Miller,Decision - Unanimous,80,41,0,121
Alexander Hernandez,2020-05-13,Drew Dober,KO/TKO,0,0,0,0
Alexander Hernandez,2021-02-27,Thiago Moises,Decision - Unanimous,0,0,0,0
Alexander Hernandez,2019-01-19,Donald Cerrone,KO/TKO,0,0,0,0
Alexander Hernandez,2022-02-12,Renato Moicano,Submission,0,4,0,4
Olivier Aubin-Mercier,2018-07-28,Alexander Hernandez,Decision - Unanimous,0,0,0,0
Olivier Aubin-Mercier,2016-06-18,Thibault Gouti,Submission,90,15,0,105
Olivier Aubin-Mercier,2016-01-30,Diego Ferreira,Decision - Unanimous,0,0,0,0
Olivier Aubin-Mercier,2015-08-23,Tony Sims,Decision - Unanimous,80,0,0,80
Olivier Aubin-Mercier,2018-04-07,Evan Dunham,KO/TKO,100,9,0,109
Olivier Aubin-Mercier,2019-07-27,Arman Tsarukyan,Decision - Unanimous,0,0,0,0
Olivier Aubin-Mercier,2017-09-16,Anthony Rocco Martin,Decision - Split,70,5,0,75
Olivier Aubin-Mercier,2014-10-04,Jake Lindsey,Submission,90,7,0,97
Olivier Aubin-Mercier,2018-12-08,Gilbert Burns,Decision - Unanimous,0,0,0,0
Olivier Aubin-Mercier,2014-04-16,Chad Laprise,Decision - Split,0,0,0,0
Olivier Aubin-Mercier,2015-04-25,David Michaud,Submission,90,32,0,122
Olivier Aubin-Mercier,2016-12-10,Drew Dober,Submission,90,3,0,93
Wagnney Fabiano,2009-04-05,Fredson Paixao,Decision - Unanimous,80,32,0,112
Wagnney Fabiano,2010-06-20,Frank Gomez,Decision - Unanimous,80,6,0,86
Wagnney Fabiano,2010-01-10,Clint Godfrey,Decision - Unanimous,80,3,0,83
Wagnney Fabiano,2010-11-11,Joseph Benavidez,Submission,0,0,0,0
Wagnney Fabiano,2008-12-03,Akitoshi Tamura,Submission,90,7,0,97
Wagnney Fabiano,2009-10-10,Mackens Semerzier,Submission,0,0,0,0
Danny Barlow,2024-02-17,Josh Quinlan,KO/TKO,100,56,0,156
Danny Barlow,2023-09-26,Raheam Forest,KO/TKO,100,9,0,109
Danny Barlow,2024-08-10,Nikolay Veretennikov,Decision - Split,70,0,0,70
Josh Quinlan,2024-02-17,Danny Barlow,KO/TKO,0,0,0,0
Josh Quinlan,2023-04-29,Trey Waters,Decision - Unanimous,0,0,0,0
Josh Quinlan,2024-06-15,Adam Fugitt,Decision - Split,0,0,0,0
Josh Quinlan,2022-08-13,Jason Witt,KO/TKO,100,2,0,102
Travis Browne,2013-08-17,Alistair Overeem,KO/TKO,100,0,0,100
Travis Browne,2017-02-19,Derrick Lewis,KO/TKO,0,0,25,25
Travis Browne,2010-06-19,James McSweeney,KO/TKO,100,13,0,113
Travis Browne,2014-04-19,Fabricio Werdum,Decision - Unanimous,0,0,25,25
Travis Browne,2012-04-21,Chad Griggs,Submission,90,4,0,94
Travis Browne,2013-12-28,Josh Barnett,KO/TKO,100,7,0,107
Travis Browne,2011-09-24,Rob Broughton,Decision - Unanimous,80,23,0,103
Travis Browne,2014-12-06,Brendan Schaub,KO/TKO,100,20,0,120
Travis Browne,2016-01-17,Matt Mitrione,KO/TKO,100,24,0,124
Travis Browne,2011-05-28,Stefan Struve,KO/TKO,100,7,0,107
Travis Browne,2015-05-23,Andrei Arlovski,KO/TKO,0,0,0,0
Travis Browne,2013-04-13,Gabriel Gonzaga,KO/TKO,100,8,0,108
Travis Browne,2016-09-10,Fabricio Werdum,Decision - Unanimous,0,0,0,0
Travis Browne,2016-07-09,Cain Velasquez,KO/TKO,0,0,0,0
Travis Browne,2012-10-05,Antonio Silva,KO/TKO,0,0,25,25
Travis Browne,2017-07-08,Aleksei Oleinik,Submission,0,0,0,0
Teemu Packalen,2017-03-18,Marc Diakiese,KO/TKO,0,0,0,0
Teemu Packalen,2015-07-18,Mickael Lebout,Decision - Unanimous,0,0,0,0
Teemu Packalen,2016-02-27,Thibault Gouti,Submission,90,6,0,96
Teemu Packalen,2019-09-07,Ottman Azaitar,KO/TKO,0,0,0,0
Jimy Hettes,2011-12-30,Nam Phan,Decision - Unanimous,80,65,0,145
Jimy Hettes,2013-10-26,Robert Whiteford,Submission,90,0,0,90
Jimy Hettes,2014-03-15,Dennis Bermudez,KO/TKO,0,0,0,0
Jimy Hettes,2015-04-18,Diego Brandao,TKO - Doctor's Stoppage,0,0,0,0
Jimy Hettes,2011-08-14,Alex Caceres,Submission,90,0,0,90
Jimy Hettes,2012-09-22,Marcus Brimage,Decision - Unanimous,0,0,0,0
Nam Phan,2011-12-30,Jimy Hettes,Decision - Unanimous,0,0,0,0
Nam Phan,2008-06-27,Billy Evangelista,Decision - Split,0,2,0,2
Nam Phan,2012-08-04,Cole Miller,Decision - Split,70,0,0,70
Nam Phan,2013-12-06,Takeya Mizugaki,Decision - Unanimous,0,0,0,0
Nam Phan,2011-08-06,Mike Brown,Decision - Unanimous,0,0,0,0
Nam Phan,2011-10-08,Leonard Garcia,Decision - Unanimous,80,74,0,154
Nam Phan,2010-12-04,Leonard Garcia,Decision - Split,0,38,0,38
Nam Phan,2012-12-08,Dennis Siver,Decision - Unanimous,0,0,0,0
Nam Phan,2014-03-01,Vaughan Lee,Decision - Unanimous,0,0,0,0
Nam Phan,2004-08-20,Nick Ertl,Decision - Split,0,6,0,6
Nam Phan,2006-12-08,Josh Thomson,Decision - Unanimous,0,0,0,0
Chris Duncan,2024-09-28,Bolaji Oki,Submission,90,0,0,90
Chris Duncan,2023-03-18,Omar Morales,Decision - Split,70,6,0,76
Chris Duncan,2023-07-22,Yanal Ashmouz,Decision - Unanimous,80,50,0,130
Chris Duncan,2022-08-02,Charlie Campbell,KO/TKO,100,0,0,100
Chris Duncan,2024-02-24,Manuel Torres,Submission,0,0,0,0
Chris Duncan,2021-10-12,Viacheslav Borshchev,KO/TKO,0,0,0,0
Bolaji Oki,2024-09-28,Chris Duncan,Submission,0,18,0,18
Bolaji Oki,2024-02-10,Timmy Cuamba,Decision - Split,70,27,0,97
Bolaji Oki,2023-08-29,Dylan Salvador,KO/TKO,100,20,0,120
Conor McGregor,2020-01-18,Donald Cerrone,KO/TKO,100,19,25,144
Conor McGregor,2015-12-12,Jose Aldo,KO/TKO,100,4,25,129
Conor McGregor,2021-07-10,Dustin Poirier,TKO - Doctor's Stoppage,0,0,25,25
Conor McGregor,2015-07-11,Chad Mendes,KO/TKO,100,15,25,140
Conor McGregor,2014-09-27,Dustin Poirier,KO/TKO,100,0,0,100
Conor McGregor,2016-08-20,Nate Diaz,Decision - Majority,75,0,25,100
Conor McGregor,2013-08-17,Max Holloway,Decision - Unanimous,80,30,0,110
Conor McGregor,2016-03-05,Nate Diaz,Submission,0,0,25,25
Conor McGregor,2018-10-06,Khabib Nurmagomedov,Submission,0,0,25,25
Conor McGregor,2015-01-18,Dennis Siver,KO/TKO,100,32,25,157
Conor McGregor,2021-01-23,Dustin Poirier,KO/TKO,0,0,25,25
Conor McGregor,2013-04-06,Marcus Brimage,KO/TKO,100,9,0,109
Conor McGregor,2014-07-19,Diego Brandao,KO/TKO,100,9,25,134
Conor McGregor,2016-11-12,Eddie Alvarez,KO/TKO,100,23,25,148
Ludovit Klein,2020-09-26,Shane Young,KO/TKO,100,5,0,105
Ludovit Klein,2024-09-28,Roosevelt Roberts,Decision - Unanimous,80,21,0,101
Ludovit Klein,2022-07-23,Mason Jones,Decision - Unanimous,80,7,0,87
Ludovit Klein,2021-10-16,Nate Landwehr,Submission,0,0,0,0
Ludovit Klein,2023-08-05,Ignacio Bahamondes,Decision - Unanimous,80,13,0,93
Ludovit Klein,2021-05-08,Michael Trizano,Decision - Unanimous,0,0,0,0
Ludovit Klein,2024-03-02,AJ Cunningham,KO/TKO,100,24,0,124
Ludovit Klein,2022-03-05,Devonte Smith,Decision - Split,70,7,0,77
Ludovit Klein,2024-06-08,Thiago Moises,Decision - Unanimous,80,32,0,112
Shane Young,2020-09-26,Ludovit Klein,KO/TKO,0,0,0,0
Shane Young,2018-06-23,Rolando Dy,KO/TKO,100,47,0,147
Shane Young,2023-09-09,Gabriel Miranda,Submission,0,0,0,0
Shane Young,2023-02-11,Blake Bilder,Decision - Unanimous,0,0,0,0
Shane Young,2019-02-09,Austin Arnett,Decision - Unanimous,80,43,0,123
Shane Young,2021-03-27,Omar Morales,Decision - Unanimous,0,0,0,0
Shane Young,2017-11-18,Alexander Volkanovski,Decision - Unanimous,0,0,0,0
Tiki Ghosn,2004-04-02,Chris Lytle,Submission,0,0,0,0
Tiki Ghosn,2006-03-17,Pat Healy,TKO - Doctor's Stoppage,0,19,0,19
Tiki Ghosn,2007-08-05,Blas Avena,Submission,0,0,0,0
Tiki Ghosn,2001-02-23,Sean Sherk,Submission,0,0,0,0
Tiki Ghosn,2007-03-24,Dave Terrel,KO/TKO,0,0,0,0
Tiki Ghosn,2002-11-22,Robbie Lawler,KO/TKO,0,2,0,2
Tiki Ghosn,2000-03-10,Bob Cook,Submission,0,2,0,2
Aleksei Oleinik,2018-09-15,Mark Hunt,Submission,90,0,25,115
Aleksei Oleinik,2022-10-01,Ilir Latifi,Decision - Unanimous,0,0,0,0
Aleksei Oleinik,2020-08-08,Derrick Lewis,KO/TKO,0,0,25,25
Aleksei Oleinik,2021-02-20,Chris Daukaus,KO/TKO,0,0,0,0
Aleksei Oleinik,2017-11-04,Curtis Blaydes,TKO - Doctor's Stoppage,0,0,0,0
Aleksei Oleinik,2020-01-18,Maurice Greene,Submission,90,0,0,90
Aleksei Oleinik,2021-06-19,Serghei Spivac,Decision - Unanimous,0,0,0,0
Aleksei Oleinik,2014-06-28,Anthony Hamilton,Submission,90,4,0,94
Aleksei Oleinik,2020-05-09,Fabricio Werdum,Decision - Split,70,41,0,111
Aleksei Oleinik,2019-04-20,Alistair Overeem,KO/TKO,0,9,25,34
Aleksei Oleinik,2018-05-12,Junior Albini,Submission,90,0,0,90
Aleksei Oleinik,2014-11-22,Jared Rosholt,KO/TKO,100,0,0,100
Aleksei Oleinik,2022-04-09,Jared Vanderaa,Submission,90,0,0,90
Aleksei Oleinik,2017-01-15,Viktor Pesta,Submission,90,0,0,90
Aleksei Oleinik,2019-07-20,Walt Harris,KO/TKO,0,0,0,0
Aleksei Oleinik,2016-07-13,Daniel Omielanczuk,Decision - Majority,0,0,0,0
Aleksei Oleinik,2017-07-08,Travis Browne,Submission,90,18,0,108
Jeremy Horn,1999-09-24,Jason Godsey,Submission,90,2,0,92
Jeremy Horn,2009-01-17,Rousimar Palhares,Decision - Unanimous,0,0,0,0
Jeremy Horn,2006-05-27,Chael Sonnen,Submission,90,0,0,90
Jeremy Horn,1998-10-16,Ebenezer Fontes Braga,Submission,0,0,0,0
Jeremy Horn,1999-03-05,Chuck Liddell,Submission,90,0,0,90
Jeremy Horn,2002-06-23,Gilbert Yvel,Decision - Unanimous,80,0,0,80
Jeremy Horn,2004-06-27,Anderson Silva,Decision - Unanimous,0,0,0,0
Jeremy Horn,2008-02-02,Nate Marquardt,Submission,0,0,0,0
Jeremy Horn,2003-09-06,Forrest Griffin,KO/TKO,100,10,0,110
Jeremy Horn,2005-11-19,Trevor Prangley,Decision - Unanimous,80,0,0,80
Jeremy Horn,2005-08-20,Chuck Liddell,KO/TKO,0,0,25,25
Jeremy Horn,2008-06-21,Dean Lister,Submission,0,0,0,0
Jeremy Horn,2001-02-23,Elvis Sinosic,Submission,0,2,0,2
Jeremy Horn,2000-09-22,Eugene Jackson,Submission,90,0,0,90
Jeremy Horn,1999-07-16,Daiju Takase,KO/TKO,100,35,0,135
Jeremy Horn,1998-05-15,Frank Shamrock,Submission,0,0,0,0
Jeremy Horn,2001-12-23,Akira Shoji,Decision - Unanimous,80,4,0,84
Jason Godsey,1999-09-24,Jeremy Horn,Submission,0,0,0,0
Jason Godsey,1999-03-05,Pete Williams,Submission,0,0,0,0
Andre Winner,2010-03-31,Rafaello Oliveira,Decision - Unanimous,80,9,0,89
Andre Winner,2011-07-02,Anthony Njokuani,Decision - Unanimous,0,0,0,0
Andre Winner,2009-11-14,Rolando Delgado,KO/TKO,100,3,0,103
Andre Winner,2010-11-13,Dennis Siver,Submission,0,0,0,0
Andre Winner,2010-08-28,Nik Lentz,Decision - Unanimous,0,0,0,0
Andre Winner,2009-06-20,Ross Pearson,Decision - Unanimous,0,0,0,0
Rafaello Oliveira,2010-03-31,Andre Winner,Decision - Unanimous,0,0,0,0
Rafaello Oliveira,2014-02-22,Erik Koch,KO/TKO,0,0,0,0
Rafaello Oliveira,2009-09-19,Nik Lentz,Decision - Unanimous,0,0,0,0
Rafaello Oliveira,2012-07-07,Yoislandy Izquierdo,Decision - Unanimous,80,2,0,82
Rafaello Oliveira,2011-10-01,Yves Edwards,KO/TKO,0,0,0,0
Rafaello Oliveira,2011-05-28,Gleison Tibau,Submission,0,0,0,0
Rafaello Oliveira,2010-01-02,John Gunderson,Decision - Unanimous,80,20,0,100
Rafaello Oliveira,2013-07-06,Edson Barboza,KO/TKO,0,0,0,0
Josh Barnett,2006-12-31,Antonio Rodrigo Nogueira,Decision - Unanimous,0,0,0,0
Josh Barnett,2000-11-17,Gan McGee,KO/TKO,100,7,0,107
Josh Barnett,2005-10-23,Mirko Filipovic,Decision - Unanimous,0,30,0,30
Josh Barnett,2006-09-10,Mirko Filipovic,KO/TKO,0,0,0,0
Josh Barnett,2001-11-02,Bobby Hoffman,KO/TKO,100,11,0,111
Josh Barnett,2006-05-05,Aleksander Emelianenko,Submission,90,1,0,91
Josh Barnett,2011-09-10,Sergei Kharitonov,Submission,90,12,0,102
Josh Barnett,2013-08-31,Frank Mir,KO/TKO,100,17,0,117
Josh Barnett,2016-09-03,Andrei Arlovski,Submission,90,15,25,130
Josh Barnett,2013-12-28,Travis Browne,KO/TKO,0,0,0,0
Josh Barnett,2006-10-21,Pawel Nastula,Submission,90,0,0,90
Josh Barnett,2008-07-19,Pedro Rizzo,KO/TKO,100,19,0,119
Josh Barnett,2009-01-24,Gilbert Yvel,KO/TKO,100,38,0,138
Josh Barnett,2010-03-22,Siala Siliga,Submission,90,7,0,97
Josh Barnett,2011-06-18,Brett Rogers,Submission,90,8,0,98
Josh Barnett,2001-02-23,Pedro Rizzo,KO/TKO,0,8,0,8
Josh Barnett,2016-01-30,Ben Rothwell,Submission,0,0,0,0
Josh Barnett,2006-02-26,Kazuhiro Nakamura,Submission,90,20,0,110
Josh Barnett,2006-09-10,Antonio Rodrigo Nogueira,Decision - Split,70,10,0,80
Josh Barnett,2006-07-01,Mark Hunt,Submission,90,1,0,91
Josh Barnett,2002-03-22,Randy Couture,KO/TKO,100,26,25,151
Josh Barnett,2015-09-26,Roy Nelson,Decision - Unanimous,80,86,25,191
Josh Barnett,2010-07-10,Geronimo dos Santos,KO/TKO,100,21,0,121
Josh Barnett,2004-10-31,Mirko Filipovic,Submission,0,2,0,2
Josh Barnett,2013-01-12,Nandor Guelmino,Submission,90,0,0,90
Josh Barnett,2001-06-29,Semmy Schilt,Submission,90,9,0,99
Josh Barnett,2012-05-19,Daniel Cormier,Decision - Unanimous,0,0,25,25
Jon Fitch,2006-04-06,Joshua Burkman,Submission,90,5,0,95
Jon Fitch,2010-03-27,Ben Saunders,Decision - Unanimous,80,55,0,135
Jon Fitch,2009-12-12,Mike Pierce,Decision - Unanimous,80,1,0,81
Jon Fitch,2010-08-07,Thiago Alves,Decision - Unanimous,80,7,0,87
Jon Fitch,2009-01-31,Akihiro Gono,Decision - Unanimous,80,33,0,113
Jon Fitch,2011-12-30,Johny Hendricks,KO/TKO,0,0,0,0
Jon Fitch,2008-08-09,Georges St-Pierre,Decision - Unanimous,0,0,25,25
Jon Fitch,2007-03-03,Luigi Fioravanti,Submission,90,5,0,95
Jon Fitch,2005-10-03,Brock Larson,Decision - Unanimous,80,11,0,91
Jon Fitch,2007-06-12,Roan Carneiro,Submission,90,14,0,104
Jon Fitch,2005-07-09,Jeff Joslin,Decision - Split,70,0,0,70
Jon Fitch,2009-07-11,Paulo Thiago,Decision - Unanimous,80,10,0,90
Jon Fitch,2007-09-22,Diego Sanchez,Decision - Split,70,14,0,84
Jon Fitch,2006-10-14,Kuniyoshi Hironaka,Decision - Unanimous,80,40,0,120
Jon Fitch,2013-02-02,Demian Maia,Decision - Unanimous,0,0,0,0
Jon Fitch,2006-06-28,Thiago Alves,KO/TKO,100,50,0,150
Jon Fitch,2012-10-13,Erick Silva,Decision - Unanimous,80,63,0,143
Jon Fitch,2008-03-01,Chris Wilson,Decision - Unanimous,80,18,0,98
Sean Brady,2024-09-07,Gilbert Burns,Decision - Unanimous,80,83,25,188
Sean Brady,2022-10-22,Belal Muhammad,KO/TKO,0,0,0,0
Sean Brady,2020-08-29,Christian Aguilera,Submission,90,18,0,108
Sean Brady,2021-03-06,Jake Matthews,Submission,90,16,0,106
Sean Brady,2020-02-29,Ismail Naurdiev,Decision - Unanimous,80,10,0,90
Sean Brady,2021-11-20,Michael Chiesa,Decision - Unanimous,80,0,0,80
Sean Brady,2023-12-02,Kelvin Gastelum,Submission,90,0,0,90
Sean Brady,2019-10-18,Court McGee,Decision - Unanimous,80,12,0,92
Erik Apple,2007-03-24,Brock Larson,Submission,0,0,0,0
Cristiane Justino,2016-05-14,Leslie Smith,KO/TKO,100,24,0,124
Cristiane Justino,2010-06-26,Jan Finney,KO/TKO,100,73,25,198
Cristiane Justino,2010-01-30,Marloes Coenen,KO/TKO,100,33,25,158
Cristiane Justino,2017-07-29,Tonya Evinger,KO/TKO,100,42,25,167
Cristiane Justino,2016-09-24,Lina Lansberg,KO/TKO,100,70,25,195
Cristiane Justino,2009-08-15,Gina Carano,KO/TKO,100,26,25,151
Cristiane Justino,2009-04-11,Hitomi Akano,KO/TKO,100,36,0,136
Cristiane Justino,2008-10-04,Yoko Takahashi,Decision - Unanimous,80,33,0,113
Cristiane Justino,2018-03-03,Yana Santos,KO/TKO,100,28,25,153
Cristiane Justino,2008-07-26,Shayna Baszler,KO/TKO,100,45,0,145
Cristiane Justino,2018-12-29,Amanda Nunes,KO/TKO,0,0,25,25
Cristiane Justino,2017-12-30,Holly Holm,Decision - Unanimous,80,74,25,179
Cristiane Justino,2019-07-27,Felicia Spencer,Decision - Unanimous,80,84,0,164
Leslie Smith,2016-05-14,Cristiane Justino,KO/TKO,0,0,0,0
Leslie Smith,2016-12-17,Irene Aldana,Decision - Unanimous,80,61,0,141
Leslie Smith,2017-07-16,Amanda Lemos,KO/TKO,100,33,0,133
Leslie Smith,2016-03-19,Rin Nakai,Decision - Unanimous,80,31,0,111
Leslie Smith,2014-07-16,Jessamyn Duke,KO/TKO,100,20,0,120
Leslie Smith,2014-04-16,Sarah Kaufman,Decision - Unanimous,0,0,0,0
Leslie Smith,2014-11-15,Jessica Eye,TKO - Doctor's Stoppage,0,0,0,0
Ian Loveland,2010-12-04,Tyler Toner,Decision - Unanimous,80,23,0,103
Ian Loveland,2011-08-27,Yves Jabouin,Decision - Split,0,0,0,0
Ian Loveland,2011-03-19,Joseph Benavidez,Decision - Unanimous,0,0,0,0
Tyler Toner,2010-12-04,Ian Loveland,Decision - Unanimous,0,0,0,0
Tyler Toner,2010-09-30,Diego Nunes,Decision - Unanimous,0,0,0,0
Tyler Toner,2008-10-03,Ricky Johnson,KO/TKO,100,39,0,139
Tyler Toner,2010-04-24,Brandon Visher,KO/TKO,100,23,0,123
Aljamain Sterling,2023-08-19,Sean O'Malley,KO/TKO,0,0,25,25
Aljamain Sterling,2018-09-08,Cody Stamann,Submission,90,21,0,111
Aljamain Sterling,2023-05-06,Henry Cejudo,Decision - Split,70,36,25,131
Aljamain Sterling,2024-12-07,Movsar Evloev,Decision - Unanimous,0,4,0,4
Aljamain Sterling,2024-04-13,Calvin Kattar,Decision - Unanimous,80,31,0,111
Aljamain Sterling,2020-06-06,Cory Sandhagen,Submission,90,1,0,91
Aljamain Sterling,2017-07-29,Renan Barao,Decision - Unanimous,80,52,0,132
Aljamain Sterling,2022-04-09,Petr Yan,Decision - Split,70,0,25,95
Aljamain Sterling,2016-05-29,Bryan Caraway,Decision - Split,0,23,0,23
Aljamain Sterling,2018-04-21,Brett Johns,Decision - Unanimous,80,62,0,142
Aljamain Sterling,2017-04-15,Augusto Mendes,Decision - Unanimous,80,53,0,133
Aljamain Sterling,2017-01-28,Raphael Assuncao,Decision - Split,0,13,0,13
Aljamain Sterling,2019-02-17,Jimmie Rivera,Decision - Unanimous,80,77,0,157
Aljamain Sterling,2015-12-10,Johnny Eduardo,Submission,90,19,0,109
Aljamain Sterling,2014-02-22,Cody Gibson,Decision - Unanimous,80,28,0,108
Aljamain Sterling,2015-04-18,Takeya Mizugaki,Submission,90,19,0,109
Aljamain Sterling,2022-10-22,TJ Dillashaw,KO/TKO,100,64,25,189
Aljamain Sterling,2017-12-09,Marlon Moraes,KO/TKO,0,0,0,0
Aljamain Sterling,2019-06-08,Pedro Munhoz,Decision - Unanimous,80,69,0,149
Aljamain Sterling,2021-03-06,Petr Yan,DQ,0,11,25,36
Aljamain Sterling,2014-07-16,Hugo Viana,KO/TKO,100,47,0,147
Travis Lutter,2005-08-20,Trevor Prangley,Decision - Unanimous,0,0,0,0
Travis Lutter,2004-10-22,Marvin Eastman,KO/TKO,100,0,0,100
Travis Lutter,2006-11-11,Patrick Cote,Submission,90,0,0,90
Travis Lutter,2008-04-19,Rich Franklin,KO/TKO,0,0,0,0
Travis Lutter,2005-04-16,Matt Lindland,Submission,0,0,0,0
Travis Lutter,2007-02-03,Anderson Silva,Submission,0,0,0,0
Mike Jackson,2016-02-06,Mickey Gall,Submission,0,1,0,1
Mike Jackson,2022-10-15,Pete Rodriguez,KO/TKO,0,0,0,0
Mike Jackson,2022-04-23,Dean Barry,DQ,0,0,0,0
Anthony Christodoulou,2015-01-24,Mairbek Taisumov,KO/TKO,0,0,0,0
Anthony Christodoulou,2015-08-08,Scott Holtzman,Submission,0,0,0,0
Joaquin Buckley,2020-10-10,Impa Kasanganay,KO/TKO,100,1,0,101
Joaquin Buckley,2023-10-07,Alex Morono,Decision - Unanimous,80,28,0,108
Joaquin Buckley,2024-03-30,Vicente Luque,KO/TKO,100,34,0,134
Joaquin Buckley,2024-05-11,Nursulton Ruziboev,Decision - Unanimous,80,55,0,135
Joaquin Buckley,2022-12-10,Chris Curtis,KO/TKO,0,14,0,14
Joaquin Buckley,2021-01-16,Alessio Di Chirico,KO/TKO,0,0,0,0
Joaquin Buckley,2023-05-20,Andre Fialho,KO/TKO,100,4,0,104
Joaquin Buckley,2020-11-21,Jordan Wright,KO/TKO,100,25,0,125
Joaquin Buckley,2024-10-05,Stephen Thompson,KO/TKO,100,0,0,100
Joaquin Buckley,2021-09-18,Antonio Arroyo,KO/TKO,100,20,0,120
Joaquin Buckley,2022-09-03,Nassourdine Imavov,Decision - Unanimous,0,0,0,0
Joaquin Buckley,2022-06-18,Albert Duraev,TKO - Doctor's Stoppage,0,17,0,17
Joaquin Buckley,2020-08-08,Kevin Holland,KO/TKO,0,0,0,0
Joaquin Buckley,2022-02-19,Abdul Razak Alhassan,Decision - Split,70,5,0,75
Joaquin Buckley,2024-12-14,Colby Covington,TKO - Doctor's Stoppage,0,38,25,63
Impa Kasanganay,2020-10-10,Joaquin Buckley,KO/TKO,0,0,0,0
Impa Kasanganay,2020-08-29,Maki Pitolo,Decision - Unanimous,80,14,0,94
Impa Kasanganay,2019-08-27,Kailan Hill,Decision - Unanimous,80,33,0,113
Impa Kasanganay,2021-04-10,Sasha Palatnikov,Submission,90,0,0,90
Impa Kasanganay,2020-08-11,Anthony Adams,Decision - Unanimous,80,50,0,130
Impa Kasanganay,2021-09-18,Carlston Harris,KO/TKO,0,0,0,0
Ian Entwistle,2014-06-28,Dan Hooker,KO/TKO,0,0,0,0
Ian Entwistle,2016-04-10,Alejandro Perez,KO/TKO,0,0,0,0
Ian Entwistle,2014-12-13,Anthony Birchak,Submission,90,0,0,90
Lauren Murphy,2016-07-13,Katlyn Cerminara,Decision - Unanimous,0,0,0,0
Lauren Murphy,2020-10-24,Liliya Shakirova,Submission,90,0,0,90
Lauren Murphy,2019-08-03,Mara Romero Borella,KO/TKO,100,2,0,102
Lauren Murphy,2017-12-01,Barb Honchak,Decision - Split,70,0,0,70
Lauren Murphy,2016-02-21,Kelly Faszholz,KO/TKO,100,19,0,119
Lauren Murphy,2020-02-08,Andrea Lee,Decision - Split,70,0,0,70
Lauren Murphy,2018-06-01,Sijara Eubanks,Decision - Unanimous,0,0,0,0
Lauren Murphy,2015-04-04,Liz Carmouche,Decision - Unanimous,0,8,0,8
Lauren Murphy,2021-09-25,Valentina Shevchenko,KO/TKO,0,0,25,25
Lauren Murphy,2022-07-16,Miesha Tate,Decision - Unanimous,80,17,0,97
Lauren Murphy,2021-06-12,Joanne Wood,Decision - Split,70,0,0,70
Lauren Murphy,2020-06-20,Roxanne Modafferi,Decision - Unanimous,80,28,0,108
Lauren Murphy,2014-08-16,Sara McMann,Decision - Split,0,10,0,10
Lauren Murphy,2023-01-21,Jessica Andrade,Decision - Unanimous,0,0,0,0
Jared Gooden,2024-10-12,Chidi Njokuani,Decision - Unanimous,0,0,0,0
Jared Gooden,2021-07-31,Niklas Stolze,KO/TKO,100,7,0,107
Jared Gooden,2021-10-09,Randy Brown,Decision - Unanimous,0,0,0,0
Jared Gooden,2023-03-11,Carlston Harris,Decision - Unanimous,0,0,0,0
Jared Gooden,2020-11-21,Alan Jouban,Decision - Unanimous,0,0,0,0
Jared Gooden,2021-03-27,Abubakar Nurmagomedov,Decision - Unanimous,0,0,0,0
Jared Gooden,2023-12-02,Wellington Turman,Submission,90,16,0,106
Justin Salas,2013-11-09,Thiago Tavares,Submission,0,0,0,0
Justin Salas,2014-07-16,Joe Proctor,KO/TKO,0,10,0,10
Justin Salas,2013-07-27,Aaron Riley,Decision - Split,70,28,0,98
Justin Salas,2012-02-15,Anton Kuivanen,Decision - Unanimous,80,12,0,92
Justin Salas,2016-03-05,Jason Saggo,KO/TKO,0,0,0,0
Justin Salas,2014-05-10,Ben Wall,KO/TKO,100,16,0,116
Justin Salas,2012-06-08,Tim Means,KO/TKO,0,0,0,0
Dan Henderson,2013-02-23,Lyoto Machida,Decision - Split,0,0,0,0
Dan Henderson,2005-09-25,Akihiro Gono,KO/TKO,100,14,0,114
Dan Henderson,2016-10-08,Michael Bisping,Decision - Unanimous,0,0,25,25
Dan Henderson,1997-06-15,Eric Smith,Submission,90,0,0,90
Dan Henderson,1997-06-15,Crezio de Souza,KO/TKO,100,7,0,107
Dan Henderson,2004-10-31,Kazuhiro Nakamura,KO/TKO,100,3,0,103
Dan Henderson,2010-04-17,Jake Shields,Decision - Unanimous,0,0,25,25
Dan Henderson,2009-01-17,Rich Franklin,Decision - Split,70,0,0,70
Dan Henderson,2010-12-04,Renato Sobral,KO/TKO,100,10,0,110
Dan Henderson,2015-01-24,Gegard Mousasi,KO/TKO,0,0,0,0
Dan Henderson,2013-06-15,Rashad Evans,Decision - Split,0,1,0,1
Dan Henderson,2005-04-23,Rogerio Nogueira,Submission,0,6,0,6
Dan Henderson,2016-06-04,Hector Lombard,KO/TKO,100,0,0,100
Dan Henderson,2011-03-05,Rafael Cavalcante,KO/TKO,100,13,25,138
Dan Henderson,2002-12-23,Antonio Rodrigo Nogueira,Submission,0,0,0,0
Dan Henderson,2011-07-30,Fedor Emelianenko,KO/TKO,100,15,0,115
Dan Henderson,2008-03-01,Anderson Silva,Submission,0,0,25,25
Dan Henderson,2003-03-16,Shungo Oyama,KO/TKO,100,15,0,115
Dan Henderson,2008-09-06,Rousimar Palhares,Decision - Unanimous,80,15,0,95
Dan Henderson,2001-11-03,Murilo Rua,Decision - Split,70,0,0,70
Dan Henderson,2014-03-23,Mauricio Rua,KO/TKO,100,0,25,125
Dan Henderson,2015-06-06,Tim Boetsch,KO/TKO,100,9,25,134
Dan Henderson,2015-11-07,Vitor Belfort,KO/TKO,0,0,25,25
Dan Henderson,2006-10-21,Vitor Belfort,Decision - Unanimous,80,29,0,109
Dan Henderson,2001-05-27,Akira Shoji,KO/TKO,100,66,0,166
Dan Henderson,2007-02-24,Wanderlei Silva,KO/TKO,100,13,25,138
Dan Henderson,2000-12-09,Wanderlei Silva,Decision - Unanimous,0,0,0,0
Dan Henderson,2009-07-11,Michael Bisping,KO/TKO,100,7,0,107
Dan Henderson,2005-09-25,Ryo Chonan,KO/TKO,100,4,0,104
Dan Henderson,2003-11-09,Murilo Bustamante,KO/TKO,100,7,0,107
Dan Henderson,2004-12-31,Yuki Kondo,Decision - Split,70,4,0,74
Dan Henderson,2006-04-02,Kazuo Misaki,Decision - Unanimous,80,17,0,97
Dan Henderson,2007-09-08,Quinton Jackson,Decision - Unanimous,0,0,25,25
Dan Henderson,2005-12-31,Murilo Bustamante,Decision - Split,70,8,0,78
Dan Henderson,2001-03-25,Renzo Gracie,KO/TKO,100,3,0,103
Dan Henderson,2014-05-24,Daniel Cormier,Submission,0,0,0,0
Dan Henderson,2006-08-27,Kazuo Misaki,Decision - Unanimous,0,0,0,0
Dan Henderson,2002-04-28,Ricardo Arona,Decision - Split,0,0,0,0
Dan Henderson,1998-05-15,Allan Goes,Decision - Unanimous,80,0,0,80
Dan Henderson,2011-11-19,Mauricio Rua,Decision - Unanimous,80,0,25,105
Dan Henderson,2013-11-09,Vitor Belfort,KO/TKO,0,0,25,25
Dan Henderson,1998-05-15,Carlos Newton,Decision - Split,70,8,0,78
Alan Jouban,2016-03-19,Brendan O'Reilly,KO/TKO,100,24,0,124
Alan Jouban,2017-08-05,Niko Price,KO/TKO,0,0,0,0
Alan Jouban,2014-11-08,Warlley Alves,Decision - Unanimous,0,32,0,32
Alan Jouban,2020-11-21,Jared Gooden,Decision - Unanimous,80,68,0,148
Alan Jouban,2015-02-28,Richard Walsh,KO/TKO,100,2,0,102
Alan Jouban,2017-03-18,Gunnar Nelson,Submission,0,9,0,9
Alan Jouban,2019-04-13,Dwight Grant,Decision - Split,0,0,0,0
Alan Jouban,2014-08-16,Seth Baczynski,KO/TKO,100,0,0,100
Alan Jouban,2016-12-17,Mike Perry,Decision - Unanimous,80,32,0,112
Alan Jouban,2015-07-15,Matt Dwyer,Decision - Unanimous,80,22,0,102
Alan Jouban,2016-07-07,Belal Muhammad,Decision - Unanimous,80,9,0,89
Alan Jouban,2015-10-03,Albert Tumenov,KO/TKO,0,0,0,0
Alan Jouban,2018-02-24,Ben Saunders,KO/TKO,100,45,0,145
Brendan O'Reilly,2016-03-19,Alan Jouban,KO/TKO,0,0,0,0
Brendan O'Reilly,2016-12-03,Dong Hyun Ma,Decision - Unanimous,0,4,0,4
Brendan O'Reilly,2015-05-09,Vik Grujic,Decision - Unanimous,80,0,0,80
Brendan O'Reilly,2014-08-23,Zhang Lipeng,Decision - Unanimous,0,0,0,0
Yoshihiro Nakao,2006-09-10,Kazuhiro Nakamura,Decision - Unanimous,0,0,0,0
Yoshihiro Nakao,2007-04-08,Edson Drago,Submission,90,7,0,97
Yoshihiro Nakao,2006-07-01,Eun Soo Lee,TKO - Doctor's Stoppage,0,13,0,13
Cesar Almeida,2024-06-01,Roman Kopylov,Decision - Split,0,17,0,17
Cesar Almeida,2024-10-05,Ihor Potieria,Decision - Unanimous,80,13,0,93
Cesar Almeida,2023-08-08,Lucas Fernando,Decision - Unanimous,80,43,0,123
Cesar Almeida,2024-04-06,Dylan Budka,KO/TKO,100,28,0,128
Nicolae Negumereanu,2022-03-05,Kennedy Nzechukwu,Decision - Split,70,0,0,70
Nicolae Negumereanu,2021-10-23,Ike Villanueva,KO/TKO,100,4,0,104
Nicolae Negumereanu,2022-11-12,Carlos Ulberg,KO/TKO,0,0,0,0
Nicolae Negumereanu,2021-06-19,Aleksa Camur,Decision - Split,70,0,0,70
Nicolae Negumereanu,2019-03-16,Saparbeg Safarov,Decision - Unanimous,0,0,0,0
Nicolae Negumereanu,2022-07-30,Ihor Potieria,KO/TKO,100,13,0,113
Kennedy Nzechukwu,2022-03-05,Nicolae Negumereanu,Decision - Split,0,31,0,31
Kennedy Nzechukwu,2024-12-07,Lukasz Brzeski,KO/TKO,100,0,0,100
Kennedy Nzechukwu,2024-10-26,Chris Barnett,KO/TKO,100,39,0,139
Kennedy Nzechukwu,2021-03-06,Carlos Ulberg,KO/TKO,100,0,0,100
Kennedy Nzechukwu,2019-08-03,Darko Stosic,Decision - Unanimous,80,0,0,80
Kennedy Nzechukwu,2023-05-06,Devin Clark,Submission,90,26,0,116
Kennedy Nzechukwu,2022-11-19,Ion Cutelaba,KO/TKO,100,15,0,115
Kennedy Nzechukwu,2017-08-22,Anton Berzin,Decision - Split,70,36,0,106
Kennedy Nzechukwu,2021-06-26,Danilo Marques,KO/TKO,100,21,0,121
Kennedy Nzechukwu,2021-11-13,Da Woon Jung,KO/TKO,0,0,0,0
Kennedy Nzechukwu,2018-08-07,Dennis Bryant,KO/TKO,100,0,0,100
Kennedy Nzechukwu,2022-07-09,Karl Roberson,KO/TKO,100,11,0,111
Kennedy Nzechukwu,2024-03-16,Ovince Saint Preux,Decision - Split,0,0,0,0
Kennedy Nzechukwu,2023-08-05,Dustin Jacoby,KO/TKO,0,0,0,0
Kennedy Nzechukwu,2019-03-30,Paul Craig,Submission,0,15,0,15
Loik Radzhabov,2023-03-04,Esteban Ribovics,Decision - Unanimous,80,0,0,80
Loik Radzhabov,2024-03-02,Abdul-Kareem Al-Selwady,KO/TKO,100,1,0,101
Loik Radzhabov,2024-07-20,Trey Ogden,Decision - Unanimous,0,18,0,18
Loik Radzhabov,2023-06-24,Mateusz Rebecki,KO/TKO,0,0,0,0
Esteban Ribovics,2023-03-04,Loik Radzhabov,Decision - Unanimous,0,26,0,26
Esteban Ribovics,2024-05-11,Terrance McKinney,KO/TKO,100,0,0,100
Esteban Ribovics,2023-07-08,Kamuela Kirk,Decision - Unanimous,80,59,0,139
Esteban Ribovics,2022-08-16,Thomas Paull,KO/TKO,100,2,0,102
Esteban Ribovics,2024-09-14,Daniel Zellhuber,Decision - Split,70,35,0,105
Luke Caudillo,2007-06-12,Nate Mohr,Decision - Unanimous,0,0,0,0
Luke Caudillo,2007-11-17,Marcus Aurelio,KO/TKO,0,0,0,0
Luke Caudillo,2008-10-03,Billy Evangelista,Decision - Unanimous,0,0,0,0
Masutatsu Yano,1999-11-19,Katsuhisa Fujii,KO/TKO,0,0,0,0
Piera Rodriguez,2024-12-14,Josefine Knutsson,Decision - Unanimous,80,10,0,90
Piera Rodriguez,2021-10-19,Valesca Machado,Decision - Unanimous,80,7,0,87
Piera Rodriguez,2022-04-09,Kay Hansen,Decision - Unanimous,80,19,0,99
Piera Rodriguez,2023-04-15,Gillian Robertson,Submission,0,0,0,0
Piera Rodriguez,2022-10-15,Sam Hughes,Decision - Unanimous,80,14,0,94
Piera Rodriguez,2024-05-18,Ariane Carnelossi,DQ,0,24,0,24
Josefine Knutsson,2024-12-14,Piera Rodriguez,Decision - Unanimous,0,0,0,0
Josefine Knutsson,2023-08-22,Isis Verbeek,Decision - Unanimous,80,6,0,86
Josefine Knutsson,2023-09-16,Marnic Mann,Decision - Unanimous,80,73,0,153
Josefine Knutsson,2024-06-15,Julia Polastri,Decision - Unanimous,80,60,0,140
Josefine Knutsson,2022-06-10,YeDam Seo,Decision - Unanimous,80,29,0,109
Chris Holdsworth,2014-05-24,Chico Camus,Decision - Unanimous,80,1,0,81
Chris Holdsworth,2013-11-30,Davey Grant,Submission,90,0,0,90
Chico Camus,2014-05-24,Chris Holdsworth,Decision - Unanimous,0,0,0,0
Chico Camus,2012-08-11,Dustin Pague,Decision - Unanimous,80,10,0,90
Chico Camus,2013-08-31,Kyung Ho Kang,Decision - Unanimous,80,10,0,90
Chico Camus,2013-02-02,Dustin Kimura,Submission,0,7,0,7
Chico Camus,2015-06-13,Henry Cejudo,Decision - Unanimous,0,0,0,0
Chico Camus,2015-09-26,Kyoji Horiguchi,Decision - Unanimous,0,0,0,0
Chico Camus,2014-11-22,Brad Pickett,Decision - Split,70,18,0,88
Luiz Azeredo,2005-05-22,Takanori Gomi,KO/TKO,0,8,0,8
Luiz Azeredo,2005-04-03,Luiz Firmino,Decision - Split,70,7,0,77
Luiz Azeredo,2000-05-27,Anderson Silva,Decision,0,0,0,0
Luiz Azeredo,2007-12-31,Tatsuya Kawajiri,Decision - Unanimous,0,0,0,0
Luiz Azeredo,2005-09-25,Naoyuki Kotani,KO/TKO,100,5,0,105
Luiz Azeredo,2006-04-02,Joachim Hansen,KO/TKO,0,15,0,15
Luiz Azeredo,2005-09-25,Takanori Gomi,Decision - Unanimous,0,0,0,0
Isaac Vallie-Flagg,2012-05-19,Gesias Cavalcante,Decision - Split,70,50,0,120
Isaac Vallie-Flagg,2014-11-22,Matt Wiman,Decision - Unanimous,0,12,0,12
Isaac Vallie-Flagg,2013-02-02,Yves Edwards,Decision - Split,70,18,0,88
Isaac Vallie-Flagg,2014-01-15,Elias Silverio,Decision - Unanimous,0,0,0,0
Isaac Vallie-Flagg,2014-04-26,Takanori Gomi,Decision - Unanimous,0,0,0,0
Gesias Cavalcante,2012-05-19,Isaac Vallie-Flagg,Decision - Split,0,0,0,0
Gesias Cavalcante,2008-04-29,Shinya Aoki,Decision - Unanimous,0,12,0,12
Gesias Cavalcante,2010-10-09,Josh Thomson,Decision - Unanimous,0,0,0,0
Gesias Cavalcante,2010-07-10,Katsunori Kikuno,Decision - Split,70,0,0,70
Gesias Cavalcante,2009-05-26,Tatsuya Kawajiri,Decision - Unanimous,0,0,0,0
Zak Ottow,2016-11-19,Sergio Moraes,Decision - Split,0,9,0,9
Zak Ottow,2018-03-03,Mike Pyle,KO/TKO,100,18,0,118
Zak Ottow,2018-12-15,Dwight Grant,Decision - Split,70,0,0,70
Zak Ottow,2019-03-09,Alex Morono,KO/TKO,0,0,0,0
Zak Ottow,2018-07-14,Sage Northcutt,KO/TKO,0,0,0,0
Zak Ottow,2017-11-25,Li Jingliang,KO/TKO,0,0,0,0
Zak Ottow,2016-10-01,Joshua Burkman,Decision - Split,70,18,0,88
Zak Ottow,2017-06-10,Kiichi Kunimoto,Decision - Split,70,12,0,82
Timmy Cuamba,2024-02-10,Bolaji Oki,Decision - Split,0,0,0,0
Timmy Cuamba,2023-08-29,Mateo Vogel,Decision - Unanimous,80,0,0,80
Timmy Cuamba,2024-06-15,Lucas Almeida,Decision - Unanimous,0,0,0,0
Krzysztof Soszynski,2008-12-13,Shane Primm,Submission,90,12,0,102
Krzysztof Soszynski,2011-12-10,Igor Pokrajac,KO/TKO,0,0,0,0
Krzysztof Soszynski,2009-05-23,Andre Gusmao,KO/TKO,100,1,0,101
Krzysztof Soszynski,2009-08-29,Brandon Vera,Decision - Unanimous,0,0,0,0
Krzysztof Soszynski,2010-11-13,Goran Reljic,Decision - Unanimous,80,34,0,114
Krzysztof Soszynski,2010-07-03,Stephan Bonnar,KO/TKO,0,0,0,0
Krzysztof Soszynski,2007-08-02,Ben Rothwell,KO/TKO,0,0,0,0
Krzysztof Soszynski,2009-04-18,Brian Stann,Submission,90,0,0,90
Krzysztof Soszynski,2011-06-11,Mike Massenzio,Decision - Unanimous,80,49,0,129
Krzysztof Soszynski,2010-02-20,Stephan Bonnar,TKO - Doctor's Stoppage,0,12,0,12
Krzysztof Soszynski,2006-04-29,Ben Rothwell,KO/TKO,0,0,0,0
Shane Primm,2008-12-13,Krzysztof Soszynski,Submission,0,0,0,0
Germaine de Randamie,2019-07-13,Aspen Ladd,KO/TKO,100,4,25,129
Germaine de Randamie,2013-07-27,Julie Kedzie,Decision - Split,70,22,0,92
Germaine de Randamie,2013-11-06,Amanda Nunes,KO/TKO,0,0,0,0
Germaine de Randamie,2020-10-03,Julianna Pena,Submission,90,10,0,100
Germaine de Randamie,2016-05-08,Anna Elmose,KO/TKO,100,12,0,112
Germaine de Randamie,2019-12-14,Amanda Nunes,Decision - Unanimous,0,0,25,25
Germaine de Randamie,2012-08-18,Hiroko Yamanaka,Decision - Unanimous,80,10,0,90
Germaine de Randamie,2011-01-29,Stephanie Webber,KO/TKO,100,13,0,113
Germaine de Randamie,2017-02-11,Holly Holm,Decision - Unanimous,80,3,25,108
Germaine de Randamie,2015-03-14,Larissa Pacheco,KO/TKO,100,21,0,121
Germaine de Randamie,2011-06-24,Julia Budd,Decision - Unanimous,0,23,0,23
Germaine de Randamie,2024-04-06,Norma Dumont,Decision - Unanimous,0,5,0,5
Germaine de Randamie,2018-11-10,Raquel Pennington,Decision - Unanimous,80,18,0,98
Max Griffin,2021-03-20,Song Kenan,KO/TKO,100,3,0,103
Max Griffin,2019-10-12,Alex Morono,Decision - Unanimous,0,0,0,0
Max Griffin,2019-04-13,Zelim Imadaev,Decision - Majority,75,0,0,75
Max Griffin,2022-10-29,Tim Means,Decision - Split,70,0,0,70
Max Griffin,2024-12-07,Michael Chiesa,Submission,0,0,0,0
Max Griffin,2017-10-28,Elizeu Zaleski dos Santos,Decision - Unanimous,0,0,0,0
Max Griffin,2018-07-07,Curtis Millender,Decision - Unanimous,0,6,0,6
Max Griffin,2021-07-10,Carlos Condit,Decision - Unanimous,80,30,0,110
Max Griffin,2019-02-02,Thiago Alves,Decision - Split,0,29,0,29
Max Griffin,2020-11-07,Ramiz Brahimaj,KO/TKO,100,29,0,129
Max Griffin,2020-03-07,Alex Oliveira,Decision - Split,0,0,0,0
Max Griffin,2018-02-24,Mike Perry,Decision - Unanimous,80,33,0,113
Max Griffin,2022-03-26,Neil Magny,Decision - Split,0,13,0,13
Max Griffin,2016-11-05,Erick Montano,KO/TKO,100,12,0,112
Max Griffin,2024-02-10,Jeremiah Wells,Decision - Split,70,0,0,70
Max Griffin,2023-07-01,Michael Morales,Decision - Unanimous,0,0,0,0
Max Griffin,2016-08-20,Colby Covington,KO/TKO,0,0,0,0
Song Kenan,2021-03-20,Max Griffin,KO/TKO,0,0,0,0
Song Kenan,2023-03-04,Ian Machado Garry,KO/TKO,0,0,0,0
Song Kenan,2024-08-17,Ricky Glenn,Decision - Unanimous,80,47,0,127
Song Kenan,2023-08-26,Rolando Bedoya,Decision - Unanimous,80,0,0,80
Song Kenan,2024-11-23,Muslim Salikhov,KO/TKO,0,0,0,0
Song Kenan,2018-06-23,Hector Aldana,KO/TKO,100,0,0,100
Song Kenan,2018-11-24,Alex Morono,Decision - Unanimous,0,0,0,0
Song Kenan,2019-08-31,Derrick Krantz,Decision - Unanimous,80,25,0,105
Song Kenan,2017-11-25,Bobby Nash,KO/TKO,100,13,0,113
Song Kenan,2023-12-09,Kevin Jousset,Decision - Unanimous,0,0,0,0
Song Kenan,2020-02-22,Callan Potter,KO/TKO,100,10,0,110
John Cholish,2013-05-18,Gleison Tibau,Submission,0,0,0,0
John Cholish,2011-12-10,Mitch Clarke,KO/TKO,100,38,0,138
John Cholish,2012-05-05,Danny Castillo,Decision - Unanimous,0,0,0,0
John Cholish,2011-02-12,Marc Stevens,Submission,90,12,0,102
Aleksandar Rakic,2024-04-13,Jiri Prochazka,KO/TKO,0,0,0,0
Aleksandar Rakic,2024-10-26,Magomed Ankalaev,Decision - Unanimous,0,0,0,0
Aleksandar Rakic,2018-07-22,Justin Ledet,Decision - Unanimous,80,92,0,172
Aleksandar Rakic,2017-09-02,Francimar Barroso,Decision - Unanimous,80,22,0,102
Aleksandar Rakic,2022-05-14,Jan Blachowicz,KO/TKO,0,0,25,25
Aleksandar Rakic,2019-12-21,Volkan Oezdemir,Decision - Split,0,12,0,12
Aleksandar Rakic,2020-08-29,Anthony Smith,Decision - Unanimous,80,35,0,115
Aleksandar Rakic,2018-12-08,Devin Clark,KO/TKO,100,12,0,112
Aleksandar Rakic,2019-06-01,Jimi Manuwa,KO/TKO,100,0,0,100
Aleksandar Rakic,2021-03-06,Thiago Santos,Decision - Unanimous,80,0,0,80
George Sotiropoulos,2013-10-19,KJ Noons,Decision - Unanimous,0,0,0,0
George Sotiropoulos,2012-12-14,Ross Pearson,KO/TKO,0,0,25,25
George Sotiropoulos,2007-12-08,Billy Miles,Submission,90,2,0,92
George Sotiropoulos,2010-07-03,Kurt Pellegrino,Decision - Unanimous,80,9,0,89
George Sotiropoulos,2010-02-20,Joe Stevenson,Decision - Unanimous,80,13,0,93
George Sotiropoulos,2009-08-08,George Roop,Submission,90,9,0,99
George Sotiropoulos,2009-11-21,Jason Dent,Submission,90,8,0,98
George Sotiropoulos,2011-07-02,Rafael Dos Anjos,KO/TKO,0,0,0,0
George Sotiropoulos,2008-04-02,Roman Mitichyan,KO/TKO,100,19,0,119
George Sotiropoulos,2010-11-20,Joe Lauzon,Submission,90,3,0,93
George Sotiropoulos,2011-02-26,Dennis Siver,Decision - Unanimous,0,0,0,0
George Sotiropoulos,2006-10-14,Shinya Aoki,DQ,0,5,0,5
Rodolfo Bellato,2023-10-03,Murtaza Talha,KO/TKO,100,33,0,133
Rodolfo Bellato,2022-09-06,Vitor Petrino,KO/TKO,0,0,0,0
Rodolfo Bellato,2023-12-02,Ihor Potieria,KO/TKO,100,7,0,107
Murtaza Talha,2023-10-03,Rodolfo Bellato,KO/TKO,0,0,0,0
Marcus LeVesseur,2012-12-08,Abel Trujillo,KO/TKO,0,0,0,0
Marcus LeVesseur,2012-05-15,Cody McKenzie,Submission,0,6,0,6
Marcus LeVesseur,2012-10-05,Carlo Prater,Decision - Split,70,11,0,81
Sabina Mazo,2020-09-12,Justine Kish,Submission,90,38,0,128
Sabina Mazo,2019-03-30,Maryna Moroz,Decision - Unanimous,0,8,0,8
Sabina Mazo,2022-03-12,Miranda Maverick,Submission,0,0,0,0
Sabina Mazo,2021-02-27,Alexis Davis,Decision - Unanimous,0,15,0,15
Sabina Mazo,2020-01-18,JJ Aldrich,Decision - Split,70,60,0,130
Sabina Mazo,2019-08-17,Shana Dobson,Decision - Unanimous,80,75,0,155
Sabina Mazo,2021-10-09,Mariya Agapova,Submission,0,0,0,0
Justine Kish,2020-09-12,Sabina Mazo,Submission,0,0,0,0
Justine Kish,2017-06-25,Felice Herrig,Decision - Unanimous,0,0,0,0
Justine Kish,2016-12-09,Ashley Yoder,Decision - Unanimous,80,7,0,87
Justine Kish,2018-01-27,Ji Yeon Kim,Decision - Split,0,28,0,28
Justine Kish,2016-01-02,Nina Nunes,Decision - Unanimous,80,0,0,80
Justine Kish,2020-01-25,Lucie Pudilova,Decision - Unanimous,80,33,0,113
Justine Kish,2021-04-17,Tracy Cortez,Decision - Split,0,0,0,0
Paul Daley,2009-04-18,Junior Barata,KO/TKO,100,11,0,111
Paul Daley,2008-10-04,Jake Shields,Submission,0,0,25,25
Paul Daley,2010-12-04,Scott Smith,KO/TKO,100,12,0,112
Paul Daley,2010-01-02,Dustin Hazelett,KO/TKO,100,4,0,104
Paul Daley,2010-05-08,Josh Koscheck,Decision - Unanimous,0,0,0,0
Paul Daley,2009-09-19,Martin Kampmann,KO/TKO,100,15,0,115
Paul Daley,2012-03-03,Kazuo Misaki,Decision - Split,0,1,0,1
Paul Daley,2011-07-30,Tyron Woodley,Decision - Unanimous,0,1,0,1
Paul Daley,2009-03-29,Aurelijus Kerpe,KO/TKO,100,11,0,111
Paul Daley,2008-01-25,Sammy Morgan,KO/TKO,100,8,0,108
Paul Daley,2007-06-22,Duane Ludwig,KO/TKO,100,4,0,104
Paul Daley,2011-04-09,Nick Diaz,KO/TKO,0,0,25,25
Junior Barata,2009-04-18,Paul Daley,KO/TKO,0,0,0,0
Aliaskhab Khizriev,2020-09-08,Henrique Shiguemoto,Submission,90,2,0,92
Aliaskhab Khizriev,2022-03-26,Denis Tiuliulin,Submission,90,11,0,101
Henrique Shiguemoto,2020-09-08,Aliaskhab Khizriev,Submission,0,0,0,0
Stefan Struve,2010-12-11,Sean McCorkle,KO/TKO,100,7,0,107
Stefan Struve,2012-02-15,Dave Herman,KO/TKO,100,0,0,100
Stefan Struve,2016-05-08,Antonio Silva,KO/TKO,100,13,0,113
Stefan Struve,2017-09-02,Alexander Volkov,KO/TKO,0,0,25,25
Stefan Struve,2013-03-02,Mark Hunt,KO/TKO,0,0,0,0
Stefan Struve,2018-03-03,Andrei Arlovski,Decision - Unanimous,0,0,0,0
Stefan Struve,2019-12-07,Ben Rothwell,KO/TKO,0,0,0,0
Stefan Struve,2015-08-01,Antonio Rodrigo Nogueira,Decision - Unanimous,80,34,0,114
Stefan Struve,2012-09-29,Stipe Miocic,KO/TKO,100,9,25,134
Stefan Struve,2012-05-26,Lavar Johnson,Submission,90,0,0,90
Stefan Struve,2009-12-12,Paul Buentello,Decision - Majority,75,17,0,92
Stefan Struve,2015-11-14,Jared Rosholt,Decision - Unanimous,0,17,0,17
Stefan Struve,2009-02-21,Junior Dos Santos,KO/TKO,0,0,0,0
Stefan Struve,2018-07-22,Marcin Tybura,Decision - Unanimous,0,0,0,0
Stefan Struve,2011-05-28,Travis Browne,KO/TKO,0,0,0,0
Stefan Struve,2020-10-24,Tai Tuivasa,KO/TKO,0,0,0,0
Stefan Struve,2010-08-07,Christian Morecraft,KO/TKO,100,0,0,100
Stefan Struve,2019-02-23,Marcos Rogerio de Lima,Submission,90,0,0,90
Stefan Struve,2009-06-13,Denis Stojnic,Submission,90,0,0,90
Stefan Struve,2010-03-31,Roy Nelson,KO/TKO,0,0,0,0
Stefan Struve,2016-10-08,Daniel Omielanczuk,Submission,90,0,0,90
Stefan Struve,2009-10-24,Chase Gormley,Submission,90,4,0,94
Stefan Struve,2011-10-01,Pat Barry,Submission,90,1,0,91
Stefan Struve,2014-12-13,Alistair Overeem,KO/TKO,0,0,0,0
Sean McCorkle,2010-12-11,Stefan Struve,KO/TKO,0,0,0,0
Sean McCorkle,2010-09-25,Mark Hunt,Submission,90,0,0,90
Sean McCorkle,2011-03-26,Christian Morecraft,Submission,0,0,0,0
Jordan Johnson,2018-09-15,Adam Yandiev,Submission,90,34,0,124
Jordan Johnson,2018-03-03,Adam Milstead,Decision - Split,70,1,0,71
Jordan Johnson,2017-07-07,Marcel Fortuna,Decision - Unanimous,80,0,0,80
Jordan Johnson,2017-01-28,Henrique da Silva,Decision - Unanimous,80,17,0,97
Adam Yandiev,2018-09-15,Jordan Johnson,Submission,0,0,0,0
Eddie Wineland,2012-06-08,Scott Jorgensen,KO/TKO,100,13,0,113
Eddie Wineland,2010-06-20,Will Campuzano,KO/TKO,100,31,0,131
Eddie Wineland,2011-03-19,Urijah Faber,Decision - Unanimous,0,0,0,0
Eddie Wineland,2016-12-17,Takeya Mizugaki,KO/TKO,100,0,0,100
Eddie Wineland,2010-12-16,Ken Stone,KO/TKO,100,1,0,101
Eddie Wineland,2009-04-05,Rani Yahya,Submission,0,0,0,0
Eddie Wineland,2018-07-14,Alejandro Perez,Decision - Unanimous,0,0,0,0
Eddie Wineland,2019-06-08,Grigory Popov,KO/TKO,100,19,0,119
Eddie Wineland,2021-02-20,John Castaneda,KO/TKO,0,0,0,0
Eddie Wineland,2014-01-25,Yves Jabouin,KO/TKO,100,21,0,121
Eddie Wineland,2017-04-22,John Dodson,Decision - Unanimous,0,0,0,0
Eddie Wineland,2022-06-18,Cody Stamann,KO/TKO,0,0,0,0
Eddie Wineland,2009-10-10,Manny Tapia,Decision - Unanimous,80,29,0,109
Eddie Wineland,2016-07-23,Frankie Saenz,KO/TKO,100,0,0,100
Eddie Wineland,2007-03-24,Chase Beebe,Decision - Unanimous,0,0,25,25
Eddie Wineland,2012-12-29,Brad Pickett,Decision - Split,70,23,0,93
Eddie Wineland,2020-06-06,Sean O'Malley,KO/TKO,0,0,0,0
Eddie Wineland,2015-07-25,Bryan Caraway,Decision - Unanimous,0,0,0,0
Eddie Wineland,2014-05-10,Johnny Eduardo,KO/TKO,0,0,0,0
Eddie Wineland,2006-05-05,Antonio Banuelos,KO/TKO,100,3,0,103
Eddie Wineland,2010-01-10,George Roop,Decision - Unanimous,80,13,0,93
Eddie Wineland,2013-09-21,Renan Barao,KO/TKO,0,0,25,25
Eddie Wineland,2011-08-14,Joseph Benavidez,Decision - Unanimous,0,0,0,0
Ihor Potieria,2024-10-05,Cesar Almeida,Decision - Unanimous,0,0,0,0
Ihor Potieria,2023-05-13,Carlos Ulberg,KO/TKO,0,0,0,0
Ihor Potieria,2023-01-21,Mauricio Rua,KO/TKO,100,4,0,104
Ihor Potieria,2021-09-28,Lucasz Sudolski,KO/TKO,100,0,0,100
Ihor Potieria,2024-05-04,Michel Pereira,Submission,0,0,0,0
Ihor Potieria,2022-07-30,Nicolae Negumereanu,KO/TKO,0,0,0,0
Ihor Potieria,2024-02-10,Robert Bryczek,Decision - Unanimous,80,35,0,115
Ihor Potieria,2023-12-02,Rodolfo Bellato,KO/TKO,0,0,0,0
Ricky Turcios,2021-08-28,Brady Hiestand,Decision - Split,70,34,0,104
Ricky Turcios,2022-07-09,Aiemann Zahabi,Decision - Unanimous,0,0,0,0
Ricky Turcios,2024-06-08,Raul Rosas Jr.,Submission,0,4,0,4
Ricky Turcios,2017-07-11,Boston Salmon,Decision - Unanimous,0,49,0,49
Ricky Turcios,2022-11-19,Kevin Natividad,Decision - Split,70,27,0,97
Said Nurmagomedov,2022-12-17,Saidyokub Kakhramonov,Submission,90,0,0,90
Said Nurmagomedov,2023-10-21,Muin Gafurov,Submission,90,4,0,94
Said Nurmagomedov,2022-07-09,Douglas Silva de Andrade,Decision - Unanimous,80,14,0,94
Said Nurmagomedov,2023-03-11,Jonathan Martinez,Decision - Unanimous,0,9,0,9
Said Nurmagomedov,2019-02-02,Ricardo Ramos,KO/TKO,100,15,0,115
Said Nurmagomedov,2022-01-22,Cody Stamann,Submission,90,6,0,96
Said Nurmagomedov,2019-12-21,Raoni Barcelos,Decision - Unanimous,0,13,0,13
Said Nurmagomedov,2018-07-14,Justin Scoggins,Decision - Split,70,33,0,103
Said Nurmagomedov,2020-10-17,Mark Striegl,KO/TKO,100,15,0,115
Muin Gafurov,2023-10-21,Said Nurmagomedov,Submission,0,0,0,0
Muin Gafurov,2021-09-07,Chad Anheliger,Decision - Split,0,0,0,0
Muin Gafurov,2023-06-03,John Castaneda,Decision - Unanimous,0,21,0,21
Muin Gafurov,2024-06-22,Kyung Ho Kang,Decision - Unanimous,80,35,0,115
Khaos Williams,2020-02-08,Alex Morono,KO/TKO,100,9,0,109
Khaos Williams,2021-06-19,Matthew Semelsberger,Decision - Unanimous,80,27,0,107
Khaos Williams,2021-11-13,Miguel Baeza,KO/TKO,100,18,0,118
Khaos Williams,2024-05-18,Carlston Harris,KO/TKO,100,0,0,100
Khaos Williams,2022-05-07,Randy Brown,Decision - Split,0,0,0,0
Khaos Williams,2023-05-06,Rolando Bedoya,Decision - Split,70,0,0,70
Khaos Williams,2020-12-19,Michel Pereira,Decision - Unanimous,0,11,0,11
Khaos Williams,2020-11-14,Abdul Razak Alhassan,KO/TKO,100,3,0,103
Matt Hughes,2006-05-27,Royce Gracie,KO/TKO,100,25,0,125
Matt Hughes,2002-03-22,Hayato Sakurai,KO/TKO,100,31,25,156
Matt Hughes,1999-09-24,Valeri Ignatov,Decision - Unanimous,80,70,0,150
Matt Hughes,2000-06-09,Marcelo Aguiar,TKO - Doctor's Stoppage,0,16,0,16
Matt Hughes,2009-05-23,Matt Serra,Decision - Unanimous,80,20,0,100
Matt Hughes,2006-09-23,BJ Penn,KO/TKO,100,18,25,143
Matt Hughes,2008-06-07,Thiago Alves,KO/TKO,0,0,0,0
Matt Hughes,2005-04-16,Frank Trigg,Submission,90,0,25,115
Matt Hughes,2002-11-22,Gil Castillo,TKO - Doctor's Stoppage,0,21,25,46
Matt Hughes,2011-09-24,Josh Koscheck,KO/TKO,0,0,0,0
Matt Hughes,2005-11-19,Joe Riggs,Submission,90,7,0,97
Matt Hughes,2007-12-29,Georges St-Pierre,Submission,0,0,25,25
Matt Hughes,2004-10-22,Georges St-Pierre,Submission,90,0,25,115
Matt Hughes,2010-04-10,Renzo Gracie,KO/TKO,100,36,0,136
Matt Hughes,2001-11-02,Carlos Newton,KO/TKO,100,6,25,131
Matt Hughes,2010-11-20,BJ Penn,KO/TKO,0,0,0,0
Matt Hughes,2004-06-19,Renato Verissimo,Decision - Unanimous,80,4,0,84
Matt Hughes,2004-01-31,BJ Penn,Submission,0,0,25,25
Matt Hughes,2000-12-16,Dennis Hallman,Submission,0,1,0,1
Matt Hughes,2003-11-21,Frank Trigg,Submission,90,0,25,115
Matt Hughes,2007-03-03,Chris Lytle,Decision - Unanimous,80,8,0,88
Matt Hughes,2006-11-18,Georges St-Pierre,KO/TKO,0,0,25,25
Matt Hughes,2010-08-07,Ricardo Almeida,Submission,90,0,0,90
Matt Hughes,2002-07-13,Carlos Newton,KO/TKO,100,55,25,180
Matt Hughes,2003-04-25,Sean Sherk,Decision - Unanimous,80,25,25,130
John Franchi,2009-11-18,Cub Swanson,Submission,0,0,0,0
John Franchi,2009-03-01,Mike Budnik,Decision - Split,70,10,0,80
John Franchi,2009-06-07,Manvel Gamburyan,Decision - Unanimous,0,0,0,0
Niklas Stolze,2022-06-04,Benoit Saint Denis,Submission,0,3,0,3
Niklas Stolze,2021-07-31,Jared Gooden,KO/TKO,0,0,0,0
Niklas Stolze,2020-07-25,Ramazan Emeev,Decision - Unanimous,0,1,0,1
Angela Magana,2014-12-12,Tecia Pennington,Decision - Unanimous,0,0,0,0
Angela Magana,2015-07-12,Michelle Waterson-Gomez,Submission,0,0,0,0
Angela Magana,2017-12-02,Amanda Cooper,KO/TKO,0,0,0,0
Antonio Banuelos,2010-09-30,Chad George,Decision - Unanimous,80,2,0,82
Antonio Banuelos,2007-01-20,Mike French,Decision - Unanimous,80,47,0,127
Antonio Banuelos,2010-04-24,Scott Jorgensen,Decision - Unanimous,0,0,0,0
Antonio Banuelos,2011-02-05,Miguel Torres,Decision - Unanimous,0,0,0,0
Antonio Banuelos,2008-02-13,Manny Tapia,Decision - Split,0,0,0,0
Antonio Banuelos,2007-08-05,Justin Robbins,Decision - Unanimous,80,38,0,118
Antonio Banuelos,2011-09-24,Hideo Tokoro,Decision - Split,70,2,0,72
Antonio Banuelos,2011-12-31,Bibiano Fernandes,KO/TKO,0,0,0,0
Antonio Banuelos,2009-11-18,Kenji Osawa,Decision - Unanimous,80,0,0,80
Antonio Banuelos,2006-08-17,Cole Escovedo,Decision - Unanimous,80,12,0,92
Antonio Banuelos,2009-06-07,Scott Jorgensen,Decision - Split,70,0,0,70
Antonio Banuelos,2007-03-24,Charlie Valencia,KO/TKO,0,0,0,0
Antonio Banuelos,2006-05-05,Eddie Wineland,KO/TKO,0,0,0,0
Antonio Banuelos,2011-12-31,Masakazu Imanari,Decision - Split,70,14,0,84
Chad George,2010-09-30,Antonio Banuelos,Decision - Unanimous,0,0,0,0
Chad George,2009-12-19,John Hosman,Decision - Unanimous,80,5,0,85
Chad George,2010-03-06,Scott Jorgensen,Submission,0,0,0,0
Jon Olav Einemo,2006-02-26,Fabricio Werdum,Decision - Unanimous,0,0,0,0
Jon Olav Einemo,2012-01-28,Mike Russow,Decision - Unanimous,0,10,0,10
Jon Olav Einemo,2011-06-11,Dave Herman,KO/TKO,0,0,0,0
Luigi Fioravanti,2008-12-10,Brodie Farber,Decision - Unanimous,80,20,0,100
Luigi Fioravanti,2006-12-13,Dave Menne,KO/TKO,100,15,0,115
Luigi Fioravanti,2007-03-03,Jon Fitch,Submission,0,0,0,0
Luigi Fioravanti,2009-02-07,Anthony Johnson,KO/TKO,0,0,0,0
Luigi Fioravanti,2006-06-24,Solomon Hutcherson,KO/TKO,100,0,0,100
Luigi Fioravanti,2008-03-01,Luke Cummo,Decision - Unanimous,80,16,0,96
Luigi Fioravanti,2006-04-06,Chris Leben,Decision - Unanimous,0,0,0,0
Luigi Fioravanti,2008-06-21,Diego Sanchez,KO/TKO,0,0,0,0
Luigi Fioravanti,2007-06-12,Forrest Petz,Decision - Unanimous,0,5,0,5
Brodie Farber,2008-12-10,Luigi Fioravanti,Decision - Unanimous,0,0,0,0
Brodie Farber,2008-07-19,Rory Markham,KO/TKO,0,12,0,12
Caio Borralho,2023-04-29,Michal Oleksiejczuk,Submission,90,4,0,94
Caio Borralho,2021-09-28,Aaron Jeffery,Decision - Unanimous,80,32,0,112
Caio Borralho,2022-04-16,Gadzhi Omargadzhiev,Decision - Unanimous,80,19,0,99
Caio Borralho,2023-11-04,Abus Magomedov,Decision - Unanimous,80,13,0,93
Caio Borralho,2022-07-09,Armen Petrosyan,Decision - Unanimous,80,0,0,80
Caio Borralho,2024-05-04,Paul Craig,KO/TKO,100,14,0,114
Caio Borralho,2022-10-22,Makhmud Muradov,Decision - Unanimous,80,5,0,85
Caio Borralho,2024-08-24,Jared Cannonier,Decision - Unanimous,80,70,25,175
Caio Borralho,2021-10-19,Jesse Murray,KO/TKO,100,9,0,109
Bryan Baker,2008-03-26,Chael Sonnen,Decision - Unanimous,0,0,0,0
Bryan Baker,2007-09-05,Jesse Forbes,KO/TKO,100,25,0,125
Bryan Baker,2007-12-12,Eric Schambari,Decision - Split,70,3,0,73
Evangelista Santos,2006-07-01,Kazuhiro Nakamura,Submission,0,0,0,0
Evangelista Santos,2010-06-16,Marius Zaromskis,KO/TKO,100,7,0,107
Evangelista Santos,2003-08-01,Mauricio Rua,KO/TKO,0,0,0,0
Evangelista Santos,2008-02-01,Gegard Mousasi,KO/TKO,0,0,0,0
Evangelista Santos,2011-01-29,Nick Diaz,Submission,0,0,25,25
Evangelista Santos,2011-09-10,Jordan Mein,KO/TKO,0,0,0,0
Evangelista Santos,2006-09-10,Yosuke Nishijima,Submission,90,14,0,104
Joe Doerksen,2010-12-11,Dan Miller,Decision - Split,0,0,0,0
Joe Doerksen,2004-05-14,Chris Leben,Decision - Unanimous,80,0,0,80
Joe Doerksen,2007-11-17,Ed Herman,KO/TKO,0,0,0,0
Joe Doerksen,2005-08-20,Matt Lindland,Decision - Unanimous,0,0,0,0
Joe Doerksen,2007-08-05,Paulo Filho,KO/TKO,0,0,25,25
Joe Doerksen,2008-04-19,Jason MacDonald,KO/TKO,0,0,0,0
Joe Doerksen,2004-08-21,Joe Riggs,KO/TKO,0,0,0,0
Joe Doerksen,2010-05-08,Tom Lawlor,Submission,90,2,0,92
Joe Doerksen,2010-09-25,CB Dollaway,Submission,0,0,0,0
Joe Doerksen,2005-04-16,Patrick Cote,Submission,90,0,0,90
Joe Doerksen,2006-03-04,Nate Marquardt,Decision - Unanimous,0,0,0,0
Antonio Carlos Junior,2019-09-14,Uriah Hall,Decision - Split,0,0,0,0
Antonio Carlos Junior,2014-12-20,Patrick Cummins,Decision - Unanimous,0,0,0,0
Antonio Carlos Junior,2016-09-17,Leonardo Guimaraes,Submission,90,26,0,116
Antonio Carlos Junior,2014-05-31,Vitor Miranda,Decision - Unanimous,80,0,0,80
Antonio Carlos Junior,2016-03-19,Daniel Kelly,KO/TKO,0,0,0,0
Antonio Carlos Junior,2019-05-18,Ian Heinisch,Decision - Unanimous,0,0,0,0
Antonio Carlos Junior,2021-01-23,Brad Tavares,Decision - Unanimous,0,0,0,0
Antonio Carlos Junior,2016-12-30,Marvin Vettori,Decision - Unanimous,80,0,0,80
Antonio Carlos Junior,2017-10-28,Jack Marshman,Submission,90,10,0,100
Antonio Carlos Junior,2015-06-27,Eddie Gordon,Submission,90,28,0,118
Antonio Carlos Junior,2018-04-14,Tim Boetsch,Submission,90,24,0,114
Antonio Carlos Junior,2017-06-03,Eric Spicely,Submission,90,0,0,90
Mac Danzig,2010-12-11,Joe Stevenson,KO/TKO,100,3,0,103
Mac Danzig,2009-02-07,Josh Neer,Submission,0,0,0,0
Mac Danzig,2008-04-19,Mark Bocek,Submission,90,24,0,114
Mac Danzig,2009-07-11,Jim Miller,Decision - Unanimous,0,0,0,0
Mac Danzig,2008-09-17,Clay Guida,Decision - Unanimous,0,0,0,0
Mac Danzig,2010-06-12,Matt Wiman,Submission,0,0,0,0
Mac Danzig,2012-04-21,Efrain Escudero,Decision - Unanimous,80,11,0,91
Mac Danzig,2013-07-27,Melvin Guillard,KO/TKO,0,0,0,0
Mac Danzig,2007-02-24,Hayato Sakurai,KO/TKO,0,0,0,0
Mac Danzig,2011-10-01,Matt Wiman,Decision - Unanimous,0,0,0,0
Mac Danzig,2013-12-14,Joe Lauzon,Decision - Unanimous,0,9,0,9
Mac Danzig,2010-02-06,Justin Buchholz,Decision - Unanimous,80,32,0,112
Mac Danzig,2007-12-08,Tommy Speer,Submission,90,6,0,96
Mac Danzig,2012-11-10,Takanori Gomi,Decision - Split,0,10,0,10
Joaquim Silva,2022-10-01,Jesse Ronson,KO/TKO,100,6,0,106
Joaquim Silva,2019-08-03,Nasrat Haqparast,KO/TKO,0,0,0,0
Joaquim Silva,2018-01-27,Vinc Pichel,Decision - Unanimous,0,0,0,0
Joaquim Silva,2015-09-05,Nazareno Malegarie,Decision - Split,70,0,0,70
Joaquim Silva,2018-12-15,Jared Gordon,KO/TKO,100,0,0,100
Joaquim Silva,2016-07-08,Andrew Holbrook,KO/TKO,100,4,0,104
Joaquim Silva,2023-06-17,Arman Tsarukyan,KO/TKO,0,0,0,0
Joaquim Silva,2024-05-04,Drakkar Klose,Decision - Unanimous,0,0,0,0
Joaquim Silva,2017-05-28,Reza Madadi,Decision - Split,70,14,0,84
Joaquim Silva,2023-12-02,Clay Guida,Decision - Unanimous,80,3,0,83
Joaquim Silva,2021-06-19,Ricky Glenn,KO/TKO,0,0,0,0
Jesse Ronson,2022-10-01,Joaquim Silva,KO/TKO,0,0,0,0
Jesse Ronson,2014-02-15,Francisco Trinaldo,Decision - Split,0,0,0,0
Jesse Ronson,2014-07-06,Kevin Lee,Decision - Split,0,0,0,0
Jesse Ronson,2013-09-21,Michel Prazeres,Decision - Split,0,19,0,19
Jesse Ronson,2022-04-16,Rafa Garcia,Submission,0,0,0,0
Daniel Zellhuber,2024-02-24,Francisco Prado,Decision - Unanimous,80,30,0,110
Daniel Zellhuber,2023-04-15,Lando Vannata,Decision - Unanimous,80,27,0,107
Daniel Zellhuber,2021-09-28,Lucas Almeida,Decision - Unanimous,80,19,0,99
Daniel Zellhuber,2022-09-17,Trey Ogden,Decision - Unanimous,0,0,0,0
Daniel Zellhuber,2023-09-16,Christos Giagos,Submission,90,0,0,90
Daniel Zellhuber,2024-09-14,Esteban Ribovics,Decision - Split,0,0,0,0
Francisco Prado,2024-02-24,Daniel Zellhuber,Decision - Unanimous,0,0,0,0
Francisco Prado,2023-07-15,Ottman Azaitar,KO/TKO,100,24,0,124
Francisco Prado,2023-02-11,Jamie Mullarkey,Decision - Unanimous,0,0,0,0
Kai Kara-France,2020-02-22,Tyson Nam,Decision - Unanimous,80,28,0,108
Kai Kara-France,2023-06-03,Amir Albazi,Decision - Split,0,56,25,81
Kai Kara-France,2018-12-01,Elias Garcia,Decision - Unanimous,80,70,0,150
Kai Kara-France,2024-08-17,Steve Erceg,KO/TKO,100,9,0,109
Kai Kara-France,2019-08-31,Mark De La Rosa,Decision - Unanimous,80,31,0,111
Kai Kara-France,2020-09-26,Brandon Royval,Submission,0,0,0,0
Kai Kara-France,2021-03-06,Rogerio Bontorin,KO/TKO,100,7,0,107
Kai Kara-France,2021-12-11,Cody Garbrandt,KO/TKO,100,14,0,114
Kai Kara-France,2022-07-30,Brandon Moreno,KO/TKO,0,0,25,25
Kai Kara-France,2019-02-09,Raulian Paiva,Decision - Split,70,0,0,70
Kai Kara-France,2022-03-26,Askar Askarov,Decision - Unanimous,80,24,0,104
Kai Kara-France,2019-12-14,Brandon Moreno,Decision - Unanimous,0,0,0,0
Tyson Nam,2020-02-22,Kai Kara-France,Decision - Unanimous,0,0,0,0
Tyson Nam,2020-06-13,Zarrukh Adashev,KO/TKO,100,0,0,100
Tyson Nam,2023-07-15,Azat Maksum,Decision - Split,0,35,0,35
Tyson Nam,2019-09-21,Sergio Pettis,Decision - Unanimous,0,0,0,0
Tyson Nam,2023-03-11,Bruno Silva,Submission,0,0,0,0
Tyson Nam,2021-01-20,Matt Schnell,Decision - Split,0,0,0,0
Tyson Nam,2020-09-19,Jerome Rivera,KO/TKO,100,6,0,106
Tyson Nam,2022-08-13,Ode Osbourne,KO/TKO,100,0,0,100
Zabit Magomedsharipov,2017-09-02,Mike Santiago,Submission,90,21,0,111
Zabit Magomedsharipov,2019-11-09,Calvin Kattar,Decision - Unanimous,80,16,0,96
Zabit Magomedsharipov,2019-03-02,Jeremy Stephens,Decision - Unanimous,80,29,0,109
Zabit Magomedsharipov,2018-09-08,Brandon Davis,Submission,90,11,0,101
Zabit Magomedsharipov,2018-04-07,Kyle Bochniak,Decision - Unanimous,80,54,0,134
Zabit Magomedsharipov,2017-11-25,Sheymon Moraes,Submission,90,16,0,106
Mike Santiago,2017-09-02,Zabit Magomedsharipov,Submission,0,0,0,0
Mike Santiago,2018-06-09,Dan Ige,KO/TKO,0,0,0,0
Mike Santiago,2018-01-14,Mads Burnell,Decision - Unanimous,0,31,0,31
Mike Santiago,2017-08-22,Mark Cherico,KO/TKO,100,11,0,111
Rory MacDonald,2015-07-11,Robbie Lawler,KO/TKO,0,16,25,41
Rory MacDonald,2014-06-14,Tyron Woodley,Decision - Unanimous,80,23,0,103
Rory MacDonald,2011-08-06,Mike Pyle,KO/TKO,100,21,0,121
Rory MacDonald,2016-06-18,Stephen Thompson,Decision - Unanimous,0,0,25,25
Rory MacDonald,2011-04-30,Nate Diaz,Decision - Unanimous,80,16,0,96
Rory MacDonald,2013-11-16,Robbie Lawler,Decision - Split,0,0,0,0
Rory MacDonald,2014-10-04,Tarec Saffiedine,KO/TKO,100,5,25,130
Rory MacDonald,2012-04-21,Che Mills,KO/TKO,100,41,0,141
Rory MacDonald,2013-07-27,Jake Ellenberger,Decision - Unanimous,80,27,0,107
Rory MacDonald,2012-12-08,BJ Penn,Decision - Unanimous,80,92,0,172
Rory MacDonald,2014-02-22,Demian Maia,Decision - Unanimous,80,24,0,104
Rory MacDonald,2010-01-11,Mike Guymon,Submission,90,2,0,92
Rory MacDonald,2010-06-12,Carlos Condit,KO/TKO,0,0,0,0
Arman Tsarukyan,2020-07-18,Davi Ramos,Decision - Unanimous,80,58,0,138
Arman Tsarukyan,2022-12-17,Damir Ismagulov,Decision - Unanimous,80,0,0,80
Arman Tsarukyan,2023-12-02,Beneil Dariush,KO/TKO,100,6,25,131
Arman Tsarukyan,2021-01-23,Matt Frevola,Decision - Unanimous,80,34,0,114
Arman Tsarukyan,2022-02-26,Joel Alvarez,KO/TKO,100,29,0,129
Arman Tsarukyan,2019-07-27,Olivier Aubin-Mercier,Decision - Unanimous,80,24,0,104
Arman Tsarukyan,2023-06-17,Joaquim Silva,KO/TKO,100,57,0,157
Arman Tsarukyan,2022-06-25,Mateusz Gamrot,Decision - Unanimous,0,14,25,39
Arman Tsarukyan,2021-09-18,Christos Giagos,KO/TKO,100,21,0,121
Arman Tsarukyan,2019-04-20,Islam Makhachev,Decision - Unanimous,0,0,0,0
Arman Tsarukyan,2024-04-13,Charles Oliveira,Decision - Split,70,30,0,100
Dricus Du Plessis,2022-12-10,Darren Till,Submission,90,51,0,141
Dricus Du Plessis,2020-10-10,Markus Perez,KO/TKO,100,12,0,112
Dricus Du Plessis,2023-03-04,Derek Brunson,KO/TKO,100,34,0,134
Dricus Du Plessis,2021-07-10,Trevin Giles,KO/TKO,100,15,0,115
Dricus Du Plessis,2024-08-17,Israel Adesanya,Submission,90,0,25,115
Dricus Du Plessis,2022-07-02,Brad Tavares,Decision - Unanimous,80,31,0,111
Dricus Du Plessis,2023-07-08,Robert Whittaker,KO/TKO,100,31,0,131
Dricus Du Plessis,2024-01-20,Sean Strickland,Decision - Split,70,0,25,95
Darren Till,2022-12-10,Dricus Du Plessis,Submission,0,0,0,0
Darren Till,2018-05-27,Stephen Thompson,Decision - Unanimous,80,8,25,113
Darren Till,2019-03-16,Jorge Masvidal,KO/TKO,0,0,25,25
Darren Till,2018-09-08,Tyron Woodley,Submission,0,0,25,25
Darren Till,2017-09-02,Bojan Velickovic,Decision - Unanimous,80,15,0,95
Darren Till,2017-10-21,Donald Cerrone,KO/TKO,100,10,25,135
Darren Till,2019-11-02,Kelvin Gastelum,Decision - Split,70,0,0,70
Darren Till,2015-05-30,Wendell Oliveira Marques,KO/TKO,100,3,0,103
Darren Till,2017-05-28,Jessin Ayari,Decision - Unanimous,80,3,0,83
Darren Till,2021-09-04,Derek Brunson,Submission,0,0,25,25
Darren Till,2020-07-25,Robert Whittaker,Decision - Unanimous,0,0,25,25
Nick Fiore,2023-05-20,Chase Hooper,Decision - Unanimous,0,0,0,0
Nick Fiore,2023-01-14,Mateusz Rebecki,Decision - Unanimous,0,0,0,0
Junie Browning,2008-12-13,David Kaplan,Submission,90,19,0,109
Junie Browning,2009-04-01,Cole Miller,Submission,0,0,0,0
David Kaplan,2008-12-13,Junie Browning,Submission,0,0,0,0
David Kaplan,2009-05-23,George Roop,Decision - Split,0,0,0,0
Bill Algeo,2024-07-20,Dooho Choi,KO/TKO,0,0,0,0
Bill Algeo,2023-10-07,Alexander Hernandez,Decision - Unanimous,80,35,0,115
Bill Algeo,2023-04-15,TJ Brown,Submission,90,18,0,108
Bill Algeo,2021-05-22,Ricardo Ramos,Decision - Unanimous,0,23,0,23
Bill Algeo,2022-09-17,Andre Fili,Decision - Split,0,22,0,22
Bill Algeo,2019-06-18,Brendan Loughnane,Decision - Unanimous,0,35,0,35
Bill Algeo,2024-03-30,Kyle Nelson,KO/TKO,0,0,0,0
Bill Algeo,2022-01-15,Joanderson Brito,Decision - Unanimous,80,19,0,99
Bill Algeo,2022-07-16,Herbert Burns,KO/TKO,100,18,0,118
Bill Algeo,2020-08-29,Ricardo Lamas,Decision - Unanimous,0,0,0,0
Bill Algeo,2020-11-28,Spike Carlyle,Decision - Unanimous,80,47,0,127
Dos Caras Jr.,2004-02-01,Kazuhiro Nakamura,Decision - Unanimous,0,0,0,0
Dos Caras Jr.,2003-10-05,Mirko Filipovic,KO/TKO,0,0,0,0
Matt Dwyer,2015-02-22,William Macario,KO/TKO,100,5,0,105
Matt Dwyer,2014-10-04,Albert Tumenov,KO/TKO,0,0,0,0
Matt Dwyer,2015-07-15,Alan Jouban,Decision - Unanimous,0,0,0,0
Matt Dwyer,2016-01-30,Randy Brown,Decision - Unanimous,0,0,0,0
William Macario,2015-02-22,Matt Dwyer,KO/TKO,0,0,0,0
William Macario,2014-10-25,Neil Magny,KO/TKO,0,0,0,0
William Macario,2013-06-08,Leonardo Santos,Submission,0,13,0,13
William Macario,2013-12-28,Bobby Voelker,Decision - Unanimous,80,72,0,152
Matt Hamill,2010-10-23,Tito Ortiz,Decision - Unanimous,80,4,0,84
Matt Hamill,2008-04-02,Tim Boetsch,KO/TKO,100,13,0,113
Matt Hamill,2008-09-06,Rich Franklin,KO/TKO,0,0,0,0
Matt Hamill,2013-10-09,Thiago Silva,Decision - Unanimous,0,0,0,0
Matt Hamill,2011-05-28,Quinton Jackson,Decision - Unanimous,0,0,0,0
Matt Hamill,2007-03-03,Rex Holman,KO/TKO,100,18,0,118
Matt Hamill,2009-03-07,Mark Munoz,KO/TKO,100,9,0,109
Matt Hamill,2006-10-10,Seth Petruzelli,Decision - Unanimous,80,0,0,80
Matt Hamill,2007-09-08,Michael Bisping,Decision - Split,0,9,0,9
Matt Hamill,2008-12-27,Reese Andy,KO/TKO,100,6,0,106
Matt Hamill,2011-08-06,Alexander Gustafsson,KO/TKO,0,0,0,0
Matt Hamill,2009-12-05,Jon Jones,DQ,0,0,0,0
Matt Hamill,2012-09-22,Roger Hollett,Decision - Unanimous,80,68,0,148
Matt Hamill,2006-06-24,Jesse Forbes,KO/TKO,100,24,0,124
Matt Hamill,2010-06-19,Keith Jardine,Decision - Majority,75,12,0,87
Anthony Perosh,2012-07-21,Ryan Jimmo,KO/TKO,0,0,0,0
Anthony Perosh,2010-02-20,Mirko Filipovic,TKO - Doctor's Stoppage,0,0,0,0
Anthony Perosh,2011-02-26,Tom Blackledge,Submission,90,0,0,90
Anthony Perosh,2011-11-05,Cyrille Diabate,Submission,90,0,0,90
Anthony Perosh,2013-12-06,Ryan Bader,Decision - Unanimous,0,0,0,0
Anthony Perosh,2006-07-08,Jeff Monson,KO/TKO,0,0,0,0
Anthony Perosh,2012-03-02,Nick Penner,KO/TKO,100,20,0,120
Anthony Perosh,2014-11-07,Guto Inocente,Submission,90,10,0,100
Anthony Perosh,2006-12-30,Christian Wellisch,Decision - Unanimous,0,0,0,0
Anthony Perosh,2013-08-03,Vinny Magalhaes,KO/TKO,100,7,0,107
Anthony Perosh,2015-11-14,Gian Villante,KO/TKO,0,0,0,0
Anthony Perosh,2015-05-09,Sean O'Connell,KO/TKO,0,0,0,0
Tom Aspinall,2024-07-27,Curtis Blaydes,KO/TKO,100,9,25,134
Tom Aspinall,2020-10-10,Alan Baudot,KO/TKO,100,13,0,113
Tom Aspinall,2023-11-11,Sergei Pavlovich,KO/TKO,100,9,25,134
Tom Aspinall,2022-07-23,Curtis Blaydes,KO/TKO,0,0,25,25
Tom Aspinall,2021-09-04,Serghei Spivac,KO/TKO,100,16,0,116
Tom Aspinall,2023-07-22,Marcin Tybura,KO/TKO,100,9,25,134
Tom Aspinall,2020-07-25,Jake Collier,KO/TKO,100,7,0,107
Tom Aspinall,2021-02-20,Andrei Arlovski,Submission,90,17,0,107
Tom Aspinall,2022-03-19,Alexander Volkov,Submission,90,16,25,131
Trey Waters,2024-05-11,Billy Ray Goff,Decision - Unanimous,80,0,0,80
Trey Waters,2023-04-29,Josh Quinlan,Decision - Unanimous,80,54,0,134
Trey Waters,2022-09-06,Gabriel Bonfim,Submission,0,0,0,0
Billy Ray Goff,2024-05-11,Trey Waters,Decision - Unanimous,0,20,0,20
Billy Ray Goff,2023-08-26,Yusaku Kinoshita,KO/TKO,100,23,0,123
Billy Ray Goff,2022-08-02,Shimon Smotritsky,KO/TKO,100,21,0,121
Brad Pickett,2010-12-16,Ivan Menjivar,Decision - Unanimous,80,0,0,80
Brad Pickett,2014-03-08,Neil Seery,Decision - Unanimous,80,2,0,82
Brad Pickett,2015-07-11,Thomas Almeida,KO/TKO,0,0,0,0
Brad Pickett,2013-08-17,Michael McDonald,Submission,0,0,0,0
Brad Pickett,2010-04-24,Demetrious Johnson,Decision - Unanimous,80,0,0,80
Brad Pickett,2012-04-14,Damacio Page,Submission,90,13,0,103
Brad Pickett,2016-02-27,Francisco Rivera,Decision - Split,70,0,0,70
Brad Pickett,2012-12-29,Eddie Wineland,Decision - Split,0,0,0,0
Brad Pickett,2013-04-06,Mike Easton,Decision - Split,70,0,0,70
Brad Pickett,2011-11-05,Renan Barao,Submission,0,0,0,0
Brad Pickett,2016-10-08,Iuri Alcantara,Submission,0,0,0,0
Brad Pickett,2016-12-17,Urijah Faber,Decision - Unanimous,0,0,0,0
Brad Pickett,2009-12-19,Kyle Dietz,Submission,90,6,0,96
Brad Pickett,2012-09-29,Yves Jabouin,KO/TKO,100,0,0,100
Brad Pickett,2010-08-18,Scott Jorgensen,Decision - Unanimous,0,0,0,0
Brad Pickett,2017-03-18,Marlon Vera,KO/TKO,0,0,0,0
Brad Pickett,2014-07-19,Ian McCall,Decision - Unanimous,0,0,0,0
Brad Pickett,2014-11-22,Chico Camus,Decision - Split,0,0,0,0
Ivan Menjivar,2010-12-16,Brad Pickett,Decision - Unanimous,0,15,0,15
Ivan Menjivar,2013-09-21,Wilson Reis,Decision - Unanimous,0,0,0,0
Ivan Menjivar,2011-08-06,Nick Pace,Decision - Unanimous,80,30,0,110
Ivan Menjivar,2012-11-17,Azamat Gashimov,Submission,90,2,0,92
Ivan Menjivar,2013-02-23,Urijah Faber,Submission,0,0,0,0
Ivan Menjivar,2012-02-15,John Albert,Submission,90,0,0,90
Ivan Menjivar,2011-04-30,Charlie Valencia,KO/TKO,100,3,0,103
Ivan Menjivar,2014-03-01,Hatsu Hioki,Decision - Unanimous,0,0,0,0
Ivan Menjivar,2002-01-25,Georges St-Pierre,KO/TKO,0,0,0,0
Ivan Menjivar,2004-06-19,Matt Serra,Decision - Unanimous,0,0,0,0
Ivan Menjivar,2012-07-07,Mike Easton,Decision - Unanimous,0,0,0,0
Trevin Jones,2023-03-04,Cody Garbrandt,Decision - Unanimous,0,0,0,0
Trevin Jones,2021-08-21,Saidyokub Kakhramonov,Submission,0,0,0,0
Trevin Jones,2021-03-06,Mario Bautista,KO/TKO,100,2,0,102
Trevin Jones,2022-03-12,Javid Basharat,Decision - Unanimous,0,0,0,0
Trevin Jones,2022-10-01,Raoni Barcelos,Decision - Unanimous,0,0,0,0
Nick Pace,2010-09-30,Demetrious Johnson,Decision - Unanimous,0,0,0,0
Nick Pace,2011-08-06,Ivan Menjivar,Decision - Unanimous,0,0,0,0
Nick Pace,2010-12-04,Will Campuzano,Submission,90,2,0,92
Nick Pace,2011-11-19,Miguel Torres,Decision - Unanimous,0,0,0,0
Kazushi Sakuraba,1997-12-21,Marcus Silveira,Submission,90,0,0,90
Kazushi Sakuraba,2002-11-24,Gilles Arsene,Submission,90,41,0,131
Kazushi Sakuraba,2003-03-16,Antonio Schembri,KO/TKO,0,15,0,15
Kazushi Sakuraba,1999-07-04,Ebenezer Fontes Braga,Submission,90,9,0,99
Kazushi Sakuraba,2007-09-17,Katsuyori Shibata,Submission,90,8,0,98
Kazushi Sakuraba,2000-05-01,Royce Gracie,KO/TKO,100,1,0,101
Kazushi Sakuraba,2007-03-12,Yurij Kiseliov,Submission,90,0,0,90
Kazushi Sakuraba,2009-10-06,Rubin Williams,Submission,90,4,0,94
Kazushi Sakuraba,2003-11-09,Kevin Randleman,Submission,90,0,0,90
Kazushi Sakuraba,2000-05-01,Igor Vovchanchyn,KO/TKO,0,0,0,0
Kazushi Sakuraba,2009-10-25,Zelg Galesic,Submission,90,0,0,90
Kazushi Sakuraba,1999-09-12,Anthony Macias,Submission,90,13,0,103
Kazushi Sakuraba,2005-06-26,Ricardo Arona,KO/TKO,0,0,0,0
Kazushi Sakuraba,2008-12-31,Kiyoshi Tamura,Decision - Unanimous,0,0,0,0
Kazushi Sakuraba,2000-08-27,Renzo Gracie,Submission,90,2,0,92
Kazushi Sakuraba,2005-10-23,Ken Shamrock,KO/TKO,100,4,0,104
Kazushi Sakuraba,1998-03-05,Vernon White,Submission,90,0,0,90
Kazushi Sakuraba,2010-09-25,Jason Miller,Submission,0,0,0,0
Kazushi Sakuraba,2001-07-29,Quinton Jackson,Submission,90,0,0,90
Kazushi Sakuraba,2003-12-31,Rogerio Nogueira,Decision - Unanimous,0,0,0,0
Kazushi Sakuraba,2000-01-30,Guy Mezger,Other,0,0,0,0
Kazushi Sakuraba,2002-08-28,Mirko Filipovic,TKO - Doctor's Stoppage,0,0,0,0
Kazushi Sakuraba,2010-12-31,Marius Zaromskis,TKO - Doctor's Stoppage,0,1,0,1
Kazushi Sakuraba,2004-06-20,Antonio Schembri,Decision - Unanimous,80,25,0,105
Kazushi Sakuraba,2005-04-23,Dong Sik Yoon,KO/TKO,100,5,0,105
Kazushi Sakuraba,2011-09-24,Yan Cabral,Submission,0,0,0,0
Kazushi Sakuraba,2005-12-31,Ikuhisa Minowa,Submission,90,1,0,91
Kazushi Sakuraba,2008-04-29,Andrews Nakahara,Submission,90,0,0,90
Kazushi Sakuraba,1999-11-21,Royler Gracie,Submission,90,47,0,137
Kazushi Sakuraba,2008-06-15,Melvin Manhoef,KO/TKO,0,0,0,0
Kazushi Sakuraba,2006-08-05,Kestutis Smirnovas,Submission,90,0,0,90
Kazushi Sakuraba,2007-12-31,Masakatsu Funaki,Submission,90,5,0,95
Kazushi Sakuraba,2007-06-02,Royce Gracie,Decision - Unanimous,0,0,0,0
Kazushi Sakuraba,1999-04-29,Vitor Belfort,Decision - Unanimous,80,44,0,124
Kazushi Sakuraba,2000-10-31,Shannon Ritch,Submission,90,1,0,91
Kazushi Sakuraba,2001-11-03,Wanderlei Silva,TKO - Doctor's Stoppage,0,0,0,0
Kazushi Sakuraba,2001-03-25,Wanderlei Silva,KO/TKO,0,0,0,0
Kazushi Sakuraba,2003-08-10,Wanderlei Silva,KO/TKO,0,0,0,0
Kazushi Sakuraba,2000-12-09,Ryan Gracie,Decision - Unanimous,80,4,0,84
Kazushi Sakuraba,2010-05-29,Ralek Gracie,Decision - Unanimous,0,0,0,0
Kazushi Sakuraba,1998-06-24,Carlos Newton,Submission,90,0,0,90
Marcus Silveira,1997-12-21,Kazushi Sakuraba,Submission,0,0,0,0
Zhang Weili,2019-03-02,Tecia Pennington,Decision - Unanimous,80,33,0,113
Zhang Weili,2020-03-07,Joanna Jedrzejczyk,Decision - Split,70,0,25,95
Zhang Weili,2018-11-24,Jessica Aguilar,Submission,90,36,0,126
Zhang Weili,2022-11-12,Carla Esparza,Submission,90,31,25,146
Zhang Weili,2023-08-19,Amanda Lemos,Decision - Unanimous,80,139,25,244
Zhang Weili,2021-04-24,Rose Namajunas,KO/TKO,0,2,25,27
Zhang Weili,2024-04-13,Yan Xiaonan,Decision - Unanimous,80,63,25,168
Zhang Weili,2018-08-04,Danielle Taylor,Decision - Unanimous,80,43,0,123
Zhang Weili,2022-06-11,Joanna Jedrzejczyk,KO/TKO,100,26,0,126
Zhang Weili,2019-08-31,Jessica Andrade,KO/TKO,100,25,25,150
Zhang Weili,2021-11-06,Rose Namajunas,Decision - Split,0,0,25,25
Todd Moore,2008-09-23,Shinya Aoki,Submission,0,0,0,0
Todd Moore,2007-12-12,John Alessio,Decision - Unanimous,0,0,0,0
Todd Moore,2008-08-03,Shane Roller,Submission,0,10,0,10
Loma Lookboonmee,2022-09-17,Denise Gomes,Decision - Unanimous,80,29,0,109
Loma Lookboonmee,2021-05-01,Sam Hughes,Decision - Unanimous,80,35,0,115
Loma Lookboonmee,2024-02-10,Bruna Brasil,Decision - Unanimous,80,30,0,110
Loma Lookboonmee,2020-02-22,Angela Hill,Decision - Unanimous,0,5,0,5
Loma Lookboonmee,2020-10-03,Jinh Yu Frey,Decision - Unanimous,80,54,0,134
Loma Lookboonmee,2023-02-11,Elise Reed,Submission,90,0,0,90
Loma Lookboonmee,2019-10-26,Aleksandra Albu,Decision - Split,70,34,0,104
Loma Lookboonmee,2021-11-20,Loopy Godinez,Decision - Unanimous,0,0,0,0
Neil Magny,2016-08-20,Lorenz Larkin,KO/TKO,0,0,0,0
Neil Magny,2020-03-07,Li Jingliang,Decision - Unanimous,80,58,0,138
Neil Magny,2015-11-21,Kelvin Gastelum,Decision - Split,70,0,25,95
Neil Magny,2014-10-25,William Macario,KO/TKO,100,41,0,141
Neil Magny,2023-06-24,Phil Rowe,Decision - Split,70,0,0,70
Neil Magny,2017-12-30,Carlos Condit,Decision - Unanimous,80,0,0,80
Neil Magny,2017-09-09,Rafael Dos Anjos,Submission,0,0,0,0
Neil Magny,2022-11-05,Daniel Rodriguez,Submission,90,0,0,90
Neil Magny,2024-08-24,Michael Morales,KO/TKO,0,0,0,0
Neil Magny,2016-12-30,Johny Hendricks,Decision - Unanimous,80,32,0,112
Neil Magny,2016-03-19,Hector Lombard,KO/TKO,100,88,0,188
Neil Magny,2024-01-20,Mike Malott,KO/TKO,100,12,0,112
Neil Magny,2014-08-23,Alex Garcia,Decision - Unanimous,80,34,0,114
Neil Magny,2013-02-23,Jon Manley,Decision - Unanimous,80,48,0,128
Neil Magny,2020-06-06,Anthony Rocco Martin,Decision - Unanimous,80,27,0,107
Neil Magny,2020-08-29,Robbie Lawler,Decision - Unanimous,80,36,0,116
Neil Magny,2018-11-17,Santiago Ponzinibbio,KO/TKO,0,0,25,25
Neil Magny,2014-02-01,Gasan Umalatov,Decision - Unanimous,80,37,0,117
Neil Magny,2023-08-19,Ian Machado Garry,Decision - Unanimous,0,0,0,0
Neil Magny,2024-11-09,Carlos Prates,KO/TKO,0,0,25,25
Neil Magny,2021-01-20,Michael Chiesa,Decision - Unanimous,0,0,25,25
Neil Magny,2013-11-06,Seth Baczynski,Decision - Unanimous,0,3,0,3
Neil Magny,2018-05-27,Craig White,KO/TKO,100,12,0,112
Neil Magny,2022-03-26,Max Griffin,Decision - Split,70,0,0,70
Neil Magny,2022-06-25,Shavkat Rakhmonov,Submission,0,0,0,0
Neil Magny,2013-08-03,Sergio Moraes,Submission,0,0,0,0
Neil Magny,2015-08-23,Erick Silva,Decision - Split,70,39,0,109
Neil Magny,2014-06-28,Rodrigo de Lima,KO/TKO,100,25,0,125
Neil Magny,2023-01-21,Gilbert Burns,Submission,0,0,0,0
Neil Magny,2015-08-01,Demian Maia,Submission,0,0,0,0
Neil Magny,2021-05-08,Geoff Neal,Decision - Unanimous,80,20,0,100
Neil Magny,2015-05-16,Hyun Gyu Lim,KO/TKO,100,28,0,128
Neil Magny,2014-05-10,Tim Means,Decision - Unanimous,80,0,0,80
Neil Magny,2015-02-14,Kiichi Kunimoto,Submission,90,66,0,156
Ernie Verdicia,1995-04-07,Oleg Taktarov,Submission,0,2,0,2
Ilia Topuria,2024-10-26,Max Holloway,KO/TKO,100,0,25,125
Ilia Topuria,2023-06-24,Josh Emmett,Decision - Unanimous,80,65,25,170
Ilia Topuria,2024-02-17,Alexander Volkanovski,KO/TKO,100,0,25,125
Ilia Topuria,2020-12-05,Damon Jackson,KO/TKO,100,15,0,115
Ilia Topuria,2022-03-19,Jai Herbert,KO/TKO,100,0,0,100
Ilia Topuria,2022-12-10,Bryce Mitchell,Submission,90,4,0,94
Ilia Topuria,2020-10-10,Youssef Zalal,Decision - Unanimous,80,0,0,80
Ilia Topuria,2021-07-10,Ryan Hall,KO/TKO,100,8,0,108
Punahele Soriano,2022-07-16,Dalcha Lungiambula,KO/TKO,100,6,0,106
Punahele Soriano,2023-01-14,Roman Kopylov,KO/TKO,0,0,0,0
Punahele Soriano,2022-02-05,Nick Maximov,Decision - Split,0,16,0,16
Punahele Soriano,2021-07-24,Brendan Allen,Decision - Unanimous,0,0,0,0
Punahele Soriano,2024-06-08,Miguel Baeza,Decision - Unanimous,80,137,0,217
Punahele Soriano,2021-01-16,Dusko Todorovic,KO/TKO,100,8,0,108
Punahele Soriano,2019-12-14,Oskar Piechota,KO/TKO,100,18,0,118
Punahele Soriano,2023-12-02,Dustin Stoltzfus,Submission,0,0,0,0
Punahele Soriano,2019-06-18,Jamie Pickett,Decision - Unanimous,80,11,0,91
Dalcha Lungiambula,2022-07-16,Punahele Soriano,KO/TKO,0,0,0,0
Dalcha Lungiambula,2021-09-04,Marc-Andre Barriault,Decision - Unanimous,0,0,0,0
Dalcha Lungiambula,2022-03-12,Cody Brundage,Submission,0,25,0,25
Dalcha Lungiambula,2019-06-29,Dequan Townsend,KO/TKO,100,19,0,119
Dalcha Lungiambula,2021-01-20,Markus Perez,Decision - Unanimous,80,4,0,84
Dalcha Lungiambula,2022-12-10,Edmen Shahbazyan,KO/TKO,0,0,0,0
Dalcha Lungiambula,2019-11-09,Magomed Ankalaev,KO/TKO,0,0,0,0
Rameau Thierry Sokoudjou,2009-12-31,Ikuhisa Minowa,KO/TKO,0,23,0,23
Rameau Thierry Sokoudjou,2007-04-08,Ricardo Arona,KO/TKO,100,7,0,107
Rameau Thierry Sokoudjou,2009-11-07,Gegard Mousasi,KO/TKO,0,0,0,0
Rameau Thierry Sokoudjou,2007-02-24,Rogerio Nogueira,KO/TKO,100,5,0,105
Rameau Thierry Sokoudjou,2009-01-24,Renato Sobral,Submission,0,0,0,0
Rameau Thierry Sokoudjou,2008-10-18,Luiz Cane,KO/TKO,0,0,0,0
Rameau Thierry Sokoudjou,2009-10-06,Bob Sapp,KO/TKO,100,6,0,106
Rameau Thierry Sokoudjou,2007-12-29,Lyoto Machida,Submission,0,0,0,0
Rameau Thierry Sokoudjou,2006-10-12,Glover Teixeira,KO/TKO,0,0,0,0
Rameau Thierry Sokoudjou,2009-05-26,Jan Nortje,KO/TKO,100,17,0,117
Rameau Thierry Sokoudjou,2008-05-24,Kazuhiro Nakamura,KO/TKO,100,20,0,120
Tom Erikson,2002-02-24,Tim Catalfo,Submission,90,1,0,91
Tom Erikson,1999-11-21,Gary Goodridge,Decision - Unanimous,80,25,0,105
Tom Erikson,2005-02-20,Fabricio Werdum,Submission,0,0,0,0
Tom Erikson,2000-10-31,Heath Herring,Submission,0,1,0,1
Tom Erikson,2001-11-03,Matt Skelton,Submission,90,1,0,91
Tim Catalfo,2002-02-24,Tom Erikson,Submission,0,0,0,0
Karlos Vemola,2010-11-13,Seth Petruzelli,KO/TKO,100,15,0,115
Karlos Vemola,2012-07-11,Francis Carmont,Submission,0,0,0,0
Karlos Vemola,2011-08-14,Ronny Markes,Decision - Unanimous,0,0,0,0
Karlos Vemola,2012-05-05,Mike Massenzio,Submission,90,5,0,95
Karlos Vemola,2010-07-03,Jon Madsen,Decision - Unanimous,0,0,0,0
Karlos Vemola,2013-06-08,Caio Magalhaes,Submission,0,9,0,9
Seth Petruzelli,2010-11-13,Karlos Vemola,KO/TKO,0,0,0,0
Seth Petruzelli,2007-04-05,Wilson Gouveia,Submission,0,0,0,0
Seth Petruzelli,2006-10-10,Matt Hamill,Decision - Unanimous,0,11,0,11
Seth Petruzelli,2008-10-04,Kevin Ferguson,KO/TKO,100,5,0,105
Seth Petruzelli,2010-07-03,Ricardo Romero,Submission,0,11,0,11
Sean Woodson,2024-12-14,Fernando Padilla,KO/TKO,100,16,0,116
Sean Woodson,2021-11-13,Collin Anglin,KO/TKO,100,42,0,142
Sean Woodson,2019-10-18,Kyle Bochniak,Decision - Unanimous,80,69,0,149
Sean Woodson,2024-05-11,Alex Caceres,Decision - Unanimous,80,19,0,99
Sean Woodson,2020-06-27,Julian Erosa,Submission,0,3,0,3
Sean Woodson,2021-06-05,Youssef Zalal,Decision - Split,70,0,0,70
Sean Woodson,2019-07-23,Terrance McKinney,KO/TKO,100,0,0,100
Sean Woodson,2023-08-05,Dennis Buzukja,Decision - Unanimous,80,29,0,109
Sean Woodson,2024-01-20,Charles Jourdain,Decision - Split,70,20,0,90
Fernando Padilla,2024-12-14,Sean Woodson,KO/TKO,0,0,0,0
Fernando Padilla,2023-04-29,Julian Erosa,KO/TKO,100,5,0,105
Fernando Padilla,2023-09-16,Kyle Nelson,Decision - Unanimous,0,0,0,0
Fernando Padilla,2024-03-23,Luis Pajuelo,Submission,90,29,0,119
Bec Rawlings,2017-02-04,Tecia Pennington,Decision - Unanimous,0,0,0,0
Bec Rawlings,2015-05-09,Lisa Ellis,Submission,90,14,0,104
Bec Rawlings,2016-03-19,Seo Hee Ham,Decision - Unanimous,80,0,0,80
Bec Rawlings,2014-12-12,Heather Clark,Decision - Unanimous,0,13,0,13
Bec Rawlings,2018-04-07,Ashlee Evans-Smith,Decision - Unanimous,0,0,0,0
Bec Rawlings,2017-11-18,Jessica-Rose Clark,Decision - Split,0,0,0,0
Bec Rawlings,2016-08-27,Paige VanZant,KO/TKO,0,0,0,0
Rickson Gracie,1998-10-11,Nobuhiko Takada,Submission,90,0,0,90
Rickson Gracie,1997-10-11,Nobuhiko Takada,Submission,90,14,0,104
Nobuhiko Takada,1998-10-11,Rickson Gracie,Submission,0,4,0,4
Nobuhiko Takada,2000-01-30,Royce Gracie,Decision - Unanimous,0,0,0,0
Nobuhiko Takada,1999-07-04,Mark Kerr,Submission,0,0,0,0
Nobuhiko Takada,1998-06-24,Kyle Sturgeon,Submission,90,0,0,90
Nobuhiko Takada,1999-04-29,Mark Coleman,Submission,90,0,0,90
Nobuhiko Takada,2000-10-31,Igor Vovchanchyn,KO/TKO,0,0,0,0
Nobuhiko Takada,1997-10-11,Rickson Gracie,Submission,0,0,0,0
Nobuhiko Takada,2002-11-24,Kiyoshi Tamura,KO/TKO,0,0,0,0
Carlos Zevallos,2008-10-03,Andre Walker,KO/TKO,100,10,0,110
Andre Walker,2008-10-03,Carlos Zevallos,KO/TKO,0,0,0,0
Gegard Mousasi,2016-10-08,Vitor Belfort,KO/TKO,100,49,0,149
Gegard Mousasi,2010-09-25,Tatsuya Mizuno,Submission,90,15,0,105
Gegard Mousasi,2009-11-07,Rameau Thierry Sokoudjou,KO/TKO,100,42,0,142
Gegard Mousasi,2008-03-02,Steve Mensing,KO/TKO,100,26,0,126
Gegard Mousasi,2006-11-05,Hector Lombard,Decision - Unanimous,80,20,0,100
Gegard Mousasi,2008-06-15,Dong Sik Yoon,Decision - Unanimous,80,52,0,132
Gegard Mousasi,2006-06-04,Makoto Takimoto,TKO - Doctor's Stoppage,0,13,0,13
Gegard Mousasi,2015-01-24,Dan Henderson,KO/TKO,100,0,0,100
Gegard Mousasi,2016-11-19,Uriah Hall,KO/TKO,100,8,25,133
Gegard Mousasi,2016-02-27,Thales Leites,Decision - Unanimous,80,64,0,144
Gegard Mousasi,2014-02-15,Lyoto Machida,Decision - Unanimous,0,8,25,33
Gegard Mousasi,2017-04-08,Chris Weidman,KO/TKO,100,36,0,136
Gegard Mousasi,2005-10-09,Stefan Klever,KO/TKO,100,11,0,111
Gegard Mousasi,2014-09-05,Jacare Souza,Submission,0,0,25,25
Gegard Mousasi,2016-07-09,Thiago Santos,KO/TKO,100,16,0,116
Gegard Mousasi,2011-12-17,Ovince Saint Preux,Decision - Unanimous,80,26,0,106
Gegard Mousasi,2013-01-12,Mike Kyle,Submission,90,16,0,106
Gegard Mousasi,2015-09-26,Uriah Hall,KO/TKO,0,0,0,0
Gegard Mousasi,2009-12-31,Gary Goodridge,KO/TKO,100,17,0,117
Gegard Mousasi,2014-05-31,Mark Munoz,Submission,90,15,25,130
Gegard Mousasi,2008-09-23,Melvin Manhoef,Submission,90,1,0,91
Gegard Mousasi,2006-08-27,Akihiro Gono,Submission,0,14,0,14
Gegard Mousasi,2005-12-02,Tsuyoshi Kurihara,KO/TKO,100,2,0,102
Gegard Mousasi,2010-07-10,Jake O'Brien,Submission,90,0,0,90
Gegard Mousasi,2008-02-01,Evangelista Santos,KO/TKO,100,19,0,119
Gegard Mousasi,2010-04-17,Muhammed Lawal,Decision - Unanimous,0,0,25,25
Gegard Mousasi,2008-09-23,Jacare Souza,KO/TKO,100,1,0,101
Gegard Mousasi,2013-04-06,Ilir Latifi,Decision - Unanimous,80,62,0,142
Gegard Mousasi,2008-04-29,Denis Kang,Submission,90,4,0,94
Gegard Mousasi,2009-05-26,Mark Hunt,Submission,90,5,0,95
Gegard Mousasi,2007-10-19,Damir Mirenic,KO/TKO,100,43,0,143
Gegard Mousasi,2015-05-16,Constantinos Philippou,Decision - Unanimous,80,47,0,127
Gegard Mousasi,2011-07-16,Hiroshi Izumi,KO/TKO,100,28,0,128
Gegard Mousasi,2009-08-15,Renato Sobral,KO/TKO,100,10,25,135
George Sullivan,2014-09-13,Igor Araujo,KO/TKO,100,35,0,135
George Sullivan,2014-01-25,Mike Rhodes,Decision - Unanimous,80,10,0,90
George Sullivan,2015-04-18,Tim Means,Submission,0,0,0,0
George Sullivan,2015-07-12,Dominic Waters,Decision - Unanimous,80,41,0,121
George Sullivan,2016-01-30,Alexander Yakovlev,KO/TKO,0,0,0,0
George Sullivan,2018-08-25,Mickey Gall,Submission,0,0,0,0
George Sullivan,2018-01-27,Niko Price,Submission,0,0,0,0
Igor Araujo,2014-09-13,George Sullivan,KO/TKO,0,0,0,0
Igor Araujo,2013-10-09,Ildemar Alcantara,Decision - Unanimous,80,3,0,83
Igor Araujo,2014-03-08,Danny Mitchell,Decision - Unanimous,80,0,0,80
Igor Araujo,2015-07-15,Sean Strickland,Decision - Unanimous,0,0,0,0
Rony Jason,2017-03-11,Jeremy Kennedy,Decision - Unanimous,0,0,0,0
Rony Jason,2012-10-13,Sam Sicilia,KO/TKO,100,7,0,107
Rony Jason,2013-06-08,Mike Wilkinson,Submission,90,3,0,93
Rony Jason,2014-05-31,Robert Peralta,Decision - Split,0,0,0,0
Rony Jason,2014-03-23,Steven Siler,KO/TKO,100,0,0,100
Rony Jason,2012-06-23,Godofredo Pepey,Decision - Unanimous,80,4,0,84
Rony Jason,2013-11-09,Jeremy Stephens,KO/TKO,0,0,0,0
Rony Jason,2016-08-06,Dennis Bermudez,Decision - Unanimous,0,0,0,0
Markus Perez,2019-02-02,Anthony Hernandez,Submission,90,0,0,90
Markus Perez,2020-10-10,Dricus Du Plessis,KO/TKO,0,0,0,0
Markus Perez,2017-12-09,Eryk Anders,Decision - Unanimous,0,0,0,0
Markus Perez,2019-11-16,Wellington Turman,Decision - Unanimous,0,1,0,1
Markus Perez,2021-01-20,Dalcha Lungiambula,Decision - Unanimous,0,0,0,0
Markus Perez,2018-05-12,James Bochnovic,Submission,90,1,0,91
Markus Perez,2018-08-25,Andrew Sanchez,Decision - Unanimous,0,0,0,0
John Dodson,2013-10-19,Darrell Montague,KO/TKO,100,18,0,118
John Dodson,2012-05-05,Tim Elliott,Decision - Unanimous,80,1,0,81
John Dodson,2012-10-05,Jussier Formiga,KO/TKO,100,24,0,124
John Dodson,2014-06-07,John Moraga,TKO - Doctor's Stoppage,0,19,0,19
John Dodson,2018-03-03,Pedro Munhoz,Decision - Split,70,7,0,77
John Dodson,2013-01-26,Demetrious Johnson,Decision - Unanimous,0,0,25,25
John Dodson,2011-12-03,TJ Dillashaw,KO/TKO,100,5,0,105
John Dodson,2017-04-22,Eddie Wineland,Decision - Unanimous,80,27,0,107
John Dodson,2016-10-01,John Lineker,Decision - Split,0,8,25,33
John Dodson,2018-09-08,Jimmie Rivera,Decision - Unanimous,0,0,0,0
John Dodson,2015-05-23,Zach Makovsky,Decision - Unanimous,80,0,0,80
John Dodson,2020-08-15,Merab Dvalishvili,Decision - Unanimous,0,0,0,0
John Dodson,2017-11-11,Marlon Moraes,Decision - Split,0,0,0,0
John Dodson,2015-09-05,Demetrious Johnson,Decision - Unanimous,0,0,25,25
John Dodson,2016-04-16,Manvel Gamburyan,KO/TKO,100,14,0,114
John Dodson,2019-02-23,Petr Yan,Decision - Unanimous,0,0,0,0
John Dodson,2020-02-15,Nathaniel Wood,KO/TKO,100,0,0,100
Darrell Montague,2013-10-19,John Dodson,KO/TKO,0,0,0,0
Darrell Montague,2015-07-12,Willie Gates,KO/TKO,0,0,0,0
Darrell Montague,2014-05-10,Kyoji Horiguchi,Decision - Unanimous,0,0,0,0
Alex Serdyukov,2009-03-01,Johny Hendricks,Decision - Unanimous,0,48,0,48
Alex Serdyukov,2007-03-24,Scott Norton,Submission,90,0,0,90
Alex Serdyukov,2006-08-17,John Alessio,Submission,0,35,0,35
Alex Serdyukov,2008-03-26,Ryan Stonitsch,Submission,90,0,0,90
Alex Serdyukov,2008-06-01,Luis Santos,KO/TKO,100,0,0,100
Alex Serdyukov,2007-06-03,John Alessio,Submission,0,0,0,0
Ikram Aliskerov,2024-06-22,Robert Whittaker,KO/TKO,0,0,25,25
Ikram Aliskerov,2022-09-13,Mario Sousa,Submission,90,0,0,90
Ikram Aliskerov,2023-05-06,Phil Hawes,KO/TKO,100,3,0,103
Ikram Aliskerov,2023-10-21,Warlley Alves,KO/TKO,100,14,0,114
Grant Dawson,2020-02-29,Darrick Minner,Submission,90,11,0,101
Grant Dawson,2019-03-09,Julian Erosa,Decision - Unanimous,80,8,0,88
Grant Dawson,2024-06-01,Joe Solecki,Decision - Unanimous,80,34,0,114
Grant Dawson,2020-07-18,Nad Narimani,Decision - Unanimous,80,22,0,102
Grant Dawson,2021-03-20,Leonardo Santos,KO/TKO,100,16,0,116
Grant Dawson,2024-10-12,Rafa Garcia,KO/TKO,100,39,0,139
Grant Dawson,2022-04-30,Jared Gordon,Submission,90,0,0,90
Grant Dawson,2023-07-01,Damir Ismagulov,Decision - Unanimous,80,17,0,97
Grant Dawson,2019-05-18,Michael Trizano,Submission,90,7,0,97
Grant Dawson,2017-08-15,Adrian Diaz,Submission,90,21,0,111
Grant Dawson,2023-10-07,Bobby Green,KO/TKO,0,0,25,25
Grant Dawson,2022-11-05,Mark Madsen,Submission,90,18,0,108
Darrick Minner,2020-02-29,Grant Dawson,Submission,0,0,0,0
Darrick Minner,2019-08-06,Herbert Burns,Submission,0,12,0,12
Darrick Minner,2021-02-20,Charles Rosa,Decision - Unanimous,80,30,0,110
Darrick Minner,2021-12-11,Ryan Hall,Decision - Unanimous,0,0,0,0
Darrick Minner,2020-09-19,TJ Laramie,Submission,90,15,0,105
Darrick Minner,2022-11-05,Shayilan Nuerdanbieke,KO/TKO,0,0,0,0
Darrick Minner,2021-07-24,Darren Elkins,KO/TKO,0,0,0,0
Rhys McKee,2024-03-30,Chidi Njokuani,Decision - Split,0,0,0,0
Rhys McKee,2020-11-14,Alex Morono,Decision - Unanimous,0,0,0,0
Rhys McKee,2020-07-25,Khamzat Chimaev,KO/TKO,0,0,0,0
Rhys McKee,2023-09-02,Ange Loosa,Decision - Unanimous,0,0,0,0
Maki Pitolo,2020-08-29,Impa Kasanganay,Decision - Unanimous,0,0,0,0
Maki Pitolo,2020-08-08,Darren Stewart,Submission,0,0,0,0
Maki Pitolo,2019-07-09,Justin Sumter,KO/TKO,100,21,0,121
Maki Pitolo,2021-02-13,Julian Marquez,Submission,0,0,0,0
Maki Pitolo,2021-12-04,Dusko Todorovic,KO/TKO,0,0,0,0
Maki Pitolo,2019-10-05,Callan Potter,Decision - Unanimous,0,12,0,12
Maki Pitolo,2020-06-06,Charles Byrd,KO/TKO,100,18,0,118
Mark Bocek,2011-04-30,Benson Henderson,Decision - Unanimous,0,0,0,0
Mark Bocek,2008-04-19,Mac Danzig,Submission,0,0,0,0
Mark Bocek,2012-04-21,John Alessio,Decision - Unanimous,80,41,0,121
Mark Bocek,2007-12-29,Doug Evans,Decision - Unanimous,80,4,0,84
Mark Bocek,2009-04-18,David Bielkheden,Submission,90,16,0,106
Mark Bocek,2014-04-16,Mike de la Torre,Decision - Split,70,13,0,83
Mark Bocek,2012-11-17,Rafael Dos Anjos,Decision - Unanimous,0,0,0,0
Mark Bocek,2010-12-11,Dustin Hazelett,Submission,90,9,0,99
Mark Bocek,2008-11-15,Alvin Robinson,Submission,90,16,0,106
Mark Bocek,2009-12-05,Joe Brammer,Submission,90,3,0,93
Mark Bocek,2011-12-10,Nik Lentz,Decision - Unanimous,80,36,0,116
Mark Bocek,2010-03-27,Jim Miller,Decision - Unanimous,0,0,0,0
Mark Bocek,2007-07-07,Frankie Edgar,KO/TKO,0,0,0,0
Nate Maness,2023-10-07,Mateus Mendonca,KO/TKO,100,26,0,126
Nate Maness,2020-11-28,Luke Sanders,Submission,90,0,0,90
Nate Maness,2024-06-15,Jimmy Flick,Decision - Unanimous,80,52,0,132
Nate Maness,2020-08-01,Johnny Munoz,Decision - Unanimous,80,0,0,80
Nate Maness,2021-09-18,Tony Gravely,KO/TKO,100,0,0,100
Nate Maness,2022-11-05,Tagir Ulanbekov,Submission,0,0,0,0
Nate Maness,2022-06-25,Umar Nurmagomedov,Decision - Unanimous,0,0,0,0
Mateus Mendonca,2023-10-07,Nate Maness,KO/TKO,0,0,0,0
Mateus Mendonca,2024-02-24,Jesus Aguilar,Decision - Split,0,0,0,0
Mateus Mendonca,2023-01-14,Javid Basharat,Decision - Unanimous,0,0,0,0
Mateus Mendonca,2022-09-27,Ashiek Ajim,KO/TKO,100,5,0,105
Dustin Kimura,2014-01-04,Jon Delos Reyes,Submission,90,0,0,90
Dustin Kimura,2013-02-02,Chico Camus,Submission,90,0,0,90
Dustin Kimura,2014-12-13,Henry Cejudo,Decision - Unanimous,0,0,0,0
Dustin Kimura,2014-04-16,George Roop,Decision - Unanimous,0,0,0,0
Dustin Kimura,2013-09-21,Mitch Gagnon,Submission,0,0,0,0
Jon Delos Reyes,2014-01-04,Dustin Kimura,Submission,0,8,0,8
Jon Delos Reyes,2014-09-20,Kyoji Horiguchi,KO/TKO,0,0,0,0
Jon Delos Reyes,2015-10-24,Neil Seery,Submission,0,0,0,0
Jon Delos Reyes,2015-05-16,Roldan Sangcha'an,Submission,90,0,0,90
Iasmin Lucindo,2024-10-05,Marina Rodriguez,Decision - Split,70,0,0,70
Iasmin Lucindo,2024-05-04,Karolina Kowalkiewicz,Decision - Unanimous,80,41,0,121
Iasmin Lucindo,2023-08-12,Polyana Viana,Submission,90,0,0,90
Iasmin Lucindo,2022-08-13,Yazmin Jauregui,Decision - Unanimous,0,0,0,0
Iasmin Lucindo,2023-04-22,Brogan Walker,Decision - Unanimous,80,24,0,104
Rob MacDonald,2006-08-26,Eric Schafer,Submission,0,0,0,0
Rob MacDonald,2006-03-04,Jason Lambert,Submission,0,0,0,0
Rob MacDonald,2006-06-28,Kristian Rothaermel,Submission,90,7,0,97
Sarah Kaufman,2009-05-15,Miesha Tate,Decision - Unanimous,80,64,0,144
Sarah Kaufman,2010-02-26,Takayo Hashi,Decision - Unanimous,80,93,25,198
Sarah Kaufman,2012-08-18,Ronda Rousey,Submission,0,0,25,25
Sarah Kaufman,2015-12-19,Valentina Shevchenko,Decision - Split,0,0,0,0
Sarah Kaufman,2010-10-09,Marloes Coenen,Submission,0,0,25,25
Sarah Kaufman,2009-06-19,Shayna Baszler,Decision - Unanimous,80,50,0,130
Sarah Kaufman,2015-04-25,Alexis Davis,Submission,0,31,0,31
Sarah Kaufman,2010-07-23,Roxanne Modafferi,KO/TKO,100,37,25,162
Sarah Kaufman,2011-07-22,Liz Carmouche,Decision - Unanimous,80,30,0,110
Sarah Kaufman,2014-04-16,Leslie Smith,Decision - Unanimous,80,123,0,203
Sarah Kaufman,2012-03-03,Alexis Davis,Decision - Majority,75,0,0,75
Claude Patrick,2011-04-30,Daniel Roberts,Decision - Unanimous,80,23,0,103
Claude Patrick,2011-12-10,Brian Ebersole,Decision - Split,0,5,0,5
Claude Patrick,2010-06-12,Ricardo Funch,Submission,90,8,0,98
Claude Patrick,2010-10-16,James Wilks,Decision - Unanimous,80,11,0,91
Colby Covington,2018-06-09,Rafael Dos Anjos,Decision - Unanimous,80,0,25,105
Colby Covington,2019-08-03,Robbie Lawler,Decision - Unanimous,80,101,25,206
Colby Covington,2022-03-05,Jorge Masvidal,Decision - Unanimous,80,27,25,132
Colby Covington,2014-11-08,Wagner Silva,Submission,90,7,0,97
Colby Covington,2020-09-19,Tyron Woodley,KO/TKO,100,44,25,169
Colby Covington,2017-06-17,Dong Hyun Kim,Decision - Unanimous,80,28,0,108
Colby Covington,2019-12-14,Kamaru Usman,KO/TKO,0,0,25,25
Colby Covington,2017-10-28,Demian Maia,Decision - Unanimous,80,35,0,115
Colby Covington,2016-12-17,Bryan Barberena,Decision - Unanimous,80,35,0,115
Colby Covington,2014-08-23,Anying Wang,KO/TKO,100,11,0,111
Colby Covington,2023-12-16,Leon Edwards,Decision - Unanimous,0,0,25,25
Colby Covington,2021-11-06,Kamaru Usman,Decision - Unanimous,0,0,25,25
Colby Covington,2016-06-18,Jonathan Meunier,Submission,90,3,0,93
Colby Covington,2015-05-23,Mike Pyle,Decision - Unanimous,80,10,0,90
Colby Covington,2016-08-20,Max Griffin,KO/TKO,100,13,0,113
Colby Covington,2015-12-12,Warlley Alves,Submission,0,0,0,0
Colby Covington,2024-12-14,Joaquin Buckley,TKO - Doctor's Stoppage,0,0,25,25
Eddie Yagin,2012-04-21,Mark Hominick,Decision - Split,70,0,0,70
Eddie Yagin,2011-09-24,Junior Assuncao,Decision - Unanimous,0,0,0,0
Mark Hominick,2012-04-21,Eddie Yagin,Decision - Split,0,26,0,26
Mark Hominick,2006-06-28,Jorge Gurgel,Decision - Unanimous,80,7,0,87
Mark Hominick,2007-06-03,Rani Yahya,Submission,0,3,0,3
Mark Hominick,2012-11-17,Pablo Garza,Decision - Unanimous,0,0,0,0
Mark Hominick,2008-07-19,Trenell Young,Submission,90,8,0,98
Mark Hominick,2011-01-22,George Roop,KO/TKO,100,0,0,100
Mark Hominick,2011-12-10,Chan Sung Jung,KO/TKO,0,0,0,0
Mark Hominick,2010-01-10,Bryan Caraway,Submission,90,0,0,90
Mark Hominick,2008-02-13,Josh Grispi,Submission,0,0,0,0
Mark Hominick,2010-09-30,Leonard Garcia,Decision - Split,70,26,0,96
Mark Hominick,2011-04-30,Jose Aldo,Decision - Unanimous,0,0,25,25
Mark Hominick,2006-03-04,Yves Edwards,Submission,90,2,0,92
Mark Hominick,2010-06-20,Yves Jabouin,KO/TKO,100,5,0,105
Cole Escovedo,2011-09-24,Takeya Mizugaki,KO/TKO,0,0,0,0
Cole Escovedo,2006-03-17,Urijah Faber,KO/TKO,0,0,25,25
Cole Escovedo,2010-03-22,Yoshiro Maeda,KO/TKO,100,0,0,100
Cole Escovedo,2011-11-12,Alex Caceres,Decision - Unanimous,0,0,0,0
Cole Escovedo,2011-05-28,Renan Barao,Decision - Unanimous,0,0,0,0
Cole Escovedo,2010-09-25,Michihiro Omigawa,Submission,0,0,0,0
Cole Escovedo,2006-08-17,Antonio Banuelos,Decision - Unanimous,0,0,0,0
Batgerel Danaa,2021-04-24,Kevin Natividad,KO/TKO,100,4,0,104
Batgerel Danaa,2022-03-26,Chris Gutierrez,KO/TKO,0,0,0,0
Batgerel Danaa,2021-10-16,Brandon Davis,KO/TKO,100,15,0,115
Batgerel Danaa,2020-03-07,Guido Cannetti,KO/TKO,100,6,0,106
Batgerel Danaa,2019-08-31,Alatengheili,Decision - Unanimous,0,49,0,49
Batgerel Danaa,2023-04-22,Brady Hiestand,KO/TKO,0,0,0,0
Batgerel Danaa,2022-06-11,Kyung Ho Kang,Decision - Unanimous,0,9,0,9
Kevin Natividad,2021-04-24,Batgerel Danaa,KO/TKO,0,0,0,0
Kevin Natividad,2020-10-31,Miles Johns,KO/TKO,0,0,0,0
Kevin Natividad,2022-11-19,Ricky Turcios,Decision - Split,0,0,0,0
Canaan Kawaihae,2018-07-24,Chase Hooper,Decision - Unanimous,0,0,0,0
Canaan Kawaihae,2021-11-02,Jonas Bilharinho,KO/TKO,0,0,0,0
Peter Danesoe,2023-05-28,Sim Kai Xiong,KO/TKO,100,6,0,106
Peter Danesoe,2023-08-27,Nyamjargal Tumendemberel,Submission,0,0,0,0
Sim Kai Xiong,2023-05-28,Peter Danesoe,KO/TKO,0,0,0,0
Timur Valiev,2021-02-06,Martin Day,Decision - Unanimous,80,47,0,127
Timur Valiev,2021-06-26,Raoni Barcelos,Decision - Majority,75,8,0,83
Timur Valiev,2022-03-19,Jack Shore,Decision - Unanimous,0,2,0,2
Istela Nunes,2023-07-15,Viktoriia Dudakova,KO/TKO,0,0,0,0
Istela Nunes,2021-10-16,Ariane Carnelossi,Submission,0,26,0,26
Istela Nunes,2022-12-03,Yazmin Jauregui,KO/TKO,0,0,0,0
Istela Nunes,2022-04-16,Sam Hughes,Decision - Majority,0,13,0,13
Yoshihiro Akiyama,2011-08-06,Vitor Belfort,KO/TKO,0,0,0,0
Yoshihiro Akiyama,2005-07-06,Carl Toomey,Submission,90,0,0,90
Yoshihiro Akiyama,2015-11-28,Alberto Mina,Decision - Split,0,9,0,9
Yoshihiro Akiyama,2007-10-28,Denis Kang,KO/TKO,100,0,0,100
Yoshihiro Akiyama,2010-10-16,Michael Bisping,Decision - Unanimous,0,0,0,0
Yoshihiro Akiyama,2005-10-12,Michael Lerma,KO/TKO,100,18,0,118
Yoshihiro Akiyama,2005-03-26,Jerome LeBanner,KO/TKO,0,0,0,0
Yoshihiro Akiyama,2006-10-09,Melvin Manhoef,Submission,90,0,0,90
Yoshihiro Akiyama,2005-11-05,Masakatsu Okuda,KO/TKO,100,15,0,115
Yoshihiro Akiyama,2006-08-05,Taiei Kin,Submission,90,0,0,90
Yoshihiro Akiyama,2012-02-25,Jake Shields,Decision - Unanimous,0,0,0,0
Yoshihiro Akiyama,2008-07-21,Katsuyori Shibata,Submission,90,0,0,90
Yoshihiro Akiyama,2008-09-23,Masanori Tonooka,Submission,90,6,0,96
Yoshihiro Akiyama,2006-10-09,Kestutis Smirnovas,KO/TKO,100,8,0,108
Yoshihiro Akiyama,2006-03-15,Tokimitsu Ishizawa,Submission,90,14,0,104
Yoshihiro Akiyama,2014-09-20,Amir Sadollah,Decision - Unanimous,80,15,0,95
Yoshihiro Akiyama,2006-05-03,Katsuhiko Nagata,KO/TKO,100,10,0,110
Yoshihiro Akiyama,2009-07-11,Alan Belcher,Decision - Split,70,0,0,70
Yoshihiro Akiyama,2010-07-03,Chris Leben,Submission,0,0,0,0
Yoshihiro Akiyama,2004-12-31,Francois Botha,Submission,90,2,0,92
Frankie Edgar,2009-05-23,Sean Sherk,Decision - Unanimous,80,47,0,127
Frankie Edgar,2020-08-22,Pedro Munhoz,Decision - Split,70,0,25,95
Frankie Edgar,2021-11-06,Marlon Vera,KO/TKO,0,6,0,6
Frankie Edgar,2019-07-27,Max Holloway,Decision - Unanimous,0,0,25,25
Frankie Edgar,2014-07-06,BJ Penn,KO/TKO,100,77,25,202
Frankie Edgar,2008-07-19,Hermes Franca,Decision - Unanimous,80,51,0,131
Frankie Edgar,2021-02-06,Cory Sandhagen,KO/TKO,0,0,0,0
Frankie Edgar,2016-11-12,Jeremy Stephens,Decision - Unanimous,80,7,0,87
Frankie Edgar,2014-11-22,Cub Swanson,Submission,90,62,25,177
Frankie Edgar,2011-10-08,Gray Maynard,KO/TKO,100,19,25,144
Frankie Edgar,2016-07-09,Jose Aldo,Decision - Unanimous,0,0,25,25
Frankie Edgar,2012-08-11,Benson Henderson,Decision - Split,0,2,25,27
Frankie Edgar,2015-05-16,Urijah Faber,Decision - Unanimous,80,35,25,140
Frankie Edgar,2018-04-21,Cub Swanson,Decision - Unanimous,80,10,0,90
Frankie Edgar,2013-07-06,Charles Oliveira,Decision - Unanimous,80,43,0,123
Frankie Edgar,2009-12-05,Matt Veach,Submission,90,18,0,108
Frankie Edgar,2012-02-25,Benson Henderson,Decision - Unanimous,0,0,25,25
Frankie Edgar,2010-08-28,BJ Penn,Decision - Unanimous,80,58,25,163
Frankie Edgar,2017-05-13,Yair Rodriguez,TKO - Doctor's Stoppage,0,56,0,56
Frankie Edgar,2010-04-10,BJ Penn,Decision - Unanimous,80,0,25,105
Frankie Edgar,2007-07-07,Mark Bocek,KO/TKO,100,25,0,125
Frankie Edgar,2018-03-03,Brian Ortega,KO/TKO,0,2,0,2
Frankie Edgar,2013-02-02,Jose Aldo,Decision - Unanimous,0,0,25,25
Frankie Edgar,2008-04-02,Gray Maynard,Decision - Unanimous,0,7,0,7
Frankie Edgar,2015-12-11,Chad Mendes,KO/TKO,100,8,25,133
Frankie Edgar,2007-11-17,Spencer Fisher,Decision - Unanimous,80,36,0,116
Frankie Edgar,2022-11-12,Chris Gutierrez,KO/TKO,0,0,0,0
Frankie Edgar,2019-12-21,Chan Sung Jung,KO/TKO,0,0,25,25
Frankie Edgar,2007-02-03,Tyson Griffin,Decision - Unanimous,80,17,0,97
Cain Velasquez,2008-04-19,Brad Morris,KO/TKO,100,35,0,135
Cain Velasquez,2013-05-25,Antonio Silva,KO/TKO,100,17,25,142
Cain Velasquez,2010-02-20,Antonio Rodrigo Nogueira,KO/TKO,100,20,0,120
Cain Velasquez,2009-10-24,Ben Rothwell,KO/TKO,100,59,0,159
Cain Velasquez,2006-12-16,Jeremiah Constant,KO/TKO,100,7,0,107
Cain Velasquez,2015-06-13,Fabricio Werdum,Submission,0,0,25,25
Cain Velasquez,2010-10-23,Brock Lesnar,KO/TKO,100,22,25,147
Cain Velasquez,2011-11-12,Junior Dos Santos,KO/TKO,0,0,25,25
Cain Velasquez,2006-10-07,Jesse Fujarczyk,KO/TKO,100,12,0,112
Cain Velasquez,2008-07-19,Jake O'Brien,KO/TKO,100,23,0,123
Cain Velasquez,2009-02-07,Denis Stojnic,KO/TKO,100,81,0,181
Cain Velasquez,2016-07-09,Travis Browne,KO/TKO,100,44,0,144
Cain Velasquez,2012-05-26,Antonio Silva,KO/TKO,100,27,0,127
Cain Velasquez,2013-10-19,Junior Dos Santos,KO/TKO,100,77,25,202
Cain Velasquez,2009-06-13,Cheick Kongo,Decision - Unanimous,80,8,0,88
Cain Velasquez,2012-12-29,Junior Dos Santos,Decision - Unanimous,80,54,25,159
Cain Velasquez,2019-02-17,Francis Ngannou,KO/TKO,0,0,25,25
Brad Morris,2008-04-19,Cain Velasquez,KO/TKO,0,0,0,0
Brad Morris,2008-09-17,Jason Brilz,KO/TKO,0,0,0,0
Vik Grujic,2014-06-28,Chris Indich,KO/TKO,100,1,0,101
Vik Grujic,2015-05-09,Brendan O'Reilly,Decision - Unanimous,0,17,0,17
Vik Grujic,2014-11-07,Chris Clements,KO/TKO,0,0,0,0
Vik Grujic,2014-04-16,Nordine Taleb,Decision - Unanimous,0,0,0,0
Chris Indich,2014-06-28,Vik Grujic,KO/TKO,0,0,0,0
Chris Indich,2014-04-16,Richard Walsh,Decision - Unanimous,0,0,0,0
Jake Collier,2022-04-30,Andrei Arlovski,Decision - Split,0,2,0,2
Jake Collier,2020-12-05,Gian Villante,Decision - Unanimous,80,43,0,123
Jake Collier,2015-06-06,Ricardo Abreu,Decision - Split,70,20,0,90
Jake Collier,2022-09-10,Chris Barnett,KO/TKO,0,0,0,0
Jake Collier,2014-12-20,Vitor Miranda,KO/TKO,0,1,0,1
Jake Collier,2017-11-11,Marcel Fortuna,Decision - Unanimous,80,35,0,115
Jake Collier,2020-07-25,Tom Aspinall,KO/TKO,0,0,0,0
Jake Collier,2023-04-29,Martin Buday,Decision - Unanimous,0,0,0,0
Jake Collier,2023-09-23,Mohammed Usman,Decision - Unanimous,0,2,0,2
Jake Collier,2017-04-15,Devin Clark,Decision - Unanimous,0,0,0,0
Jake Collier,2022-01-15,Chase Sherman,Submission,90,10,0,100
Jake Collier,2015-11-28,Dongi Yang,KO/TKO,0,0,0,0
Jake Collier,2021-06-12,Carlos Felipe,Decision - Split,0,36,0,36
Jake Collier,2016-05-29,Alberto Uda,KO/TKO,100,12,0,112
Tim Means,2018-02-03,Sergio Moraes,Decision - Split,0,42,0,42
Tim Means,2013-07-27,Danny Castillo,Decision - Unanimous,0,13,0,13
Tim Means,2021-06-26,Nicolas Dalby,Decision - Unanimous,80,0,0,80
Tim Means,2018-11-30,Ricky Rainey,KO/TKO,100,13,0,113
Tim Means,2015-07-11,Matt Brown,Submission,0,0,0,0
Tim Means,2022-10-29,Max Griffin,Decision - Split,0,5,0,5
Tim Means,2015-04-18,George Sullivan,Submission,90,9,0,99
Tim Means,2014-12-20,Marcio Alexandre Junior,Decision - Split,70,7,0,77
Tim Means,2017-06-25,Alex Garcia,Decision - Unanimous,80,32,0,112
Tim Means,2023-09-23,Andre Fialho,KO/TKO,100,53,0,153
Tim Means,2019-03-09,Niko Price,KO/TKO,0,0,0,0
Tim Means,2016-08-20,Sabah Homasi,KO/TKO,100,38,0,138
Tim Means,2024-10-05,Court McGee,Submission,0,0,0,0
Tim Means,2023-05-13,Alex Morono,Submission,0,7,0,7
Tim Means,2013-04-20,Jorge Masvidal,Decision - Unanimous,0,0,0,0
Tim Means,2020-08-08,Laureano Staropoli,Decision - Unanimous,80,14,0,94
Tim Means,2024-04-27,Uros Medic,KO/TKO,0,0,0,0
Tim Means,2015-12-10,John Howard,KO/TKO,100,17,0,117
Tim Means,2012-02-15,Bernardo Magalhaes,Decision - Unanimous,80,55,0,135
Tim Means,2017-11-18,Belal Muhammad,Decision - Split,0,3,0,3
Tim Means,2019-12-07,Thiago Alves,Submission,90,10,0,100
Tim Means,2014-07-26,Hernani Perpetuo,Decision - Unanimous,80,24,0,104
Tim Means,2020-02-15,Daniel Rodriguez,Submission,0,0,0,0
Tim Means,2020-11-21,Mike Perry,Decision - Unanimous,80,64,0,144
Tim Means,2017-03-11,Alex Oliveira,Submission,0,0,0,0
Tim Means,2015-02-28,Dhiego Lima,KO/TKO,100,16,0,116
Tim Means,2022-06-18,Kevin Holland,Submission,0,0,0,0
Tim Means,2012-06-08,Justin Salas,KO/TKO,100,21,0,121
Tim Means,2014-05-10,Neil Magny,Decision - Unanimous,0,1,0,1
Ariel Gandulla,2007-05-12,Gary Padilla,Decision - Split,70,0,0,70
Ariel Gandulla,2007-12-12,Doug Marshall,Submission,0,1,25,26
Gary Padilla,2007-05-12,Ariel Gandulla,Decision - Split,0,3,0,3
Hannah Goldy,2021-09-18,Emily Whitmire,Submission,90,5,0,95
Hannah Goldy,2019-06-18,Kali Robbins,Decision - Unanimous,80,85,0,165
Hannah Goldy,2023-09-23,Mizuki,Decision - Unanimous,0,0,0,0
Hannah Goldy,2022-07-23,Molly McCann,KO/TKO,0,0,0,0
Hannah Goldy,2019-08-03,Miranda Granger,Decision - Unanimous,0,0,0,0
Hannah Goldy,2021-07-24,Diana Belbita,Decision - Unanimous,0,0,0,0
Emily Whitmire,2021-09-18,Hannah Goldy,Submission,0,0,0,0
Emily Whitmire,2019-06-29,Amanda Ribas,Submission,0,0,0,0
Emily Whitmire,2018-07-07,Jamie Moyle,Decision - Unanimous,80,3,0,83
Emily Whitmire,2019-02-17,Aleksandra Albu,Submission,90,1,0,91
Emily Whitmire,2017-12-01,Gillian Robertson,Submission,0,7,0,7
Emily Whitmire,2020-08-29,Polyana Viana,Submission,0,0,0,0
Akira Corassani,2015-01-24,Sam Sicilia,KO/TKO,0,0,0,0
Akira Corassani,2012-09-29,Andy Ogle,Decision - Split,70,0,0,70
Akira Corassani,2014-10-04,Max Holloway,KO/TKO,0,0,0,0
Akira Corassani,2013-11-30,Maximo Blanco,DQ,0,0,0,0
Akira Corassani,2013-04-06,Robert Peralta,Decision - Unanimous,80,0,0,80
Akira Corassani,2014-04-16,Dustin Poirier,KO/TKO,0,0,0,0
Makoto Takimoto,2007-04-08,Zelg Galesic,Submission,90,0,0,90
Makoto Takimoto,2006-06-04,Gegard Mousasi,TKO - Doctor's Stoppage,0,0,0,0
Makoto Takimoto,2005-06-26,Kiyoshi Tamura,Decision - Unanimous,0,0,0,0
Makoto Takimoto,2004-12-31,Henry Miller,Decision - Unanimous,80,19,0,99
Makoto Takimoto,2005-10-23,Dong Sik Yoon,Decision - Unanimous,80,15,0,95
Makoto Takimoto,2005-12-31,Sanae Kikuta,Decision - Unanimous,0,0,0,0
Zelg Galesic,2007-04-08,Makoto Takimoto,Submission,0,12,0,12
Zelg Galesic,2009-10-25,Kazushi Sakuraba,Submission,0,33,0,33
Zelg Galesic,2008-06-15,Taiei Kin,KO/TKO,100,3,0,103
Zelg Galesic,2008-04-29,Magomed Sultanakhmedov,Submission,90,4,0,94
Zelg Galesic,2008-09-23,Jacare Souza,Submission,0,0,0,0
Brian Stann,2008-03-26,Doug Marshall,KO/TKO,100,4,25,129
Brian Stann,2007-03-24,Steve Cantwell,KO/TKO,100,2,0,102
Brian Stann,2013-03-02,Wanderlei Silva,KO/TKO,0,0,25,25
Brian Stann,2012-09-22,Michael Bisping,Decision - Unanimous,0,0,0,0
Brian Stann,2009-12-05,Rodney Wallace,Decision - Unanimous,80,21,0,101
Brian Stann,2009-09-16,Steve Cantwell,Decision - Unanimous,80,9,0,89
Brian Stann,2010-02-06,Phil Davis,Decision - Unanimous,0,0,0,0
Brian Stann,2010-08-01,Mike Massenzio,Submission,90,38,0,128
Brian Stann,2012-04-14,Alessio Sakara,KO/TKO,100,11,0,111
Brian Stann,2007-06-03,Craig Zellner,KO/TKO,100,20,0,120
Brian Stann,2007-09-05,Jeremiah Billington,KO/TKO,100,17,0,117
Brian Stann,2011-05-28,Jorge Santiago,KO/TKO,100,33,0,133
Brian Stann,2011-10-08,Chael Sonnen,Submission,0,0,0,0
Brian Stann,2008-08-03,Steve Cantwell,KO/TKO,0,0,25,25
Brian Stann,2009-04-18,Krzysztof Soszynski,Submission,0,5,0,5
Brian Stann,2011-01-01,Chris Leben,KO/TKO,100,23,0,123
Marcus Brimage,2012-04-21,Maximo Blanco,Decision - Split,70,6,0,76
Marcus Brimage,2014-11-07,Jumabieke Tuerxun,KO/TKO,100,0,0,100
Marcus Brimage,2015-07-18,Jimmie Rivera,KO/TKO,0,0,0,0
Marcus Brimage,2014-07-05,Russell Doane,Decision - Split,0,3,0,3
Marcus Brimage,2011-12-03,Stephen Bass,Decision - Unanimous,80,15,0,95
Marcus Brimage,2013-04-06,Conor McGregor,KO/TKO,0,0,0,0
Marcus Brimage,2015-01-03,Cody Garbrandt,KO/TKO,0,0,0,0
Marcus Brimage,2012-09-22,Jimy Hettes,Decision - Unanimous,80,24,0,104
Maximo Blanco,2012-04-21,Marcus Brimage,Decision - Split,0,0,0,0
Maximo Blanco,2016-01-17,Luke Sanders,Submission,0,0,0,0
Maximo Blanco,2013-11-30,Akira Corassani,DQ,0,4,0,4
Maximo Blanco,2014-02-15,Felipe Arantes,Decision - Unanimous,0,5,0,5
Maximo Blanco,2015-07-12,Mike de la Torre,KO/TKO,100,3,0,103
Maximo Blanco,2011-09-10,Pat Healy,Submission,0,12,0,12
Maximo Blanco,2014-05-31,Andy Ogle,Decision - Unanimous,80,16,0,96
Maximo Blanco,2014-09-20,Dan Hooker,Decision - Unanimous,80,33,0,113
Maximo Blanco,2013-04-13,Sam Sicilia,Decision - Unanimous,80,26,0,106
Maximo Blanco,2016-09-17,Chas Skelly,Submission,0,0,0,0
Anthony Rocco Martin,2017-06-25,Johnny Case,Decision - Unanimous,80,0,0,80
Anthony Rocco Martin,2018-04-21,Keita Nakamura,Decision - Unanimous,80,32,0,112
Anthony Rocco Martin,2014-02-01,Rashid Magomedov,Decision - Unanimous,0,0,0,0
Anthony Rocco Martin,2020-06-06,Neil Magny,Decision - Unanimous,0,0,0,0
Anthony Rocco Martin,2017-01-15,Alex White,Decision - Unanimous,80,9,0,89
Anthony Rocco Martin,2018-10-06,Ryan LaFlare,KO/TKO,100,1,0,101
Anthony Rocco Martin,2018-12-01,Jake Matthews,Submission,90,1,0,91
Anthony Rocco Martin,2019-06-29,Demian Maia,Decision - Majority,0,19,0,19
Anthony Rocco Martin,2014-08-23,Beneil Dariush,Submission,0,8,0,8
Anthony Rocco Martin,2017-09-16,Olivier Aubin-Mercier,Decision - Split,0,0,0,0
Anthony Rocco Martin,2019-03-09,Sergio Moraes,Decision - Unanimous,80,31,0,111
Anthony Rocco Martin,2014-10-25,Fabricio Camoes,Submission,90,0,0,90
Anthony Rocco Martin,2016-01-30,Felipe Olivieri,Submission,90,0,0,90
Anthony Rocco Martin,2019-11-09,Ramazan Emeev,Decision - Unanimous,80,11,0,91
Anthony Rocco Martin,2015-03-21,Leonardo Santos,Submission,0,2,0,2
Johnny Case,2017-06-25,Anthony Rocco Martin,Decision - Unanimous,0,10,0,10
Johnny Case,2015-11-07,Yan Cabral,Decision - Unanimous,80,43,0,123
Johnny Case,2015-06-13,Francisco Trevino,Decision - Unanimous,80,6,0,86
Johnny Case,2016-03-19,Jake Matthews,Submission,0,0,0,0
Johnny Case,2015-01-18,Frankie Perez,KO/TKO,100,43,0,143
Johnny Case,2014-09-20,Kazuki Tokudome,Submission,90,1,0,91
Mackenzie Dern,2018-03-03,Ashley Yoder,Decision - Split,70,18,0,88
Mackenzie Dern,2022-04-09,Tecia Pennington,Decision - Split,70,0,0,70
Mackenzie Dern,2022-10-01,Yan Xiaonan,Decision - Majority,0,0,25,25
Mackenzie Dern,2024-08-03,Loopy Godinez,Decision - Unanimous,80,5,0,85
Mackenzie Dern,2023-05-20,Angela Hill,Decision - Unanimous,80,60,25,165
Mackenzie Dern,2020-09-19,Randa Markos,Submission,90,6,0,96
Mackenzie Dern,2018-05-12,Amanda Cooper,Submission,90,9,0,99
Mackenzie Dern,2023-11-11,Jessica Andrade,KO/TKO,0,0,0,0
Mackenzie Dern,2020-05-30,Hannah Cifers,Submission,90,0,0,90
Mackenzie Dern,2019-10-12,Amanda Ribas,Decision - Unanimous,0,0,0,0
Mackenzie Dern,2024-02-17,Amanda Lemos,Decision - Unanimous,0,0,0,0
Mackenzie Dern,2020-12-12,Virna Jandiroba,Decision - Unanimous,80,19,0,99
Mackenzie Dern,2021-10-09,Marina Rodriguez,Decision - Unanimous,0,0,25,25
Mackenzie Dern,2021-04-10,Nina Nunes,Submission,90,8,0,98
Ashley Yoder,2018-03-03,Mackenzie Dern,Decision - Split,0,0,0,0
Ashley Yoder,2017-07-07,Angela Hill,Decision - Unanimous,0,0,0,0
Ashley Yoder,2018-11-10,Amanda Cooper,Decision - Split,70,0,0,70
Ashley Yoder,2021-07-31,Jinh Yu Frey,Decision - Unanimous,0,3,0,3
Ashley Yoder,2016-12-09,Justine Kish,Decision - Unanimous,0,0,0,0
Ashley Yoder,2023-10-14,Emily Ducote,Decision - Unanimous,0,0,0,0
Ashley Yoder,2020-08-15,Livinha Souza,Decision - Unanimous,0,0,0,0
Ashley Yoder,2019-06-22,Syuri Kondo,Decision - Unanimous,80,52,0,132
Ashley Yoder,2020-11-14,Miranda Granger,Decision - Unanimous,80,0,0,80
Ashley Yoder,2019-10-26,Randa Markos,Decision - Split,0,0,0,0
Ashley Yoder,2021-03-13,Angela Hill,Decision - Unanimous,0,0,0,0
Cezar Ferreira,2014-03-23,CB Dollaway,KO/TKO,0,0,0,0
Cezar Ferreira,2018-05-12,Karl Roberson,Submission,90,1,0,91
Cezar Ferreira,2019-07-13,Marvin Vettori,Decision - Unanimous,0,0,0,0
Cezar Ferreira,2012-06-23,Sergio Moraes,Decision - Unanimous,80,4,0,84
Cezar Ferreira,2017-11-11,Nate Marquardt,Decision - Split,70,11,0,81
Cezar Ferreira,2016-04-16,Oluwale Bamgbose,Decision - Unanimous,80,6,0,86
Cezar Ferreira,2018-11-17,Ian Heinisch,Decision - Unanimous,0,0,0,0
Cezar Ferreira,2013-11-09,Daniel Sarafian,Decision - Split,70,0,0,70
Cezar Ferreira,2013-08-03,Thiago Santos,Submission,90,3,0,93
Cezar Ferreira,2017-02-19,Elias Theodorou,Decision - Unanimous,0,0,0,0
Cezar Ferreira,2015-02-22,Sam Alvey,KO/TKO,0,9,0,9
Cezar Ferreira,2016-11-19,Jack Hermansson,Submission,90,0,0,90
Cezar Ferreira,2014-06-28,Andrew Craig,Decision - Unanimous,80,4,0,84
Cezar Ferreira,2015-07-12,Jorge Masvidal,KO/TKO,0,0,0,0
Cezar Ferreira,2016-07-08,Anthony Smith,Decision - Unanimous,80,0,0,80
Jordan Leavitt,2022-04-16,Trey Ogden,Decision - Split,70,28,0,98
Jordan Leavitt,2021-12-18,Matt Sayles,Submission,90,0,0,90
Jordan Leavitt,2023-02-25,Victor Martinez,KO/TKO,100,10,0,110
Jordan Leavitt,2022-07-23,Paddy Pimblett,Submission,0,0,0,0
Jordan Leavitt,2020-12-05,Matt Wiman,KO/TKO,100,1,0,101
Jordan Leavitt,2023-11-18,Chase Hooper,Submission,0,2,0,2
Jordan Leavitt,2021-06-05,Claudio Puelles,Decision - Unanimous,0,1,0,1
Jordan Leavitt,2020-08-04,Luke Flores,Submission,90,2,0,92
Trey Ogden,2022-04-16,Jordan Leavitt,Decision - Split,0,0,0,0
Trey Ogden,2024-03-23,Kurt Holobaugh,Decision - Unanimous,80,6,0,86
Trey Ogden,2023-04-08,Ignacio Bahamondes,Decision - Unanimous,0,0,0,0
Trey Ogden,2024-07-20,Loik Radzhabov,Decision - Unanimous,80,0,0,80
Trey Ogden,2022-09-17,Daniel Zellhuber,Decision - Unanimous,80,19,0,99
Khabib Nurmagomedov,2018-04-07,Al Iaquinta,Decision - Unanimous,80,93,25,198
Khabib Nurmagomedov,2013-05-25,Abel Trujillo,Decision - Unanimous,80,12,0,92
Khabib Nurmagomedov,2012-07-07,Gleison Tibau,Decision - Unanimous,80,0,0,80
Khabib Nurmagomedov,2013-09-21,Pat Healy,Decision - Unanimous,80,10,0,90
Khabib Nurmagomedov,2016-11-12,Michael Johnson,Submission,90,75,0,165
Khabib Nurmagomedov,2017-12-30,Edson Barboza,Decision - Unanimous,80,64,0,144
Khabib Nurmagomedov,2014-04-19,Rafael Dos Anjos,Decision - Unanimous,80,16,0,96
Khabib Nurmagomedov,2012-01-20,Kamal Shalorus,Submission,90,22,0,112
Khabib Nurmagomedov,2016-04-16,Darrell Horcher,KO/TKO,100,69,0,169
Khabib Nurmagomedov,2013-01-19,Thiago Tavares,KO/TKO,100,20,0,120
Khabib Nurmagomedov,2020-10-24,Justin Gaethje,Submission,90,0,25,115
Khabib Nurmagomedov,2018-10-06,Conor McGregor,Submission,90,19,25,134
Khabib Nurmagomedov,2019-09-07,Dustin Poirier,Submission,90,10,25,125
Al Iaquinta,2018-04-07,Khabib Nurmagomedov,Decision - Unanimous,0,0,25,25
Al Iaquinta,2021-11-06,Bobby Green,KO/TKO,0,0,0,0
Al Iaquinta,2015-01-31,Joe Lauzon,KO/TKO,100,27,0,127
Al Iaquinta,2018-12-15,Kevin Lee,Decision - Unanimous,80,9,25,114
Al Iaquinta,2014-02-01,Kevin Lee,Decision - Unanimous,80,10,0,90
Al Iaquinta,2013-08-31,Ryan Couture,Decision - Unanimous,80,35,0,115
Al Iaquinta,2019-05-04,Donald Cerrone,Decision - Unanimous,0,0,25,25
Al Iaquinta,2014-11-07,Ross Pearson,KO/TKO,100,11,0,111
Al Iaquinta,2015-04-04,Jorge Masvidal,Decision - Split,70,0,0,70
Al Iaquinta,2014-05-24,Mitch Clarke,Submission,0,5,0,5
Al Iaquinta,2017-04-22,Diego Sanchez,KO/TKO,100,8,0,108
Al Iaquinta,2013-10-26,Piotr Hallmann,Decision - Unanimous,80,19,0,99
Al Iaquinta,2014-09-05,Rodrigo Damm,KO/TKO,100,36,0,136
Al Iaquinta,2012-06-01,Michael Chiesa,Submission,0,0,0,0
Al Iaquinta,2019-10-05,Dan Hooker,Decision - Unanimous,0,0,0,0
Albert Tumenov,2015-01-24,Nicholas Musoke,Decision - Unanimous,80,22,0,102
Albert Tumenov,2014-05-10,Anthony Lapsley,KO/TKO,100,4,0,104
Albert Tumenov,2014-02-15,Ildemar Alcantara,Decision - Split,0,0,0,0
Albert Tumenov,2016-10-08,Leon Edwards,Submission,0,16,0,16
Albert Tumenov,2014-10-04,Matt Dwyer,KO/TKO,100,4,0,104
Albert Tumenov,2015-10-03,Alan Jouban,KO/TKO,100,2,0,102
Albert Tumenov,2016-01-02,Lorenz Larkin,Decision - Split,70,7,0,77
Albert Tumenov,2016-05-08,Gunnar Nelson,Submission,0,0,0,0
Nicholas Musoke,2015-01-24,Albert Tumenov,Decision - Unanimous,0,0,0,0
Nicholas Musoke,2014-02-15,Viscardi Andrade,Decision - Unanimous,80,21,0,101
Nicholas Musoke,2017-05-28,Bojan Velickovic,KO/TKO,0,0,0,0
Nicholas Musoke,2014-10-04,Alexander Yakovlev,Decision - Unanimous,80,26,0,106
Nicholas Musoke,2013-10-26,Alessio Sakara,Submission,90,0,0,90
Nicholas Musoke,2014-06-28,Kelvin Gastelum,Decision - Unanimous,0,0,0,0
Lando Vannata,2020-02-15,Yancy Medeiros,Decision - Unanimous,80,31,0,111
Lando Vannata,2023-04-15,Daniel Zellhuber,Decision - Unanimous,0,0,0,0
Lando Vannata,2021-05-15,Mike Grundy,Decision - Split,70,48,0,118
Lando Vannata,2019-02-09,Marcos Mariano,Submission,90,17,0,107
Lando Vannata,2019-09-28,Marc Diakiese,Decision - Unanimous,0,0,0,0
Lando Vannata,2016-07-13,Tony Ferguson,Submission,0,0,0,0
Lando Vannata,2017-03-04,David Teymur,Decision - Unanimous,0,0,0,0
Lando Vannata,2018-07-07,Drakkar Klose,Decision - Unanimous,0,0,0,0
Lando Vannata,2022-04-23,Charles Jourdain,Submission,0,4,0,4
Lando Vannata,2020-08-01,Bobby Green,Decision - Unanimous,0,0,0,0
Lando Vannata,2016-12-10,John Makdessi,KO/TKO,100,0,0,100
Danillo Villefort,2009-08-08,Jesse Lennox,TKO - Doctor's Stoppage,0,6,0,6
Danillo Villefort,2009-01-25,Mike Campbell,KO/TKO,100,2,0,102
Joey Gambino,2012-10-13,Diego Brandao,Decision - Unanimous,0,6,0,6
Joey Gambino,2012-06-22,Steven Siler,Submission,0,0,0,0
Curtis Stout,2004-12-12,Rich Franklin,KO/TKO,0,0,0,0
Curtis Stout,2001-02-23,Phil Baroni,Decision - Unanimous,0,0,0,0
Curtis Stout,2005-12-03,Anderson Silva,KO/TKO,0,0,0,0
Curtis Stout,2004-06-19,Trevor Prangley,Submission,0,0,0,0
Manvel Gamburyan,2015-07-15,Scott Jorgensen,Decision - Unanimous,80,6,0,86
Manvel Gamburyan,2008-08-09,Rob Emerson,KO/TKO,0,0,0,0
Manvel Gamburyan,2009-01-31,Thiago Tavares,Decision - Unanimous,0,0,0,0
Manvel Gamburyan,2008-04-02,Jeff Cox,Submission,90,1,0,91
Manvel Gamburyan,2014-09-27,Cody Gibson,Submission,90,0,0,90
Manvel Gamburyan,2011-06-26,Tyson Griffin,Decision - Unanimous,0,0,0,0
Manvel Gamburyan,2014-05-10,Nik Lentz,Decision - Unanimous,0,0,0,0
Manvel Gamburyan,2009-11-18,Leonard Garcia,Decision - Unanimous,80,18,0,98
Manvel Gamburyan,2007-12-29,Nate Mohr,Submission,90,1,0,91
Manvel Gamburyan,2012-08-04,Michihiro Omigawa,Decision - Unanimous,80,11,0,91
Manvel Gamburyan,2010-04-24,Mike Brown,KO/TKO,100,6,0,106
Manvel Gamburyan,2007-06-23,Nate Diaz,Submission,0,14,0,14
Manvel Gamburyan,2011-12-30,Diego Nunes,Decision - Unanimous,0,0,0,0
Manvel Gamburyan,2016-04-16,John Dodson,KO/TKO,0,0,0,0
Manvel Gamburyan,2010-09-30,Jose Aldo,KO/TKO,0,0,25,25
Manvel Gamburyan,2009-06-07,John Franchi,Decision - Unanimous,80,33,0,113
Manvel Gamburyan,2013-08-17,Cole Miller,Decision - Unanimous,80,0,0,80
Manvel Gamburyan,2016-11-19,Johnny Eduardo,KO/TKO,0,0,0,0
Erik Perez,2012-12-29,Byron Bloodworth,KO/TKO,100,32,0,132
Erik Perez,2013-11-16,Edwin Figueroa,Decision - Unanimous,80,32,0,112
Erik Perez,2012-06-01,John Albert,Submission,90,12,0,102
Erik Perez,2015-11-21,Taylor Lapilus,Decision - Unanimous,80,11,0,91
Erik Perez,2016-11-05,Felipe Arantes,Decision - Split,70,2,0,72
Erik Perez,2014-06-07,Bryan Caraway,Submission,0,3,0,3
Erik Perez,2016-07-30,Francisco Rivera,Decision - Unanimous,80,0,0,80
Erik Perez,2013-08-28,Takeya Mizugaki,Decision - Split,0,0,0,0
Erik Perez,2012-08-11,Ken Stone,KO/TKO,100,7,0,107
Byron Bloodworth,2012-12-29,Erik Perez,KO/TKO,0,0,0,0
Byron Bloodworth,2011-10-01,Mike Easton,KO/TKO,0,0,0,0
Forrest Griffin,2005-06-04,Bill Mahood,Submission,90,2,0,92
Forrest Griffin,2005-10-07,Elvis Sinosic,KO/TKO,100,12,0,112
Forrest Griffin,2011-08-27,Mauricio Rua,KO/TKO,0,0,0,0
Forrest Griffin,2009-08-08,Anderson Silva,KO/TKO,0,0,0,0
Forrest Griffin,2011-02-05,Rich Franklin,Decision - Unanimous,80,17,0,97
Forrest Griffin,2012-07-07,Tito Ortiz,Decision - Unanimous,80,36,0,116
Forrest Griffin,2006-08-26,Stephan Bonnar,Decision - Unanimous,80,42,0,122
Forrest Griffin,2006-12-30,Keith Jardine,KO/TKO,0,0,0,0
Forrest Griffin,2003-12-18,Edson Silva,KO/TKO,100,3,0,103
Forrest Griffin,2008-07-05,Quinton Jackson,Decision - Unanimous,80,27,25,132
Forrest Griffin,2009-11-21,Tito Ortiz,Decision - Split,70,46,0,116
Forrest Griffin,2003-09-06,Jeremy Horn,KO/TKO,0,0,0,0
Forrest Griffin,2007-09-22,Mauricio Rua,Submission,90,39,0,129
Forrest Griffin,2007-06-16,Hector Ramirez,Decision - Unanimous,80,93,0,173
Forrest Griffin,2006-04-15,Tito Ortiz,Decision - Split,0,0,0,0
Forrest Griffin,2005-04-09,Stephan Bonnar,Decision - Unanimous,80,31,0,111
Forrest Griffin,2003-09-06,Chael Sonnen,Submission,90,0,0,90
Forrest Griffin,2008-12-27,Rashad Evans,KO/TKO,0,1,25,26
Bill Mahood,2005-06-04,Forrest Griffin,Submission,0,0,0,0
Bill Mahood,2004-05-22,Patrick Cote,KO/TKO,0,0,0,0
Bill Mahood,2007-09-29,Bobby Southworth,Submission,0,0,0,0
Sarah Frota,2018-08-10,Maiara Amanajas dos Santos,KO/TKO,100,65,0,165
Sarah Frota,2019-07-27,Gillian Robertson,KO/TKO,0,0,0,0
Sarah Frota,2019-02-02,Livinha Souza,Decision - Split,0,9,0,9
Maiara Amanajas dos Santos,2018-08-10,Sarah Frota,KO/TKO,0,0,0,0
Mansur Abdul-Malik,2024-11-09,Dusko Todorovic,KO/TKO,100,26,0,126
Kyle Bochniak,2018-01-20,Brandon Davis,Decision - Unanimous,80,0,0,80
Kyle Bochniak,2018-12-08,Hakeem Dawodu,Decision - Split,0,0,0,0
Kyle Bochniak,2016-08-27,Enrique Barzola,Decision - Split,70,0,0,70
Kyle Bochniak,2017-07-22,Jeremy Kennedy,Decision - Unanimous,0,0,0,0
Kyle Bochniak,2019-10-18,Sean Woodson,Decision - Unanimous,0,0,0,0
Kyle Bochniak,2018-04-07,Zabit Magomedsharipov,Decision - Unanimous,0,0,0,0
Kyle Bochniak,2016-01-17,Charles Rosa,Decision - Unanimous,0,0,0,0
Brandon Davis,2018-01-20,Kyle Bochniak,Decision - Unanimous,0,5,0,5
Brandon Davis,2021-10-16,Batgerel Danaa,KO/TKO,0,0,0,0
Brandon Davis,2018-09-08,Zabit Magomedsharipov,Submission,0,0,0,0
Brandon Davis,2018-02-18,Steven Peterson,Decision - Unanimous,80,41,0,121
Brandon Davis,2022-10-15,Mana Martinez,Decision - Split,0,0,0,0
Brandon Davis,2019-04-13,Randy Costa,Submission,90,0,0,90
Brandon Davis,2019-09-28,Giga Chikadze,Decision - Split,0,0,0,0
Brandon Davis,2018-05-19,Enrique Barzola,Decision - Unanimous,0,0,0,0
Brandon Davis,2017-08-01,Austin Arnett,Decision - Unanimous,80,29,0,109
Brandon Davis,2019-08-17,Kyung Ho Kang,Decision - Split,0,27,0,27
Jesse Strader,2022-02-19,Chad Anheliger,KO/TKO,0,0,0,0
Jesse Strader,2021-03-20,Montel Jackson,KO/TKO,0,0,0,0
Noe Hernandez,1998-05-15,Chuck Liddell,Decision - Unanimous,0,0,0,0
Yizha,2022-06-09,Keisuke Sasu,Submission,90,5,0,95
Yizha,2023-05-27,Wuziazibieke Jiahefu,Submission,90,6,0,96
Yizha,2022-10-23,Koyomi Matsushima,Decision - Split,70,0,0,70
Yizha,2023-08-27,SangWon Kim,Decision - Unanimous,80,19,0,99
Yizha,2023-02-04,JeongYeong Lee,Decision - Split,0,0,0,0
Yizha,2024-09-07,Gabriel Santos,Decision - Unanimous,0,0,0,0
Keisuke Sasu,2022-06-09,Yizha,Submission,0,0,0,0
Keisuke Sasu,2023-05-27,SangWon Kim,KO/TKO,0,0,0,0
Keisuke Sasu,2022-10-23,Balajin,Decision - Unanimous,80,20,0,100
Sodiq Yusuff,2019-08-17,Gabriel Benitez,KO/TKO,100,10,0,110
Sodiq Yusuff,2018-07-24,Mike Davis,Decision - Unanimous,80,34,0,114
Sodiq Yusuff,2023-10-14,Edson Barboza,Decision - Unanimous,0,14,25,39
Sodiq Yusuff,2019-03-30,Sheymon Moraes,Decision - Unanimous,80,19,0,99
Sodiq Yusuff,2021-04-10,Arnold Allen,Decision - Unanimous,0,26,0,26
Sodiq Yusuff,2022-03-12,Alex Caceres,Decision - Unanimous,80,0,0,80
Sodiq Yusuff,2020-01-18,Andre Fili,Decision - Unanimous,80,24,0,104
Sodiq Yusuff,2024-04-13,Diego Lopes,KO/TKO,0,0,0,0
Sodiq Yusuff,2022-10-01,Don Shainis,Submission,90,6,0,96
Sodiq Yusuff,2018-12-01,Suman Mokhtarian,KO/TKO,100,18,0,118
Melissa Gatto,2023-07-01,Ariane da Silva,Decision - Split,0,19,0,19
Melissa Gatto,2021-12-18,Sijara Eubanks,KO/TKO,100,3,0,103
Melissa Gatto,2021-08-07,Victoria Leonardo,TKO - Doctor's Stoppage,0,27,0,27
Melissa Gatto,2022-05-07,Tracy Cortez,Decision - Unanimous,0,0,0,0
Melissa Gatto,2024-05-18,Tamires Vidal,KO/TKO,100,15,0,115
Mike Rhodes,2014-01-25,George Sullivan,Decision - Unanimous,0,0,0,0
Mike Rhodes,2014-12-20,Erick Silva,Submission,0,0,0,0
Mike Rhodes,2014-06-28,Robert Whittaker,Decision - Unanimous,0,0,0,0
Serghei Spivac,2023-09-02,Ciryl Gane,KO/TKO,0,0,25,25
Serghei Spivac,2019-05-04,Walt Harris,KO/TKO,0,0,0,0
Serghei Spivac,2020-02-29,Marcin Tybura,Decision - Unanimous,0,0,0,0
Serghei Spivac,2022-03-05,Greg Hardy,KO/TKO,100,7,0,107
Serghei Spivac,2023-02-04,Derrick Lewis,Submission,90,12,25,127
Serghei Spivac,2021-02-20,Jared Vanderaa,KO/TKO,100,38,0,138
Serghei Spivac,2021-09-04,Tom Aspinall,KO/TKO,0,0,0,0
Serghei Spivac,2019-10-05,Tai Tuivasa,Submission,90,2,0,92
Serghei Spivac,2024-08-10,Marcin Tybura,Submission,90,3,25,118
Serghei Spivac,2021-06-19,Aleksei Oleinik,Decision - Unanimous,80,12,0,92
Serghei Spivac,2020-07-18,Carlos Felipe,Decision - Majority,75,29,0,104
Serghei Spivac,2022-08-06,Augusto Sakai,KO/TKO,100,25,0,125
Bethe Correia,2016-09-10,Jessica Eye,Decision - Split,70,0,0,70
Bethe Correia,2014-04-26,Jessamyn Duke,Decision - Unanimous,80,37,0,117
Bethe Correia,2019-09-21,Sijara Eubanks,Decision - Unanimous,80,0,0,80
Bethe Correia,2019-05-11,Irene Aldana,Submission,0,0,0,0
Bethe Correia,2014-08-30,Shayna Baszler,KO/TKO,100,60,0,160
Bethe Correia,2015-08-01,Ronda Rousey,KO/TKO,0,0,25,25
Bethe Correia,2020-07-25,Pannie Kianzad,Decision - Unanimous,0,0,0,0
Bethe Correia,2013-12-06,Julie Kedzie,Decision - Split,70,11,0,81
Bethe Correia,2016-04-16,Raquel Pennington,Decision - Split,0,0,0,0
Bethe Correia,2021-10-02,Karol Rosa,Decision - Unanimous,0,0,0,0
Bethe Correia,2017-06-17,Holly Holm,KO/TKO,0,0,25,25
Tom Niinimaki,2013-11-30,Rani Yahya,Decision - Split,70,2,0,72
Tom Niinimaki,2014-08-23,Chas Skelly,Submission,0,0,0,0
Tom Niinimaki,2014-12-20,Renato Moicano,Submission,0,0,0,0
Tom Niinimaki,2014-05-31,Niklas Backstrom,Submission,0,2,0,2
Rani Yahya,2013-11-30,Tom Niinimaki,Decision - Split,0,0,0,0
Rani Yahya,2011-08-06,Chad Mendes,Decision - Unanimous,0,0,0,0
Rani Yahya,2016-07-13,Matthew Lopez,Submission,90,26,0,116
Rani Yahya,2017-03-11,Joe Soto,Decision - Unanimous,0,5,0,5
Rani Yahya,2007-06-03,Mark Hominick,Submission,90,0,0,90
Rani Yahya,2018-02-24,Russell Doane,Submission,90,15,0,105
Rani Yahya,2013-08-03,Josh Clopton,Decision - Unanimous,80,9,0,89
Rani Yahya,2011-01-22,Mike Brown,Decision - Unanimous,80,25,0,105
Rani Yahya,2008-11-05,Yoshiro Maeda,Submission,90,0,0,90
Rani Yahya,2009-04-05,Eddie Wineland,Submission,90,2,0,92
Rani Yahya,2007-09-05,Chase Beebe,Decision - Unanimous,0,0,25,25
Rani Yahya,2012-08-04,Josh Grispi,Submission,90,0,0,90
Rani Yahya,2009-08-09,John Hosman,Submission,90,2,0,92
Rani Yahya,2010-04-24,Takeya Mizugaki,Decision - Unanimous,0,0,0,0
Rani Yahya,2014-09-13,Johnny Bedford,Submission,90,4,0,94
Rani Yahya,2024-04-27,Victor Henry,KO/TKO,0,0,0,0
Rani Yahya,2018-08-25,Luke Sanders,Submission,90,2,0,92
Rani Yahya,2009-12-19,Joseph Benavidez,KO/TKO,0,0,0,0
Rani Yahya,2015-07-15,Masanori Kanehara,Decision - Split,70,0,0,70
Rani Yahya,2013-03-02,Mizuto Hirota,Decision - Unanimous,80,9,0,89
Rani Yahya,2021-11-20,Kyung Ho Kang,Decision - Unanimous,80,0,0,80
Rani Yahya,2017-08-05,Henry Briones,Submission,90,3,0,93
Rani Yahya,2019-02-09,Ricky Simon,Decision - Unanimous,0,0,0,0
Rani Yahya,2016-09-24,Michinori Tanaka,Decision - Unanimous,80,0,0,80
Rani Yahya,2021-03-13,Ray Rodriguez,Submission,90,5,0,95
Rani Yahya,2023-04-22,Montel Jackson,KO/TKO,0,0,0,0
Edmen Shahbazyan,2019-07-06,Jack Marshman,Submission,90,13,0,103
Edmen Shahbazyan,2018-07-17,Antonio Jones,KO/TKO,100,15,0,115
Edmen Shahbazyan,2024-03-23,AJ Dobson,KO/TKO,100,12,0,112
Edmen Shahbazyan,2019-11-02,Brad Tavares,KO/TKO,100,11,0,111
Edmen Shahbazyan,2021-05-22,Jack Hermansson,Decision - Unanimous,0,0,0,0
Edmen Shahbazyan,2019-03-02,Charles Byrd,KO/TKO,100,12,0,112
Edmen Shahbazyan,2018-11-30,Darren Stewart,Decision - Split,70,0,0,70
Edmen Shahbazyan,2022-12-10,Dalcha Lungiambula,KO/TKO,100,31,0,131
Edmen Shahbazyan,2023-05-20,Anthony Hernandez,KO/TKO,0,0,0,0
Edmen Shahbazyan,2024-08-24,Gerald Meerschaert,Submission,0,27,0,27
Edmen Shahbazyan,2020-08-01,Derek Brunson,KO/TKO,0,0,0,0
Edmen Shahbazyan,2021-11-06,Nassourdine Imavov,KO/TKO,0,0,0,0
Tyron Woodley,2020-05-30,Gilbert Burns,Decision - Unanimous,0,0,25,25
Tyron Woodley,2017-03-04,Stephen Thompson,Decision - Majority,75,1,25,101
Tyron Woodley,2014-06-14,Rory MacDonald,Decision - Unanimous,0,0,0,0
Tyron Woodley,2015-01-31,Kelvin Gastelum,Decision - Split,70,0,0,70
Tyron Woodley,2020-09-19,Colby Covington,KO/TKO,0,0,25,25
Tyron Woodley,2016-07-30,Robbie Lawler,KO/TKO,100,5,25,130
Tyron Woodley,2014-03-15,Carlos Condit,KO/TKO,100,1,0,101
Tyron Woodley,2018-09-08,Darren Till,Submission,90,57,25,172
Tyron Woodley,2009-11-20,Rudy Bears,Submission,90,1,0,91
Tyron Woodley,2010-05-21,Nathan Coy,Decision - Split,70,0,0,70
Tyron Woodley,2012-07-14,Nate Marquardt,KO/TKO,0,0,25,25
Tyron Woodley,2013-02-02,Jay Hieron,KO/TKO,100,15,0,115
Tyron Woodley,2019-03-02,Kamaru Usman,Decision - Unanimous,0,0,25,25
Tyron Woodley,2011-07-30,Paul Daley,Decision - Unanimous,80,0,0,80
Tyron Woodley,2014-08-23,Dong Hyun Kim,KO/TKO,100,11,0,111
Tyron Woodley,2011-01-07,Tarec Saffiedine,Decision - Unanimous,80,7,0,87
Tyron Woodley,2013-06-15,Jake Shields,Decision - Split,0,0,0,0
Tyron Woodley,2021-03-27,Vicente Luque,Submission,0,0,0,0
Tyron Woodley,2010-10-09,Andre Galvao,KO/TKO,100,9,0,109
Tyron Woodley,2017-07-29,Demian Maia,Decision - Unanimous,80,29,25,134
Tyron Woodley,2013-11-16,Josh Koscheck,KO/TKO,100,17,0,117
Tyron Woodley,2009-09-25,Zach Light,Submission,90,11,0,101
Tyron Woodley,2012-01-07,Jordan Mein,Decision - Split,70,10,0,80
Ronda Rousey,2013-02-23,Liz Carmouche,Submission,90,3,25,118
Ronda Rousey,2015-02-28,Cat Zingano,Submission,90,0,25,115
Ronda Rousey,2012-08-18,Sarah Kaufman,Submission,90,2,25,117
Ronda Rousey,2011-08-12,Sarah D'alelio,Submission,90,0,0,90
Ronda Rousey,2014-02-22,Sara McMann,KO/TKO,100,1,25,126
Ronda Rousey,2015-08-01,Bethe Correia,KO/TKO,100,10,25,135
Ronda Rousey,2014-07-05,Alexis Davis,KO/TKO,100,12,25,137
Ronda Rousey,2012-03-03,Miesha Tate,Submission,90,0,25,115
Ronda Rousey,2013-12-28,Miesha Tate,Submission,90,16,25,131
Ronda Rousey,2011-11-18,Julia Budd,Submission,90,0,0,90
Ronda Rousey,2016-12-30,Amanda Nunes,KO/TKO,0,0,25,25
Ronda Rousey,2015-11-14,Holly Holm,KO/TKO,0,0,25,25
Liz Carmouche,2013-02-23,Ronda Rousey,Submission,0,0,25,25
Liz Carmouche,2014-04-19,Miesha Tate,Decision - Unanimous,0,0,0,0
Liz Carmouche,2018-07-14,Jennifer Maia,Decision - Unanimous,80,11,0,91
Liz Carmouche,2013-07-27,Jessica Andrade,KO/TKO,100,40,0,140
Liz Carmouche,2010-11-19,Jan Finney,KO/TKO,100,55,0,155
Liz Carmouche,2019-08-10,Valentina Shevchenko,Decision - Unanimous,0,0,25,25
Liz Carmouche,2015-04-04,Lauren Murphy,Decision - Unanimous,80,0,0,80
Liz Carmouche,2016-11-12,Katlyn Cerminara,Decision - Split,70,5,0,75
Liz Carmouche,2013-11-06,Alexis Davis,Decision - Unanimous,0,0,0,0
Liz Carmouche,2011-07-22,Sarah Kaufman,Decision - Unanimous,0,0,0,0
Liz Carmouche,2010-08-13,Colleen Schneider,Decision - Unanimous,80,2,0,82
Liz Carmouche,2019-02-23,Lucie Pudilova,Decision - Unanimous,80,0,0,80
Liz Carmouche,2017-12-09,Alexis Davis,Decision - Split,0,26,0,26
Liz Carmouche,2011-03-05,Marloes Coenen,Submission,0,13,25,38
Scott Bessac,1995-09-08,David Hood,Submission,90,0,0,90
David Hood,1995-09-08,Scott Bessac,Submission,0,1,0,1
Mike Malott,2023-06-10,Adam Fugitt,Submission,90,10,0,100
Mike Malott,2024-11-02,Trevin Giles,Decision - Unanimous,80,25,0,105
Mike Malott,2021-10-05,Shimon Smotritsky,Submission,90,1,0,91
Mike Malott,2024-01-20,Neil Magny,KO/TKO,0,0,0,0
Mike Malott,2022-04-09,Mickey Gall,KO/TKO,100,15,0,115
Mike Malott,2023-02-25,Yohan Lainesse,Submission,90,8,0,98
Adam Fugitt,2023-06-10,Mike Malott,Submission,0,0,0,0
Adam Fugitt,2022-07-30,Michael Morales,KO/TKO,0,0,0,0
Adam Fugitt,2023-02-04,Yusaku Kinoshita,KO/TKO,100,11,0,111
Adam Fugitt,2024-06-15,Josh Quinlan,Decision - Split,70,27,0,97
Karl Williams,2023-03-11,Lukasz Brzeski,Decision - Unanimous,80,12,0,92
Karl Williams,2022-09-06,Jimmy Lawson,Decision - Unanimous,80,23,0,103
Karl Williams,2024-03-23,Justin Tafa,Decision - Unanimous,80,19,0,99
Karl Williams,2024-08-10,Jhonata Diniz,Decision - Unanimous,0,0,0,0
Karl Williams,2023-05-13,Chase Sherman,Decision - Unanimous,80,16,0,96
Omari Akhmedov,2013-11-09,Thiago Perpetuo,KO/TKO,100,0,0,100
Omari Akhmedov,2015-01-03,Mats Nilsson,Decision - Unanimous,80,31,0,111
Omari Akhmedov,2019-12-14,Ian Heinisch,Decision - Unanimous,80,2,0,82
Omari Akhmedov,2021-01-20,Tom Breese,Submission,90,24,0,114
Omari Akhmedov,2019-03-09,Tim Boetsch,Decision - Unanimous,80,11,0,91
Omari Akhmedov,2019-09-07,Zak Cummings,Decision - Unanimous,80,9,0,89
Omari Akhmedov,2016-04-16,Elizeu Zaleski dos Santos,KO/TKO,0,0,0,0
Omari Akhmedov,2017-05-28,Abdul Razak Alhassan,Decision - Split,70,9,0,79
Omari Akhmedov,2016-11-26,Kyle Noke,Decision - Unanimous,80,7,0,87
Omari Akhmedov,2015-06-06,Brian Ebersole,KO/TKO,100,13,0,113
Omari Akhmedov,2020-08-08,Chris Weidman,Decision - Unanimous,0,4,0,4
Omari Akhmedov,2015-12-10,Sergio Moraes,KO/TKO,0,14,0,14
Omari Akhmedov,2021-07-10,Brad Tavares,Decision - Split,0,0,0,0
Omari Akhmedov,2014-03-08,Gunnar Nelson,Submission,0,0,0,0
Thiago Perpetuo,2013-11-09,Omari Akhmedov,KO/TKO,0,4,0,4
Thiago Perpetuo,2012-06-23,Leonardo Mafra,KO/TKO,100,35,0,135
Thiago Perpetuo,2014-03-23,Kenny Robertson,Submission,0,0,0,0
Waldo Cortes-Acosta,2024-05-11,Robelis Despaigne,Decision - Unanimous,80,26,0,106
Waldo Cortes-Acosta,2023-08-26,Lukasz Brzeski,KO/TKO,100,1,0,101
Waldo Cortes-Acosta,2023-04-29,Marcos Rogerio de Lima,Decision - Unanimous,0,23,0,23
Waldo Cortes-Acosta,2024-01-13,Andrei Arlovski,Decision - Unanimous,80,0,0,80
Waldo Cortes-Acosta,2022-10-29,Jared Vanderaa,Decision - Unanimous,80,17,0,97
Waldo Cortes-Acosta,2022-11-19,Chase Sherman,Decision - Unanimous,80,81,0,161
Waldo Cortes-Acosta,2022-08-02,Danilo Suzart,KO/TKO,100,28,0,128
Robelis Despaigne,2024-05-11,Waldo Cortes-Acosta,Decision - Unanimous,0,0,0,0
Robelis Despaigne,2024-03-09,Josh Parisian,KO/TKO,100,5,0,105
Robelis Despaigne,2024-10-19,Austen Lane,Decision - Unanimous,0,8,0,8
Caio Magalhaes,2013-12-06,Nick Ring,Decision - Unanimous,80,2,0,82
Caio Magalhaes,2016-09-10,Brad Tavares,Decision - Split,0,0,0,0
Caio Magalhaes,2015-07-12,Josh Samman,Submission,0,0,0,0
Caio Magalhaes,2012-06-08,Buddy Roberts,Decision - Unanimous,0,0,0,0
Caio Magalhaes,2014-04-19,Luke Zachrich,KO/TKO,100,13,0,113
Caio Magalhaes,2013-06-08,Karlos Vemola,Submission,90,0,0,90
Caio Magalhaes,2014-11-08,Trevor Smith,KO/TKO,100,7,0,107
Nick Ring,2013-12-06,Caio Magalhaes,Decision - Unanimous,0,0,0,0
Nick Ring,2011-02-26,Riki Fukuda,Decision - Unanimous,80,13,0,93
Nick Ring,2011-09-24,Tim Boetsch,Decision - Unanimous,0,0,0,0
Nick Ring,2013-03-16,Chris Camozzi,Decision - Split,0,22,0,22
Nick Ring,2012-07-21,Court McGee,Decision - Unanimous,80,0,0,80
Nick Ring,2011-06-11,James Head,Submission,90,28,0,118
Nick Roehrick,2017-07-07,Jared Cannonier,KO/TKO,0,0,0,0
Shane Roller,2009-08-09,Marcus Hicks,Decision - Unanimous,80,22,0,102
Shane Roller,2012-01-28,Michael Johnson,Decision - Unanimous,0,0,0,0
Shane Roller,2011-10-01,TJ Grant,Submission,0,0,0,0
Shane Roller,2010-04-24,Anthony Njokuani,Submission,90,0,0,90
Shane Roller,2009-04-05,Benson Henderson,KO/TKO,0,0,0,0
Shane Roller,2012-10-05,Jacob Volkmann,Submission,0,0,0,0
Shane Roller,2008-08-03,Todd Moore,Submission,90,0,0,90
Shane Roller,2009-11-18,Danny Castillo,Submission,90,5,0,95
Shane Roller,2010-12-16,Jamie Varner,Submission,90,0,0,90
Shane Roller,2012-07-07,John Alessio,Decision - Unanimous,80,0,0,80
Shane Roller,2008-12-03,Mike Budnik,Submission,90,0,0,90
Shane Roller,2011-03-03,Thiago Tavares,KO/TKO,100,4,0,104
Shane Roller,2011-07-02,Melvin Guillard,KO/TKO,0,0,0,0
Shane Roller,2010-08-18,Anthony Pettis,Submission,0,0,0,0
Marcus Hicks,2009-08-09,Shane Roller,Decision - Unanimous,0,0,0,0
Marcus Hicks,2008-03-26,Ed Ratcliff,Submission,90,4,0,94
Marcus Hicks,2008-08-03,Jamie Varner,KO/TKO,0,0,25,25
Marcus Hicks,2007-09-05,Scott McAfee,Submission,90,3,0,93
Marcus Hicks,2007-05-12,Sergio Gomez,Submission,90,0,0,90
Marcus Hicks,2009-03-01,Rob McCullough,Decision - Majority,0,0,0,0
Brad Katona,2023-08-19,Cody Gibson,Decision - Unanimous,80,0,0,80
Brad Katona,2019-05-04,Merab Dvalishvili,Decision - Unanimous,0,0,0,0
Brad Katona,2024-01-20,Garrett Armfield,Decision - Unanimous,0,0,0,0
Brad Katona,2024-06-08,Jesse Butler,Decision - Unanimous,80,38,0,118
Brad Katona,2018-12-08,Matthew Lopez,Decision - Unanimous,80,7,0,87
Brad Katona,2024-10-19,Jean Matsumoto,Decision - Unanimous,0,0,0,0
Brad Katona,2018-07-06,Jay Cucciniello,Decision - Unanimous,80,57,0,137
Brad Katona,2019-09-14,Hunter Azure,Decision - Unanimous,0,0,0,0
Cody Gibson,2023-08-19,Brad Katona,Decision - Unanimous,0,4,0,4
Cody Gibson,2024-11-02,Chad Anheliger,Decision - Unanimous,80,5,0,85
Cody Gibson,2014-09-27,Manvel Gamburyan,Submission,0,38,0,38
Cody Gibson,2014-06-28,Johnny Bedford,KO/TKO,100,0,0,100
Cody Gibson,2024-03-23,Miles Johns,Decision - Unanimous,0,0,0,0
Cody Gibson,2014-02-22,Aljamain Sterling,Decision - Unanimous,0,0,0,0
Cody Gibson,2024-07-20,Brian Kelleher,Submission,90,11,0,101
Cody Gibson,2015-02-22,Douglas Silva de Andrade,Decision - Unanimous,0,0,0,0
Daniel Marcos,2024-06-08,John Castaneda,Decision - Unanimous,80,38,0,118
Daniel Marcos,2022-09-13,Brandon Lewis,Decision - Unanimous,80,36,0,116
Daniel Marcos,2023-07-22,Davey Grant,Decision - Split,70,0,0,70
Daniel Marcos,2024-12-14,Adrian Yanez,Decision - Split,70,7,0,77
Daniel Marcos,2023-01-21,Saimon Oliveira,KO/TKO,100,30,0,130
John Castaneda,2024-06-08,Daniel Marcos,Decision - Unanimous,0,0,0,0
John Castaneda,2023-06-03,Muin Gafurov,Decision - Unanimous,80,0,0,80
John Castaneda,2022-02-05,Miles Johns,Submission,90,24,0,114
John Castaneda,2017-08-01,Cheyden Leialoha,Decision - Unanimous,80,20,0,100
John Castaneda,2021-02-20,Eddie Wineland,KO/TKO,100,25,0,125
John Castaneda,2020-07-25,Nathaniel Wood,Decision - Unanimous,0,0,0,0
John Castaneda,2022-10-01,Daniel Santos,KO/TKO,0,0,0,0
John Castaneda,2023-11-11,Kyung Ho Kang,Decision - Unanimous,80,23,0,103
Joe Pyfer,2023-10-07,Abdul Razak Alhassan,Submission,90,15,0,105
Joe Pyfer,2024-06-29,Marc-Andre Barriault,KO/TKO,100,8,0,108
Joe Pyfer,2020-08-11,Dustin Stoltzfus,KO/TKO,0,0,0,0
Joe Pyfer,2024-02-10,Jack Hermansson,Decision - Unanimous,0,0,25,25
Joe Pyfer,2023-04-08,Gerald Meerschaert,KO/TKO,100,4,0,104
Joe Pyfer,2022-07-26,Ozzy Diaz,KO/TKO,100,15,0,115
Joe Pyfer,2022-09-17,Alen Amedovski,KO/TKO,100,3,0,103
Alexandre Barros,2009-01-17,Martin Kampmann,KO/TKO,0,0,0,0
Will Campuzano,2010-06-20,Eddie Wineland,KO/TKO,0,0,0,0
Will Campuzano,2010-12-04,Nick Pace,Submission,0,0,0,0
Will Campuzano,2009-10-10,Damacio Page,Submission,0,0,0,0
Will Campuzano,2011-01-22,Chris Cariaso,Decision - Unanimous,0,0,0,0
Will Campuzano,2013-11-16,Sergio Pettis,Decision - Unanimous,0,0,0,0
Will Campuzano,2010-01-10,Coty Wheeler,Decision - Unanimous,80,18,0,98
Will Campuzano,2014-03-15,Justin Scoggins,Decision - Unanimous,0,0,0,0
Chris Leben,2003-10-17,Brian Sleeman,Submission,90,0,0,90
Chris Leben,2007-09-19,Terry Martin,KO/TKO,100,8,0,108
Chris Leben,2009-08-29,Jake Rosholt,Submission,0,0,0,0
Chris Leben,2004-05-14,Joe Doerksen,Decision - Unanimous,0,3,0,3
Chris Leben,2010-01-11,Jay Silva,Decision - Unanimous,80,45,0,125
Chris Leben,2006-06-28,Anderson Silva,KO/TKO,0,0,0,0
Chris Leben,2012-12-29,Derek Brunson,Decision - Unanimous,0,0,0,0
Chris Leben,2004-01-16,Mike Swick,KO/TKO,100,0,25,125
Chris Leben,2010-06-19,Aaron Simpson,KO/TKO,100,0,0,100
Chris Leben,2005-04-09,Jason Thacker,KO/TKO,100,26,0,126
Chris Leben,2006-08-17,Jorge Santiago,KO/TKO,100,3,0,103
Chris Leben,2007-05-26,Kalib Starnes,Decision - Unanimous,0,0,0,0
Chris Leben,2013-07-06,Andrew Craig,Decision - Split,0,0,0,0
Chris Leben,2011-07-02,Wanderlei Silva,KO/TKO,100,6,0,106
Chris Leben,2008-03-01,Alessio Sakara,KO/TKO,100,11,0,111
Chris Leben,2006-04-06,Luigi Fioravanti,Decision - Unanimous,80,16,0,96
Chris Leben,2011-11-05,Mark Munoz,KO/TKO,0,0,25,25
Chris Leben,2005-08-06,Patrick Cote,Decision - Split,70,0,0,70
Chris Leben,2006-12-30,Jason MacDonald,Submission,0,6,0,6
Chris Leben,2008-10-18,Michael Bisping,Decision - Unanimous,0,0,0,0
Chris Leben,2013-12-28,Uriah Hall,TKO - Doctor's Stoppage,0,0,0,0
Chris Leben,2011-01-01,Brian Stann,KO/TKO,0,0,0,0
Chris Leben,2005-10-03,Edwin DeWees,Submission,90,0,0,90
Chris Leben,2006-01-16,Jorge Rivera,KO/TKO,100,5,0,105
Chris Leben,2010-07-03,Yoshihiro Akiyama,Submission,90,19,0,109
Brian Sleeman,2003-10-17,Chris Leben,Submission,0,7,0,7
Josh Hendricks,2008-11-15,Gabriel Gonzaga,KO/TKO,0,0,0,0
Austin Springer,2018-06-19,Giga Chikadze,Submission,90,11,0,101
Austin Springer,2020-08-29,Alex Caceres,Submission,0,0,0,0
Giga Chikadze,2018-06-19,Austin Springer,Submission,0,0,0,0
Giga Chikadze,2023-08-26,Alex Caceres,Decision - Unanimous,80,3,0,83
Giga Chikadze,2020-03-07,Jamall Emmers,Decision - Split,70,0,0,70
Giga Chikadze,2020-05-16,Irwin Rivera,Decision - Unanimous,80,27,0,107
Giga Chikadze,2022-01-15,Calvin Kattar,Decision - Unanimous,0,0,25,25
Giga Chikadze,2024-07-27,Arnold Allen,Decision - Unanimous,0,0,0,0
Giga Chikadze,2020-10-10,Omar Morales,Decision - Unanimous,80,31,0,111
Giga Chikadze,2019-09-28,Brandon Davis,Decision - Split,70,25,0,95
Giga Chikadze,2021-08-28,Edson Barboza,KO/TKO,100,27,25,152
Giga Chikadze,2021-05-01,Cub Swanson,KO/TKO,100,8,0,108
Giga Chikadze,2020-11-07,Jamey Simmons,KO/TKO,100,6,0,106
Jordan Espinosa,2017-08-22,Nick Urso,Submission,90,2,0,92
Jordan Espinosa,2020-06-13,Mark De La Rosa,Decision - Unanimous,80,89,0,169
Jordan Espinosa,2018-07-10,Rilley Dutro,KO/TKO,100,18,0,118
Jordan Espinosa,2020-01-25,Alex Perez,Submission,0,0,0,0
Jordan Espinosa,2019-08-03,Matt Schnell,Submission,0,2,0,2
Jordan Espinosa,2019-03-23,Eric Shelton,Decision - Unanimous,80,22,0,102
Jordan Espinosa,2020-09-19,David Dvorak,Decision - Unanimous,0,0,0,0
Jordan Espinosa,2021-03-06,Tim Elliott,Decision - Unanimous,0,0,0,0
Nick Urso,2017-08-22,Jordan Espinosa,Submission,0,0,0,0
Rinya Nakamura,2024-02-17,Carlos Vera,Decision - Unanimous,80,26,0,106
Rinya Nakamura,2022-10-23,Shohei Nose,KO/TKO,100,6,0,106
Rinya Nakamura,2023-08-26,Fernie Garcia,Decision - Unanimous,80,21,0,101
Rinya Nakamura,2023-02-04,Toshiomi Kazama,KO/TKO,100,7,0,107
Rinya Nakamura,2022-06-10,Gugun Gusman,Submission,90,18,0,108
Carlos Vera,2024-02-17,Rinya Nakamura,Decision - Unanimous,0,0,0,0
Steve Nelmark,1996-05-17,Tai Bowden,TKO - Doctor's Stoppage,0,9,0,9
Steve Nelmark,1996-12-07,David Abbott,KO/TKO,0,0,0,0
Tai Bowden,1996-05-17,Steve Nelmark,TKO - Doctor's Stoppage,0,0,0,0
Elvis Sinosic,2005-10-07,Forrest Griffin,KO/TKO,0,0,0,0
Elvis Sinosic,2001-02-23,Jeremy Horn,Submission,90,0,0,90
Elvis Sinosic,2001-06-29,Tito Ortiz,KO/TKO,0,0,25,25
Elvis Sinosic,2002-03-22,Evan Tanner,TKO - Doctor's Stoppage,0,0,0,0
Elvis Sinosic,2002-07-13,Renato Sobral,Decision - Unanimous,0,0,0,0
Elvis Sinosic,2006-02-04,Alessio Sakara,Decision - Unanimous,0,0,0,0
Elvis Sinosic,2007-04-21,Michael Bisping,KO/TKO,0,0,0,0
Carl Toomey,2005-07-06,Yoshihiro Akiyama,Submission,0,0,0,0
Rob Emerson,2008-08-09,Manvel Gamburyan,KO/TKO,100,3,0,103
Rob Emerson,2008-02-02,Keita Nakamura,Decision - Split,70,24,0,94
Rob Emerson,2010-03-31,Nik Lentz,Decision - Unanimous,0,0,0,0
Rob Emerson,2010-02-06,Phillipe Nover,Decision - Unanimous,80,7,0,87
Rob Emerson,2009-09-19,Rafael Dos Anjos,Decision - Unanimous,0,0,0,0
Rob Emerson,2009-02-07,Kurt Pellegrino,Submission,0,5,0,5
Marius Zaromskis,2009-04-05,Seichi Ikemoto,Decision - Unanimous,80,28,0,108
Marius Zaromskis,2009-07-20,Hayato Sakurai,KO/TKO,100,0,0,100
Marius Zaromskis,2010-06-16,Evangelista Santos,KO/TKO,0,0,0,0
Marius Zaromskis,2011-07-16,Eiji Ishikawa,Decision - Unanimous,80,43,0,123
Marius Zaromskis,2009-10-25,Ho Bae Myeon,KO/TKO,100,0,0,100
Marius Zaromskis,2009-07-20,Jason High,KO/TKO,100,3,0,103
Marius Zaromskis,2010-12-31,Kazushi Sakuraba,TKO - Doctor's Stoppage,0,0,0,0
Marius Zaromskis,2010-01-30,Nick Diaz,KO/TKO,0,0,25,25
Seichi Ikemoto,2009-04-05,Marius Zaromskis,Decision - Unanimous,0,0,0,0
Seichi Ikemoto,2009-07-20,Tarec Saffiedine,Decision - Unanimous,0,0,0,0
Seichi Ikemoto,2006-04-02,Yves Edwards,Decision - Unanimous,0,0,0,0
Seichi Ikemoto,2006-08-27,Daisuke Nakamura,Submission,0,1,0,1
Chas Skelly,2014-08-23,Tom Niinimaki,Submission,90,1,0,91
Chas Skelly,2016-03-05,Darren Elkins,Decision - Unanimous,0,0,0,0
Chas Skelly,2015-02-14,Jim Alers,KO/TKO,100,9,0,109
Chas Skelly,2017-05-13,Jason Knight,KO/TKO,0,0,0,0
Chas Skelly,2014-09-05,Sean Soriano,Decision - Unanimous,80,0,0,80
Chas Skelly,2014-04-19,Mirsad Bektic,Decision - Majority,0,0,0,0
Chas Skelly,2015-11-07,Edimilson Souza,Submission,90,0,0,90
Chas Skelly,2017-02-04,Chris Gruetzemacher,Submission,90,0,0,90
Chas Skelly,2019-09-14,Jordan Griffin,Decision - Unanimous,80,0,0,80
Chas Skelly,2022-02-19,Mark Striegl,KO/TKO,100,6,0,106
Chas Skelly,2016-09-17,Maximo Blanco,Submission,90,1,0,91
Josh Parisian,2021-06-19,Roque Martinez,Decision - Split,70,15,0,85
Josh Parisian,2023-08-12,Martin Buday,Submission,0,0,0,0
Josh Parisian,2024-03-09,Robelis Despaigne,KO/TKO,0,0,0,0
Josh Parisian,2022-06-25,Alan Baudot,KO/TKO,100,0,0,100
Josh Parisian,2021-12-18,Don'Tale Mayes,KO/TKO,0,0,0,0
Josh Parisian,2023-02-18,Jamal Pogues,Decision - Unanimous,0,4,0,4
Josh Parisian,2020-08-18,Chad Johnson,KO/TKO,100,7,0,107
Josh Parisian,2018-06-26,Greg Rebello,KO/TKO,100,4,0,104
Josh Parisian,2020-11-28,Parker Porter,Decision - Unanimous,0,0,0,0
Wellington Turman,2020-08-08,Andrew Sanchez,KO/TKO,0,0,0,0
Wellington Turman,2021-06-19,Bruno Silva,KO/TKO,0,0,0,0
Wellington Turman,2019-07-13,Karl Roberson,Decision - Split,0,0,0,0
Wellington Turman,2019-11-16,Markus Perez,Decision - Unanimous,80,0,0,80
Wellington Turman,2022-11-12,Andre Petroski,Decision - Unanimous,0,0,0,0
Wellington Turman,2021-08-28,Sam Alvey,Decision - Split,70,1,0,71
Wellington Turman,2023-06-24,Randy Brown,Decision - Unanimous,0,0,0,0
Wellington Turman,2023-12-02,Jared Gooden,Submission,0,0,0,0
Wellington Turman,2022-02-26,Misha Cirkunov,Submission,90,0,0,90
Ben Saunders,2015-07-25,Kenny Robertson,Decision - Split,70,7,0,77
Ben Saunders,2009-06-13,Mike Swick,KO/TKO,0,7,0,7
Ben Saunders,2010-03-27,Jon Fitch,Decision - Unanimous,0,0,0,0
Ben Saunders,2014-08-23,Chris Heatherly,Submission,90,0,0,90
Ben Saunders,2018-11-03,Lyman Good,KO/TKO,0,0,0,0
Ben Saunders,2018-06-01,Jake Ellenberger,KO/TKO,100,5,0,105
Ben Saunders,2018-09-22,Sergio Moraes,Submission,0,0,0,0
Ben Saunders,2016-01-17,Patrick Cote,KO/TKO,0,0,0,0
Ben Saunders,2019-12-14,Matt Brown,KO/TKO,0,0,0,0
Ben Saunders,2010-08-07,Dennis Hallman,Decision - Unanimous,0,2,0,2
Ben Saunders,2017-01-15,Court McGee,Decision - Unanimous,80,0,0,80
Ben Saunders,2017-05-28,Peter Sobotta,KO/TKO,0,0,0,0
Ben Saunders,2019-04-27,Takashi Sato,KO/TKO,0,18,0,18
Ben Saunders,2007-12-08,Dan Barrera,Decision - Unanimous,80,6,0,86
Ben Saunders,2008-12-10,Brandon Wolff,KO/TKO,100,42,0,142
Ben Saunders,2008-08-09,Ryan Thomas,Submission,90,29,0,119
Ben Saunders,2014-12-13,Joe Riggs,Submission,90,2,0,92
Ben Saunders,2009-11-21,Marcus Davis,KO/TKO,100,14,0,114
Ben Saunders,2018-02-24,Alan Jouban,KO/TKO,0,0,0,0
Mizuto Hirota,2018-02-10,Ross Pearson,Decision - Unanimous,0,19,0,19
Mizuto Hirota,2017-06-10,Alexander Volkanovski,Decision - Unanimous,0,0,0,0
Mizuto Hirota,2009-12-31,Shinya Aoki,Submission,0,0,0,0
Mizuto Hirota,2018-12-01,Christos Giagos,Decision - Unanimous,0,0,0,0
Mizuto Hirota,2016-12-17,Cole Miller,Decision - Unanimous,80,36,0,116
Mizuto Hirota,2012-07-14,Pat Healy,Decision - Unanimous,0,0,0,0
Mizuto Hirota,2013-06-08,Rodrigo Damm,Decision - Split,0,26,0,26
Mizuto Hirota,2013-03-02,Rani Yahya,Decision - Unanimous,0,0,0,0
Jeremy Jackson,2002-06-22,Joe Stevenson,KO/TKO,0,0,0,0
Jeremy Jackson,2003-09-26,Nick Diaz,Submission,0,0,0,0
Jeremy Jackson,2006-11-11,Pete Spratt,Submission,0,0,0,0
Liliya Shakirova,2020-10-24,Lauren Murphy,Submission,0,1,0,1
Claudia Gadelha,2017-09-22,Jessica Andrade,Decision - Unanimous,0,0,0,0
Claudia Gadelha,2018-12-08,Nina Nunes,Decision - Unanimous,0,0,0,0
Claudia Gadelha,2018-06-09,Carla Esparza,Decision - Split,70,0,0,70
Claudia Gadelha,2020-11-07,Yan Xiaonan,Decision - Unanimous,0,0,0,0
Claudia Gadelha,2019-07-06,Randa Markos,Decision - Unanimous,80,15,0,95
Claudia Gadelha,2014-12-13,Joanna Jedrzejczyk,Decision - Split,0,0,0,0
Claudia Gadelha,2016-07-08,Joanna Jedrzejczyk,Decision - Unanimous,0,0,25,25
Claudia Gadelha,2014-07-16,Tina Lahdemaki,Decision - Unanimous,80,41,0,121
Claudia Gadelha,2017-06-03,Karolina Kowalkiewicz,Submission,90,0,0,90
Claudia Gadelha,2016-11-19,Cortney Casey,Decision - Unanimous,80,12,0,92
Claudia Gadelha,2020-05-16,Angela Hill,Decision - Split,70,0,0,70
Claudia Gadelha,2015-08-01,Jessica Aguilar,Decision - Unanimous,80,41,0,121
Tae Hyun Bang,2015-11-28,Leo Kuntz,Decision - Split,70,23,0,93
Tae Hyun Bang,2014-06-14,Kajan Johnson,KO/TKO,100,5,0,105
Tae Hyun Bang,2016-09-03,Nick Hein,Decision - Unanimous,0,20,0,20
Tae Hyun Bang,2015-05-16,Jon Tuck,Submission,0,0,0,0
Tae Hyun Bang,2014-01-04,Mairbek Taisumov,Decision - Unanimous,0,0,0,0
Leo Kuntz,2015-11-28,Tae Hyun Bang,Decision - Split,0,0,0,0
Leo Kuntz,2015-05-23,Islam Makhachev,Submission,0,0,0,0
Marcin Bandel,2015-04-11,Stevie Ray,KO/TKO,0,0,0,0
Marcin Bandel,2014-10-04,Mairbek Taisumov,KO/TKO,0,0,0,0
Brandon Vera,2005-01-22,Mike Whitehead,TKO - Doctor's Stoppage,0,6,25,31
Brandon Vera,2006-05-27,Assuerio Silva,Submission,90,0,0,90
Brandon Vera,2006-11-18,Frank Mir,KO/TKO,100,13,0,113
Brandon Vera,2009-11-14,Randy Couture,Decision - Unanimous,0,0,0,0
Brandon Vera,2009-03-07,Michael Patt,KO/TKO,100,27,0,127
Brandon Vera,2005-10-03,Fabiano Scherner,KO/TKO,100,18,0,118
Brandon Vera,2009-08-29,Krzysztof Soszynski,Decision - Unanimous,80,21,0,101
Brandon Vera,2008-07-19,Reese Andy,Decision - Unanimous,80,8,0,88
Brandon Vera,2013-08-31,Ben Rothwell,KO/TKO,0,0,0,0
Brandon Vera,2010-03-21,Jon Jones,KO/TKO,0,0,0,0
Brandon Vera,2005-01-22,Andre Mussi,KO/TKO,100,9,0,109
Brandon Vera,2011-10-29,Eliot Marshall,Decision - Unanimous,80,12,0,92
Brandon Vera,2007-10-20,Tim Sylvia,Decision - Unanimous,0,0,0,0
Brandon Vera,2006-02-04,Justin Eilers,KO/TKO,100,3,0,103
Brandon Vera,2012-08-04,Mauricio Rua,KO/TKO,0,0,25,25
Brandon Vera,2008-06-07,Fabricio Werdum,KO/TKO,0,0,0,0
Brandon Vera,2008-10-18,Keith Jardine,Decision - Split,0,0,0,0
Mike Whitehead,2005-01-22,Brandon Vera,TKO - Doctor's Stoppage,0,0,25,25
Mike Whitehead,2009-06-06,Kevin Randleman,Decision - Unanimous,80,15,0,95
Mike Whitehead,2009-12-19,Muhammed Lawal,KO/TKO,0,0,0,0
Mike Whitehead,2006-02-04,Keith Jardine,Decision - Unanimous,0,0,0,0
Mike Whitehead,2008-07-19,Renato Sobral,Decision - Unanimous,0,0,0,0
Marcos Galvao,2009-03-01,Damacio Page,KO/TKO,0,0,0,0
Marcos Galvao,2007-12-12,Brian Bowles,KO/TKO,0,0,0,0
Tyson Pedro,2022-04-23,Ike Villanueva,KO/TKO,100,18,0,118
Tyson Pedro,2024-03-02,Vitor Petrino,Decision - Unanimous,0,3,0,3
Tyson Pedro,2016-11-26,Khalil Rountree Jr.,Submission,90,1,0,91
Tyson Pedro,2023-02-11,Modestas Bukauskas,Decision - Unanimous,0,1,0,1
Tyson Pedro,2018-06-23,Ovince Saint Preux,Submission,0,2,0,2
Tyson Pedro,2018-02-10,Saparbeg Safarov,Submission,90,4,0,94
Tyson Pedro,2017-03-04,Paul Craig,KO/TKO,100,11,0,111
Tyson Pedro,2017-09-09,Ilir Latifi,Decision - Unanimous,0,0,0,0
Tyson Pedro,2022-08-20,Harry Hunsucker,KO/TKO,100,4,0,104
Tyson Pedro,2023-09-09,Anton Turkalj,KO/TKO,100,8,0,108
Tyson Pedro,2018-12-01,Mauricio Rua,KO/TKO,0,1,0,1
Ike Villanueva,2022-04-23,Tyson Pedro,KO/TKO,0,0,0,0
Ike Villanueva,2021-10-23,Nicolae Negumereanu,KO/TKO,0,0,0,0
Ike Villanueva,2021-06-26,Marcin Prachnio,KO/TKO,0,0,0,0
Ike Villanueva,2020-05-13,Chase Sherman,KO/TKO,0,0,0,0
Ike Villanueva,2021-01-20,Vinicius Moreira,KO/TKO,100,0,0,100
Ike Villanueva,2020-08-22,Jordan Wright,TKO - Doctor's Stoppage,0,0,0,0
TJ Grant,2013-01-26,Matt Wiman,KO/TKO,100,36,0,136
TJ Grant,2010-05-08,Johny Hendricks,Decision - Majority,0,14,0,14
TJ Grant,2011-10-01,Shane Roller,Submission,90,14,0,104
TJ Grant,2009-07-11,Dong Hyun Kim,Decision - Unanimous,0,0,0,0
TJ Grant,2010-09-25,Julio Paulino,Decision - Unanimous,80,5,0,85
TJ Grant,2013-05-25,Gray Maynard,KO/TKO,100,13,0,113
TJ Grant,2009-12-12,Kevin Burns,KO/TKO,100,14,0,114
TJ Grant,2012-09-22,Evan Dunham,Decision - Unanimous,80,4,0,84
TJ Grant,2012-05-15,Carlo Prater,Decision - Unanimous,80,41,0,121
TJ Grant,2010-12-11,Ricardo Almeida,Decision - Unanimous,0,0,0,0
TJ Grant,2009-04-18,Ryo Chonan,Decision - Split,70,3,0,73
Joe Proctor,2012-06-01,Jeremy Larsen,KO/TKO,100,0,0,100
Joe Proctor,2014-12-12,Yancy Medeiros,Submission,0,0,0,0
Joe Proctor,2014-02-15,Cristiano Marcello,Decision - Unanimous,80,41,0,121
Joe Proctor,2014-07-16,Justin Salas,KO/TKO,100,0,0,100
Joe Proctor,2012-12-08,Ramsey Nijem,Decision - Unanimous,0,0,0,0
Joe Proctor,2017-04-22,Bryan Barberena,KO/TKO,0,0,0,0
Joe Proctor,2015-12-12,Magomed Mustafaev,KO/TKO,0,0,0,0
Joe Proctor,2015-06-06,Justin Edwards,Submission,90,4,0,94
Austin Hubbard,2024-10-05,Alexander Hernandez,Decision - Split,0,0,0,0
Austin Hubbard,2020-06-20,Max Rohskopf,TKO - Doctor's Stoppage,0,41,0,41
Austin Hubbard,2019-09-14,Kyle Prepolec,Decision - Unanimous,80,7,0,87
Austin Hubbard,2021-04-17,Dakota Bush,Decision - Unanimous,80,26,0,106
Austin Hubbard,2021-08-21,Vinc Pichel,Decision - Unanimous,0,0,0,0
Austin Hubbard,2024-04-27,Michal Figlak,Decision - Unanimous,80,0,0,80
Austin Hubbard,2019-05-18,Davi Ramos,Decision - Unanimous,0,0,0,0
Austin Hubbard,2023-08-19,Kurt Holobaugh,Submission,0,0,0,0
Austin Hubbard,2020-03-07,Mark Madsen,Decision - Unanimous,0,26,0,26
Austin Hubbard,2020-08-22,Joe Solecki,Submission,0,0,0,0
Murilo Bustamante,2006-11-05,Dong Sik Yoon,Decision - Unanimous,80,0,0,80
Murilo Bustamante,2002-01-11,Dave Menne,KO/TKO,100,0,25,125
Murilo Bustamante,2005-09-25,Ikuhisa Minowa,KO/TKO,100,14,0,114
Murilo Bustamante,2000-04-14,Yoji Anjo,Submission,90,11,0,101
Murilo Bustamante,2001-09-28,Chuck Liddell,Decision - Unanimous,0,0,0,0
Murilo Bustamante,2005-09-25,Masanori Suda,Submission,90,0,0,90
Murilo Bustamante,2003-11-09,Dan Henderson,KO/TKO,0,0,0,0
Murilo Bustamante,2004-08-15,Kazuhiro Nakamura,Decision - Unanimous,0,0,0,0
Murilo Bustamante,2003-08-10,Quinton Jackson,Decision - Split,0,0,0,0
Murilo Bustamante,2005-12-31,Dan Henderson,Decision - Split,0,0,0,0
Murilo Bustamante,2005-04-03,Ryuta Sakurai,Decision - Unanimous,80,25,0,105
Murilo Bustamante,2006-06-04,Amar Suloev,Decision - Unanimous,0,0,0,0
Murilo Bustamante,2002-05-10,Matt Lindland,Submission,90,0,25,115
Dong Sik Yoon,2006-11-05,Murilo Bustamante,Decision - Unanimous,0,1,0,1
Dong Sik Yoon,2009-10-25,Tarec Saffiedine,Decision - Split,70,0,0,70
Dong Sik Yoon,2008-06-15,Gegard Mousasi,Decision - Unanimous,0,0,0,0
Dong Sik Yoon,2005-04-23,Kazushi Sakuraba,KO/TKO,0,0,0,0
Dong Sik Yoon,2006-02-26,Quinton Jackson,Decision - Unanimous,0,0,0,0
Dong Sik Yoon,2008-09-23,Andrews Nakahara,KO/TKO,0,0,0,0
Dong Sik Yoon,2008-04-29,Shungo Oyama,Decision - Unanimous,80,14,0,94
Dong Sik Yoon,2005-10-23,Makoto Takimoto,Decision - Unanimous,0,0,0,0
Dong Sik Yoon,2009-07-20,Jesse Taylor,Submission,0,0,0,0
JJ Aldrich,2021-03-13,Cortney Casey,Decision - Split,70,0,0,70
JJ Aldrich,2018-08-04,Polyana Viana,Decision - Unanimous,80,0,0,80
JJ Aldrich,2024-05-11,Veronica Hardy,Decision - Unanimous,0,0,0,0
JJ Aldrich,2023-10-07,Montana De La Rosa,Decision - Unanimous,80,0,0,80
JJ Aldrich,2017-06-10,Chan-Mi Jeon,Decision - Unanimous,80,6,0,86
JJ Aldrich,2018-01-14,Danielle Taylor,Decision - Unanimous,80,16,0,96
JJ Aldrich,2020-01-18,Sabina Mazo,Decision - Split,0,0,0,0
JJ Aldrich,2023-03-11,Ariane da Silva,Decision - Unanimous,0,0,0,0
JJ Aldrich,2016-12-09,Juliana Lima,Decision - Unanimous,0,0,0,0
JJ Aldrich,2019-10-12,Lauren Mueller,Decision - Unanimous,80,20,0,100
JJ Aldrich,2022-06-04,Erin Blanchfield,Submission,0,0,0,0
JJ Aldrich,2019-03-23,Maycee Barber,KO/TKO,0,0,0,0
JJ Aldrich,2021-08-28,Vanessa Demopoulos,Decision - Unanimous,80,23,0,103
JJ Aldrich,2022-03-12,Gillian Robertson,Decision - Unanimous,80,8,0,88
JJ Aldrich,2023-08-26,Liang Na,KO/TKO,100,36,0,136
Naoyuki Kotani,2007-04-05,Thiago Tavares,Decision - Unanimous,0,0,0,0
Naoyuki Kotani,2015-09-26,Kajan Johnson,Decision - Unanimous,0,0,0,0
Naoyuki Kotani,2005-09-25,Luiz Azeredo,KO/TKO,0,0,0,0
Naoyuki Kotani,2014-07-19,Norman Parke,KO/TKO,0,0,0,0
Naoyuki Kotani,2007-09-08,Dennis Siver,KO/TKO,0,0,0,0
Naoyuki Kotani,2014-10-25,Yan Cabral,Submission,0,0,0,0
Kyle Daukaus,2022-06-18,Roman Dolidze,KO/TKO,0,0,0,0
Kyle Daukaus,2020-06-27,Brendan Allen,Decision - Unanimous,0,0,0,0
Kyle Daukaus,2022-12-03,Eryk Anders,KO/TKO,0,0,0,0
Kyle Daukaus,2019-06-25,Michael Lombardo,Decision - Unanimous,80,44,0,124
Kyle Daukaus,2022-02-19,Jamie Pickett,Submission,90,1,0,91
Kyle Daukaus,2020-11-21,Dustin Stoltzfus,Decision - Unanimous,80,32,0,112
Kyle Daukaus,2021-05-08,Phil Hawes,Decision - Unanimous,0,0,0,0
Goran Reljic,2010-02-20,CB Dollaway,Decision - Unanimous,0,0,0,0
Goran Reljic,2008-05-24,Wilson Gouveia,KO/TKO,100,0,0,100
Goran Reljic,2010-11-13,Krzysztof Soszynski,Decision - Unanimous,0,0,0,0
Goran Reljic,2010-07-03,Kendall Grove,Decision - Split,0,0,0,0
Ovince Saint Preux,2014-11-08,Mauricio Rua,KO/TKO,100,7,25,132
Ovince Saint Preux,2010-11-19,Antwain Britt,Decision - Unanimous,80,23,0,103
Ovince Saint Preux,2014-06-14,Ryan Jimmo,KO/TKO,100,0,0,100
Ovince Saint Preux,2014-08-16,Ryan Bader,Decision - Unanimous,0,0,25,25
Ovince Saint Preux,2011-01-07,Abongo Humphrey,Decision - Unanimous,80,11,0,91
Ovince Saint Preux,2021-06-26,Tanner Boser,KO/TKO,0,0,0,0
Ovince Saint Preux,2019-04-13,Nikita Krylov,Submission,0,0,0,0
Ovince Saint Preux,2017-09-22,Yushin Okami,Submission,90,0,25,115
Ovince Saint Preux,2015-04-18,Patrick Cummins,KO/TKO,100,4,0,104
Ovince Saint Preux,2022-05-07,Mauricio Rua,Decision - Split,70,8,0,78
Ovince Saint Preux,2018-06-23,Tyson Pedro,Submission,90,0,0,90
Ovince Saint Preux,2019-09-28,Michal Oleksiejczuk,Submission,90,0,0,90
Ovince Saint Preux,2018-02-24,Ilir Latifi,Submission,0,0,0,0
Ovince Saint Preux,2011-07-22,Joe Cason,KO/TKO,100,8,0,108
Ovince Saint Preux,2020-12-05,Jamahal Hill,KO/TKO,0,0,0,0
Ovince Saint Preux,2011-12-17,Gegard Mousasi,Decision - Unanimous,0,0,0,0
Ovince Saint Preux,2012-08-18,TJ Cook,KO/TKO,100,10,0,110
Ovince Saint Preux,2017-11-04,Corey Anderson,KO/TKO,100,0,0,100
Ovince Saint Preux,2024-10-05,Ryan Spann,Submission,0,0,0,0
Ovince Saint Preux,2017-04-22,Marcos Rogerio de Lima,Submission,90,4,0,94
Ovince Saint Preux,2013-04-27,Gian Villante,Decision - Majority,75,19,0,94
Ovince Saint Preux,2013-08-17,Cody Donovan,KO/TKO,100,0,0,100
Ovince Saint Preux,2016-10-08,Jimi Manuwa,KO/TKO,0,0,0,0
Ovince Saint Preux,2023-02-18,Philipe Lins,KO/TKO,0,0,0,0
Ovince Saint Preux,2018-10-06,Dominick Reyes,Decision - Unanimous,0,0,0,0
Ovince Saint Preux,2020-05-13,Ben Rothwell,Decision - Split,0,0,0,0
Ovince Saint Preux,2016-02-06,Rafael Cavalcante,Decision - Unanimous,80,41,0,121
Ovince Saint Preux,2017-02-04,Volkan Oezdemir,Decision - Split,0,0,0,0
Ovince Saint Preux,2024-03-16,Kennedy Nzechukwu,Decision - Split,70,37,0,107
Ovince Saint Preux,2010-12-04,Benji Radach,Decision - Unanimous,80,60,0,140
Ovince Saint Preux,2015-08-08,Glover Teixeira,Submission,0,0,25,25
Ovince Saint Preux,2014-03-15,Nikita Krylov,Submission,90,0,0,90
Ovince Saint Preux,2020-09-05,Alonzo Menifield,KO/TKO,100,14,0,114
Ovince Saint Preux,2016-04-23,Jon Jones,Decision - Unanimous,0,0,25,25
Abdul-Kareem Al-Selwady,2023-08-15,George Hardwick,Decision - Unanimous,80,15,0,95
Abdul-Kareem Al-Selwady,2024-03-02,Loik Radzhabov,KO/TKO,0,0,0,0
George Hardwick,2023-08-15,Abdul-Kareem Al-Selwady,Decision - Unanimous,0,0,0,0
Peter Sobotta,2014-05-31,Pawel Pawlak,Decision - Unanimous,80,26,0,106
Peter Sobotta,2018-03-17,Leon Edwards,KO/TKO,0,0,0,0
Peter Sobotta,2010-06-12,James Wilks,Decision - Unanimous,0,0,0,0
Peter Sobotta,2017-05-28,Ben Saunders,KO/TKO,100,27,0,127
Peter Sobotta,2009-06-13,Paul Taylor,Decision - Unanimous,0,0,0,0
Peter Sobotta,2010-11-13,Amir Sadollah,Decision - Unanimous,0,0,0,0
Peter Sobotta,2015-11-14,Kyle Noke,KO/TKO,0,0,0,0
Peter Sobotta,2016-09-03,Nicolas Dalby,Decision - Unanimous,80,24,0,104
Peter Sobotta,2020-07-25,Alex Oliveira,Decision - Unanimous,0,0,0,0
Peter Sobotta,2015-06-20,Steve Kennedy,Submission,90,3,0,93
Pawel Pawlak,2014-05-31,Peter Sobotta,Decision - Unanimous,0,0,0,0
Pawel Pawlak,2015-07-18,Leon Edwards,Decision - Unanimous,0,0,0,0
Pawel Pawlak,2015-04-11,Sheldon Westcott,Decision - Unanimous,80,13,0,93
Jonathan Brookins,2012-12-15,Dustin Poirier,Submission,0,0,0,0
Jonathan Brookins,2010-12-04,Michael Johnson,Decision - Unanimous,80,2,0,82
Jonathan Brookins,2011-09-17,Erik Koch,Decision - Unanimous,0,0,0,0
Jonathan Brookins,2008-11-05,Jose Aldo,KO/TKO,0,0,0,0
Jonathan Brookins,2012-02-15,Vagner Rocha,KO/TKO,100,11,0,111
Jonathan Brookins,2012-06-01,Charles Oliveira,Submission,0,0,0,0
Jeff Hougland,2012-11-10,Takeya Mizugaki,Decision - Unanimous,0,0,0,0
Jeff Hougland,2012-05-15,Yves Jabouin,Decision - Unanimous,0,0,0,0
Jeff Hougland,2003-03-27,Gilbert Melendez,KO/TKO,0,0,0,0
Jeff Hougland,2011-07-02,Donny Walker,Decision - Unanimous,80,30,0,110
Tokimitsu Ishizawa,2001-07-29,Ryan Gracie,KO/TKO,100,2,0,102
Tokimitsu Ishizawa,2000-08-27,Ryan Gracie,KO/TKO,0,0,0,0
Tokimitsu Ishizawa,2009-10-25,Katsuyori Shibata,KO/TKO,0,0,0,0
Tokimitsu Ishizawa,2006-03-15,Yoshihiro Akiyama,Submission,0,0,0,0
Ryan Gracie,2001-07-29,Tokimitsu Ishizawa,KO/TKO,0,0,0,0
Ryan Gracie,2000-08-27,Tokimitsu Ishizawa,KO/TKO,100,8,0,108
Ryan Gracie,2002-09-29,Shungo Oyama,Submission,90,0,0,90
Ryan Gracie,2003-10-05,Kazuhiro Hamanaka,KO/TKO,100,8,0,108
Ryan Gracie,2004-05-23,Ikuhisa Minowa,Decision - Split,70,0,0,70
Ryan Gracie,2000-12-09,Kazushi Sakuraba,Decision - Unanimous,0,0,0,0
Ryan Gracie,2004-12-31,Yoji Anjo,Submission,90,19,0,109
Gilles Arsene,2002-11-24,Kazushi Sakuraba,Submission,0,0,0,0
Diego Nunes,2010-06-20,Raphael Assuncao,Decision - Split,70,3,0,73
Diego Nunes,2010-09-30,Tyler Toner,Decision - Unanimous,80,5,0,85
Diego Nunes,2008-12-03,Cole Province,Decision - Unanimous,80,31,0,111
Diego Nunes,2011-06-11,Kenny Florian,Decision - Unanimous,0,0,0,0
Diego Nunes,2012-10-05,Bart Palaszewski,Decision - Unanimous,80,24,0,104
Diego Nunes,2011-01-01,Mike Brown,Decision - Split,70,0,0,70
Diego Nunes,2009-11-18,LC Davis,Decision - Unanimous,0,0,0,0
Diego Nunes,2013-01-19,Nik Lentz,Decision - Unanimous,0,0,0,0
Diego Nunes,2011-12-30,Manvel Gamburyan,Decision - Unanimous,80,23,0,103
Diego Nunes,2012-04-14,Dennis Siver,Decision - Unanimous,0,0,0,0
Diego Nunes,2009-08-09,Rafael Dias,Decision - Unanimous,80,28,0,108
Siyar Bahadurzada,2016-03-05,Brandon Thatch,Submission,90,54,0,144
Siyar Bahadurzada,2013-03-02,Dong Hyun Kim,Decision - Unanimous,0,0,0,0
Siyar Bahadurzada,2018-04-21,Luan Chagas,KO/TKO,100,22,0,122
Siyar Bahadurzada,2013-12-28,John Howard,Decision - Unanimous,0,0,0,0
Siyar Bahadurzada,2012-04-14,Paulo Thiago,KO/TKO,100,3,0,103
Siyar Bahadurzada,2017-09-02,Rob Wilkinson,KO/TKO,100,19,0,119
Siyar Bahadurzada,2018-12-29,Curtis Millender,Decision - Unanimous,0,0,0,0
Siyar Bahadurzada,2019-09-28,Ismail Naurdiev,Decision - Unanimous,0,0,0,0
Sheymon Moraes,2018-08-04,Matt Sayles,Decision - Unanimous,80,0,0,80
Sheymon Moraes,2019-07-13,Andre Fili,KO/TKO,0,0,0,0
Sheymon Moraes,2019-03-30,Sodiq Yusuff,Decision - Unanimous,0,0,0,0
Sheymon Moraes,2017-11-25,Zabit Magomedsharipov,Submission,0,0,0,0
Sheymon Moraes,2018-11-03,Julio Arce,Decision - Split,70,7,0,77
Jamie Pickett,2022-01-15,Joseph Holmes,Decision - Unanimous,80,0,0,80
Jamie Pickett,2020-08-25,Jhonoven Pati,KO/TKO,100,18,0,118
Jamie Pickett,2023-08-12,Josh Fremd,Decision - Unanimous,0,0,0,0
Jamie Pickett,2022-02-19,Kyle Daukaus,Submission,0,0,0,0
Jamie Pickett,2021-10-23,Laureano Staropoli,Decision - Unanimous,80,22,0,102
Jamie Pickett,2022-09-10,Denis Tiuliulin,KO/TKO,0,0,0,0
Jamie Pickett,2021-05-15,Jordan Wright,KO/TKO,0,0,0,0
Jamie Pickett,2024-03-02,Eryk Anders,Decision - Unanimous,0,0,0,0
Jamie Pickett,2023-03-04,Bo Nickal,Submission,0,0,0,0
Jamie Pickett,2017-07-11,Charles Byrd,Submission,0,0,0,0
Jamie Pickett,2020-12-19,Tafon Nchukwi,Decision - Unanimous,0,0,0,0
Jamie Pickett,2019-06-18,Punahele Soriano,Decision - Unanimous,0,0,0,0
Joseph Holmes,2022-01-15,Jamie Pickett,Decision - Unanimous,0,1,0,1
Joseph Holmes,2022-10-29,JunYong Park,Submission,0,2,0,2
Joseph Holmes,2022-05-21,Alen Amedovski,Submission,90,15,0,105
Joseph Holmes,2023-05-06,Claudio Ribeiro,KO/TKO,0,0,0,0
Joseph Holmes,2021-10-05,Shonte Barnes,Submission,90,0,0,90
Marvin Vettori,2020-06-13,Karl Roberson,Submission,90,41,0,131
Marvin Vettori,2021-04-10,Kevin Holland,Decision - Unanimous,80,0,25,105
Marvin Vettori,2019-10-12,Andrew Sanchez,Decision - Unanimous,80,46,0,126
Marvin Vettori,2022-09-03,Robert Whittaker,Decision - Unanimous,0,0,0,0
Marvin Vettori,2018-04-14,Israel Adesanya,Decision - Split,0,0,0,0
Marvin Vettori,2019-07-13,Cezar Ferreira,Decision - Unanimous,80,39,0,119
Marvin Vettori,2021-10-23,Paulo Costa,Decision - Unanimous,80,27,25,132
Marvin Vettori,2016-12-30,Antonio Carlos Junior,Decision - Unanimous,0,1,0,1
Marvin Vettori,2021-06-12,Israel Adesanya,Decision - Unanimous,0,0,25,25
Marvin Vettori,2023-03-18,Roman Dolidze,Decision - Unanimous,80,35,0,115
Marvin Vettori,2016-08-20,Alberto Uda,Submission,90,6,0,96
Marvin Vettori,2017-06-25,Vitor Miranda,Decision - Unanimous,80,18,0,98
Marvin Vettori,2020-12-05,Jack Hermansson,Decision - Unanimous,80,42,25,147
Marvin Vettori,2023-06-17,Jared Cannonier,Decision - Unanimous,0,0,25,25
Eric Smith,1997-06-15,Dan Henderson,Submission,0,0,0,0
Ketlen Vieira,2020-09-26,Sijara Eubanks,Decision - Unanimous,80,0,0,80
Ketlen Vieira,2019-12-14,Irene Aldana,KO/TKO,0,0,0,0
Ketlen Vieira,2021-02-20,Yana Santos,Decision - Unanimous,0,0,0,0
Ketlen Vieira,2023-07-22,Pannie Kianzad,Decision - Unanimous,80,0,0,80
Ketlen Vieira,2024-10-05,Kayla Harrison,Decision - Unanimous,0,0,0,0
Ketlen Vieira,2016-10-01,Kelly Faszholz,Decision - Split,70,0,0,70
Ketlen Vieira,2017-04-15,Ashlee Evans-Smith,Decision - Unanimous,80,3,0,83
Ketlen Vieira,2017-09-09,Sara McMann,Submission,90,0,0,90
Ketlen Vieira,2022-05-21,Holly Holm,Decision - Split,70,0,25,95
Ketlen Vieira,2023-01-14,Raquel Pennington,Decision - Split,0,0,0,0
Ketlen Vieira,2018-03-03,Cat Zingano,Decision - Split,70,0,0,70
Ketlen Vieira,2021-11-20,Miesha Tate,Decision - Unanimous,80,0,25,105
Jay Silva,2009-09-16,CB Dollaway,Decision - Unanimous,0,0,0,0
Jay Silva,2010-01-11,Chris Leben,Decision - Unanimous,0,0,0,0
Steven Siler,2012-11-17,Darren Elkins,Decision - Unanimous,0,0,0,0
Steven Siler,2013-11-06,Dennis Bermudez,Decision - Unanimous,0,0,0,0
Steven Siler,2012-06-22,Joey Gambino,Submission,90,7,0,97
Steven Siler,2014-03-23,Rony Jason,KO/TKO,0,8,0,8
Steven Siler,2013-04-27,Kurt Holobaugh,Decision - Unanimous,80,9,0,89
Steven Siler,2014-07-26,Noad Lahat,Decision - Unanimous,0,9,0,9
Steven Siler,2012-03-02,Cole Miller,Decision - Unanimous,80,9,0,89
Steven Siler,2011-12-03,Josh Clopton,Decision - Unanimous,80,29,0,109
Steven Siler,2013-08-17,Mike Brown,KO/TKO,100,3,0,103
Misha Cirkunov,2017-12-16,Glover Teixeira,KO/TKO,0,8,0,8
Misha Cirkunov,2021-10-02,Krzysztof Jotko,Decision - Split,0,0,0,0
Misha Cirkunov,2018-10-27,Patrick Cummins,Submission,90,8,0,98
Misha Cirkunov,2019-09-14,Jimmy Crute,Submission,90,0,0,90
Misha Cirkunov,2016-06-18,Ion Cutelaba,Submission,90,20,0,110
Misha Cirkunov,2019-03-02,Johnny Walker,KO/TKO,0,0,0,0
Misha Cirkunov,2017-05-28,Volkan Oezdemir,KO/TKO,0,4,0,4
Misha Cirkunov,2022-10-15,Alonzo Menifield,KO/TKO,0,0,0,0
Misha Cirkunov,2021-03-13,Ryan Spann,KO/TKO,0,0,0,0
Misha Cirkunov,2016-02-06,Alex Nicholson,Submission,90,16,0,106
Misha Cirkunov,2015-08-23,Daniel Jolly,KO/TKO,100,18,0,118
Misha Cirkunov,2016-12-10,Nikita Krylov,Submission,90,0,0,90
Misha Cirkunov,2022-02-26,Wellington Turman,Submission,0,15,0,15
Danilo Marques,2022-02-05,Jailton Almeida,KO/TKO,0,0,0,0
Danilo Marques,2020-09-26,Khadis Ibragimov,Decision - Unanimous,80,0,0,80
Danilo Marques,2021-02-06,Mike Rodriguez,Submission,90,13,0,103
Danilo Marques,2021-06-26,Kennedy Nzechukwu,KO/TKO,0,0,0,0
Andre Muniz,2020-09-05,Bartosz Fabinski,Submission,90,0,0,90
Andre Muniz,2021-05-15,Jacare Souza,Submission,90,0,0,90
Andre Muniz,2018-08-11,Bruno Assis,Decision - Unanimous,80,29,0,109
Andre Muniz,2022-07-02,Uriah Hall,Decision - Unanimous,80,11,0,91
Andre Muniz,2023-07-22,Paul Craig,KO/TKO,0,0,0,0
Andre Muniz,2019-11-16,Antonio Arroyo,Decision - Unanimous,80,0,0,80
Andre Muniz,2023-02-25,Brendan Allen,Submission,0,1,0,1
Andre Muniz,2019-08-06,Taylor Johnson,Submission,90,0,0,90
Andre Muniz,2023-12-09,JunYong Park,Decision - Split,70,0,0,70
Andre Muniz,2021-12-11,Eryk Anders,Submission,90,5,0,95
Bartosz Fabinski,2020-09-05,Andre Muniz,Submission,0,1,0,1
Bartosz Fabinski,2018-07-22,Emil Meek,Decision - Unanimous,80,14,0,94
Bartosz Fabinski,2015-04-11,Garreth McLellan,Decision - Unanimous,80,28,0,108
Bartosz Fabinski,2021-04-17,Gerald Meerschaert,Submission,0,0,0,0
Bartosz Fabinski,2018-11-17,Michel Prazeres,Submission,0,0,0,0
Bartosz Fabinski,2015-11-21,Hector Urbina,Decision - Unanimous,80,15,0,95
Aleksandra Albu,2017-07-29,Kailin Curran,Decision - Unanimous,80,0,0,80
Aleksandra Albu,2019-02-17,Emily Whitmire,Submission,0,0,0,0
Aleksandra Albu,2015-04-11,Izabela Badurek,Submission,90,10,0,100
Aleksandra Albu,2019-10-26,Loma Lookboonmee,Decision - Split,0,0,0,0
Kailin Curran,2017-07-29,Aleksandra Albu,Decision - Unanimous,0,4,0,4
Kailin Curran,2014-11-22,Paige VanZant,KO/TKO,0,0,0,0
Kailin Curran,2015-05-09,Alex Chambers,Submission,0,37,0,37
Kailin Curran,2015-12-10,Emily Kagan,Submission,90,0,0,90
Kailin Curran,2016-12-03,Jamie Moyle,Decision - Unanimous,0,0,0,0
Kailin Curran,2016-07-23,Felice Herrig,Submission,0,0,0,0
Kailin Curran,2017-11-25,Yan Xiaonan,Decision - Unanimous,0,0,0,0
Syuri Kondo,2018-11-24,Yan Xiaonan,Decision - Unanimous,0,0,0,0
Syuri Kondo,2018-05-19,Poliana Botelho,KO/TKO,0,0,0,0
Syuri Kondo,2019-06-22,Ashley Yoder,Decision - Unanimous,0,0,0,0
Syuri Kondo,2017-09-22,Chan-Mi Jeon,Decision - Split,70,40,0,110
Bazigit Atajev,2002-12-23,Alistair Overeem,KO/TKO,0,0,0,0
Jason MacDonald,2007-06-16,Rory Singer,KO/TKO,100,13,0,113
Jason MacDonald,2007-10-20,Yushin Okami,Decision - Unanimous,0,0,0,0
Jason MacDonald,2010-05-08,John Salter,KO/TKO,0,2,0,2
Jason MacDonald,2011-09-17,Alan Belcher,KO/TKO,0,0,0,0
Jason MacDonald,2008-04-19,Joe Doerksen,KO/TKO,100,9,0,109
Jason MacDonald,2008-09-06,Jason Lambert,Submission,90,9,0,99
Jason MacDonald,2009-04-18,Nate Quarry,KO/TKO,0,0,0,0
Jason MacDonald,2011-04-30,Ryan Jensen,Submission,90,0,0,90
Jason MacDonald,2012-05-15,Tom Lawlor,KO/TKO,0,0,0,0
Jason MacDonald,2006-12-30,Chris Leben,Submission,90,0,0,90
Jason MacDonald,2007-03-03,Rich Franklin,KO/TKO,0,0,0,0
Jason MacDonald,2008-08-09,Demian Maia,Submission,0,0,0,0
Jason MacDonald,2006-10-10,Ed Herman,Submission,90,3,0,93
Jason MacDonald,2008-12-13,Wilson Gouveia,KO/TKO,0,0,0,0
Rory Singer,2007-06-16,Jason MacDonald,KO/TKO,0,0,0,0
Rory Singer,2006-10-10,Josh Haynes,Decision - Unanimous,80,27,0,107
Rory Singer,2006-06-24,Ross Pointon,Submission,90,0,0,90
Rory Singer,2006-12-30,Yushin Okami,KO/TKO,0,0,0,0
George Roop,2015-09-26,Takeya Mizugaki,Decision - Unanimous,0,0,0,0
George Roop,2013-11-06,Francisco Rivera,KO/TKO,0,0,0,0
George Roop,2012-01-28,Cub Swanson,KO/TKO,0,0,0,0
George Roop,2014-07-05,Rob Font,KO/TKO,0,0,0,0
George Roop,2011-01-22,Mark Hominick,KO/TKO,0,3,0,3
George Roop,2009-08-08,George Sotiropoulos,Submission,0,0,0,0
George Roop,2013-03-16,Reuben Duran,Decision - Unanimous,80,3,0,83
George Roop,2008-12-13,Shane Nelson,Decision - Split,0,11,0,11
George Roop,2009-05-23,David Kaplan,Decision - Split,70,12,0,82
George Roop,2014-04-16,Dustin Kimura,Decision - Unanimous,80,46,0,126
George Roop,2011-06-04,Josh Grispi,KO/TKO,100,80,0,180
George Roop,2013-05-25,Brian Bowles,KO/TKO,100,20,0,120
George Roop,2010-01-10,Eddie Wineland,Decision - Unanimous,0,0,0,0
George Roop,2011-10-29,Hatsu Hioki,Decision - Split,0,11,0,11
George Roop,2010-09-30,Chan Sung Jung,KO/TKO,100,24,0,124
Roger Huerta,2007-04-07,Leonard Garcia,Decision - Unanimous,80,56,0,136
Roger Huerta,2008-08-09,Kenny Florian,Decision - Unanimous,0,0,0,0
Roger Huerta,2009-09-16,Gray Maynard,Decision - Split,0,17,0,17
Roger Huerta,2007-12-08,Clay Guida,Submission,90,0,0,90
Roger Huerta,2007-08-25,Alberto Crane,KO/TKO,100,22,0,122
Roger Huerta,2006-09-23,Jason Dent,Decision - Unanimous,80,33,0,113
Roger Huerta,2007-02-03,John Halverson,KO/TKO,100,12,0,112
Roger Huerta,2007-06-23,Doug Evans,KO/TKO,100,14,0,114
Terry Martin,2007-09-19,Chris Leben,KO/TKO,0,0,0,0
Terry Martin,2007-02-03,Jorge Rivera,KO/TKO,100,3,0,103
Terry Martin,2008-07-19,Vitor Belfort,KO/TKO,0,0,0,0
Terry Martin,2008-09-20,Cory Devela,KO/TKO,100,0,0,100
Terry Martin,2006-10-12,Keith Berry,KO/TKO,100,16,0,116
Terry Martin,2008-02-02,Marvin Eastman,Decision - Unanimous,0,10,0,10
Terry Martin,2005-08-20,James Irvin,KO/TKO,0,6,0,6
Terry Martin,2006-04-15,Jason Lambert,KO/TKO,0,0,0,0
Terry Martin,2008-11-21,Scott Smith,KO/TKO,0,0,0,0
Terry Martin,2007-05-26,Ivan Salaverry,KO/TKO,100,2,0,102
James Wilks,2010-06-12,Peter Sobotta,Decision - Unanimous,80,23,0,103
James Wilks,2009-11-14,Matt Brown,KO/TKO,0,0,0,0
James Wilks,2010-10-16,Claude Patrick,Decision - Unanimous,0,0,0,0
James Wilks,2009-06-20,DaMarques Johnson,Submission,90,4,0,94
Marco Ruas,1995-09-08,Paul Varelans,KO/TKO,100,23,0,123
Marco Ruas,1995-09-08,Larry Cureton,Submission,90,0,0,90
Marco Ruas,1995-09-08,Remco Pardoel,Submission,90,2,0,92
Marco Ruas,1995-12-16,Oleg Taktarov,Decision - Unanimous,0,8,0,8
Marco Ruas,1999-07-16,Maurice Smith,KO/TKO,0,0,0,0
Marco Ruas,1995-12-16,Keith Hackney,Submission,90,6,0,96
Marco Ruas,1998-03-05,Gary Goodridge,Submission,90,0,0,90
Marco Ruas,1998-10-11,Alexander Otsuka,KO/TKO,0,0,0,0
Paul Varelans,1995-09-08,Marco Ruas,KO/TKO,0,0,0,0
Paul Varelans,1995-12-16,Dan Severn,Submission,0,1,0,1
Paul Varelans,1995-09-08,Gerry Harris,KO/TKO,100,4,0,104
Paul Varelans,1995-09-08,Mark Hall,Submission,90,0,0,90
Paul Varelans,1995-07-14,Cal Worsham,KO/TKO,100,0,0,100
Paul Varelans,1995-07-14,David Abbott,KO/TKO,0,0,0,0
Paul Varelans,1996-02-16,Joe Moreira,Decision - Unanimous,80,0,0,80
Paul Varelans,1996-12-07,Kimo Leopoldo,KO/TKO,0,12,0,12
Naoki Inoue,2017-06-17,Carls John De Tomas,Decision - Unanimous,80,32,0,112
Naoki Inoue,2018-06-23,Matt Schnell,Decision - Split,0,0,0,0
Carls John De Tomas,2017-06-17,Naoki Inoue,Decision - Unanimous,0,0,0,0
Carls John De Tomas,2017-12-09,Alex Perez,Submission,0,0,0,0
Roxanne Modafferi,2021-09-25,Taila Santos,Decision - Unanimous,0,0,0,0
Roxanne Modafferi,2019-07-20,Jennifer Maia,Decision - Unanimous,0,0,0,0
Roxanne Modafferi,2009-11-07,Marloes Coenen,Submission,0,0,0,0
Roxanne Modafferi,2022-02-12,Casey O'Neill,Decision - Split,0,0,0,0
Roxanne Modafferi,2019-04-20,Antonina Shevchenko,Decision - Split,70,0,0,70
Roxanne Modafferi,2021-01-20,Viviane Araujo,Decision - Unanimous,0,0,0,0
Roxanne Modafferi,2018-07-06,Barb Honchak,KO/TKO,100,27,0,127
Roxanne Modafferi,2020-09-12,Andrea Lee,Decision - Unanimous,80,0,0,80
Roxanne Modafferi,2020-01-18,Maycee Barber,Decision - Unanimous,80,3,0,83
Roxanne Modafferi,2018-11-03,Sijara Eubanks,Decision - Unanimous,0,0,0,0
Roxanne Modafferi,2010-07-23,Sarah Kaufman,KO/TKO,0,0,25,25
Roxanne Modafferi,2017-12-01,Nicco Montano,Decision - Unanimous,0,0,25,25
Roxanne Modafferi,2013-11-30,Raquel Pennington,Decision - Unanimous,0,0,0,0
Roxanne Modafferi,2020-06-20,Lauren Murphy,Decision - Unanimous,0,0,0,0
Jan Blachowicz,2017-04-08,Patrick Cummins,Decision - Unanimous,0,0,0,0
Jan Blachowicz,2019-02-23,Thiago Santos,KO/TKO,0,0,25,25
Jan Blachowicz,2019-11-16,Jacare Souza,Decision - Split,70,51,25,146
Jan Blachowicz,2015-04-11,Jimi Manuwa,Decision - Unanimous,0,1,0,1
Jan Blachowicz,2021-10-30,Glover Teixeira,Submission,0,5,25,30
Jan Blachowicz,2018-09-15,Nikita Krylov,Submission,90,6,0,96
Jan Blachowicz,2020-02-15,Corey Anderson,KO/TKO,100,2,25,127
Jan Blachowicz,2023-07-29,Alex Pereira,Decision - Split,0,0,0,0
Jan Blachowicz,2015-09-05,Corey Anderson,Decision - Unanimous,0,0,0,0
Jan Blachowicz,2021-03-06,Israel Adesanya,Decision - Unanimous,80,29,25,134
Jan Blachowicz,2017-10-21,Devin Clark,Submission,90,18,0,108
Jan Blachowicz,2014-10-04,Ilir Latifi,KO/TKO,100,11,0,111
Jan Blachowicz,2018-03-17,Jimi Manuwa,Decision - Unanimous,80,60,0,140
Jan Blachowicz,2022-05-14,Aleksandar Rakic,KO/TKO,100,4,25,129
Jan Blachowicz,2019-07-06,Luke Rockhold,KO/TKO,100,16,0,116
Jan Blachowicz,2020-09-26,Dominick Reyes,KO/TKO,100,20,25,145
Jan Blachowicz,2016-04-10,Igor Pokrajac,Decision - Unanimous,80,63,0,143
Jan Blachowicz,2016-09-03,Alexander Gustafsson,Decision - Unanimous,0,0,0,0
Jan Blachowicz,2017-12-16,Jared Cannonier,Decision - Unanimous,80,24,0,104
Leandro Silva,2014-09-13,Francisco Trinaldo,Decision - Unanimous,0,0,0,0
Leandro Silva,2016-09-03,Rustam Khabilov,Decision - Unanimous,0,5,0,5
Leandro Silva,2015-06-27,Lewis Gonzalez,Decision - Unanimous,80,7,0,87
Leandro Silva,2013-06-08,Ildemar Alcantara,Decision - Unanimous,0,17,0,17
Leandro Silva,2015-11-21,Efrain Escudero,Decision - Unanimous,80,11,0,91
Leandro Silva,2016-06-18,Jason Saggo,Decision - Split,0,0,0,0
Leandro Silva,2014-11-08,Charlie Brenneman,Submission,90,0,0,90
Jacob Volkmann,2011-01-01,Antonio McKee,Decision - Split,70,0,0,70
Jacob Volkmann,2013-02-02,Bobby Green,Submission,0,0,0,0
Jacob Volkmann,2010-03-31,Ronys Torres,Decision - Split,70,4,0,74
Jacob Volkmann,2012-10-05,Shane Roller,Submission,90,8,0,98
Jacob Volkmann,2010-01-02,Martin Kampmann,Submission,0,0,0,0
Jacob Volkmann,2010-08-01,Paul Kelly,Decision - Unanimous,80,8,0,88
Jacob Volkmann,2009-11-21,Paulo Thiago,Decision - Unanimous,0,0,0,0
Jacob Volkmann,2011-12-30,Efrain Escudero,Decision - Unanimous,80,10,0,90
Jacob Volkmann,2012-05-26,Paul Sass,Submission,0,1,0,1
Jacob Volkmann,2011-08-14,Danny Castillo,Decision - Unanimous,80,0,0,80
Antonio McKee,2011-01-01,Jacob Volkmann,Decision - Split,0,15,0,15
Antonio McKee,2012-12-31,Shinya Aoki,KO/TKO,0,0,0,0
Farid Basharat,2022-09-13,Allan Begosso,Decision - Unanimous,80,89,0,169
Farid Basharat,2023-03-04,Da'Mon Blackshear,Decision - Unanimous,80,12,0,92
Farid Basharat,2023-09-02,Kleydson Rodrigues,Submission,90,0,0,90
Farid Basharat,2024-10-26,Victor Hugo,Decision - Unanimous,80,15,0,95
Farid Basharat,2024-01-13,Taylor Lapilus,Decision - Unanimous,80,2,0,82
Allan Begosso,2022-09-13,Farid Basharat,Decision - Unanimous,0,0,0,0
Paige VanZant,2014-11-22,Kailin Curran,KO/TKO,100,33,0,133
Paige VanZant,2015-04-18,Felice Herrig,Decision - Unanimous,80,39,0,119
Paige VanZant,2015-12-10,Rose Namajunas,Submission,0,0,25,25
Paige VanZant,2019-01-19,Rachael Ostovich,Submission,90,7,0,97
Paige VanZant,2020-07-11,Amanda Ribas,Submission,0,0,0,0
Paige VanZant,2016-12-17,Michelle Waterson-Gomez,Submission,0,0,25,25
Paige VanZant,2016-08-27,Bec Rawlings,KO/TKO,100,4,0,104
Paige VanZant,2018-01-14,Jessica-Rose Clark,Decision - Unanimous,0,0,0,0
Paige VanZant,2015-09-05,Alex Chambers,Submission,90,43,0,133
Paul Kelly,2010-11-20,TJ O'Brien,KO/TKO,100,12,0,112
Paul Kelly,2008-01-19,Paul Taylor,Decision - Unanimous,80,27,0,107
Paul Kelly,2009-02-21,Troy Mandaloniz,Decision - Unanimous,80,33,0,113
Paul Kelly,2009-06-13,Rolando Delgado,Decision - Unanimous,80,18,0,98
Paul Kelly,2008-10-18,Marcus Davis,Submission,0,0,0,0
Paul Kelly,2010-04-10,Matt Veach,Submission,90,43,0,133
Paul Kelly,2010-08-01,Jacob Volkmann,Decision - Unanimous,0,0,0,0
Paul Kelly,2009-11-14,Dennis Siver,KO/TKO,0,0,0,0
Paul Kelly,2011-02-05,Donald Cerrone,Submission,0,0,0,0
TJ O'Brien,2010-11-20,Paul Kelly,KO/TKO,0,0,0,0
TJ O'Brien,2011-08-14,Cole Miller,Submission,0,0,0,0
Alexandre Pantoja,2024-12-07,Kai Asakura,Submission,90,15,25,130
Alexandre Pantoja,2019-04-13,Wilson Reis,KO/TKO,100,22,0,122
Alexandre Pantoja,2019-07-27,Deiveson Figueiredo,Decision - Unanimous,0,0,0,0
Alexandre Pantoja,2020-07-18,Askar Askarov,Decision - Unanimous,0,0,0,0
Alexandre Pantoja,2022-07-30,Alex Perez,Submission,90,0,0,90
Alexandre Pantoja,2018-11-17,Yuta Sasaki,Submission,90,0,0,90
Alexandre Pantoja,2017-07-16,Neil Seery,Submission,90,37,0,127
Alexandre Pantoja,2019-12-21,Matt Schnell,KO/TKO,100,14,0,114
Alexandre Pantoja,2018-05-19,Brandon Moreno,Decision - Unanimous,80,34,0,114
Alexandre Pantoja,2023-12-16,Brandon Royval,Decision - Unanimous,80,0,25,105
Alexandre Pantoja,2024-05-04,Steve Erceg,Decision - Unanimous,80,14,25,119
Alexandre Pantoja,2021-02-06,Manel Kape,Decision - Unanimous,80,25,0,105
Alexandre Pantoja,2023-07-08,Brandon Moreno,Decision - Split,70,0,25,95
Alexandre Pantoja,2021-08-21,Brandon Royval,Submission,90,5,0,95
Alexandre Pantoja,2018-01-20,Dustin Ortiz,Decision - Unanimous,0,0,0,0
Alexandre Pantoja,2017-01-28,Eric Shelton,Decision - Split,70,5,0,75
Kai Asakura,2024-12-07,Alexandre Pantoja,Submission,0,0,25,25
Kyle Stewart,2019-01-19,Chance Rencountre,Submission,0,0,0,0
Kyle Stewart,2019-07-27,Erik Koch,Decision - Unanimous,0,0,0,0
Kyle Stewart,2017-07-25,Jason Jackson,KO/TKO,100,0,0,100
Ricardo Arona,2007-04-08,Rameau Thierry Sokoudjou,KO/TKO,0,0,0,0
Ricardo Arona,2005-06-26,Kazushi Sakuraba,KO/TKO,100,38,0,138
Ricardo Arona,2005-12-31,Wanderlei Silva,Decision - Split,0,0,0,0
Ricardo Arona,2002-11-24,Murilo Rua,Decision - Unanimous,80,4,0,84
Ricardo Arona,2005-08-28,Wanderlei Silva,Decision - Unanimous,80,4,0,84
Ricardo Arona,2005-04-23,Dean Lister,Decision - Unanimous,80,6,0,86
Ricardo Arona,2006-09-10,Alistair Overeem,KO/TKO,100,3,0,103
Ricardo Arona,2005-08-28,Mauricio Rua,KO/TKO,0,0,0,0
Ricardo Arona,2004-06-20,Quinton Jackson,KO/TKO,0,0,0,0
Ricardo Arona,2004-10-31,Sergey Ignatov,Submission,90,25,0,115
Ricardo Arona,2002-04-28,Dan Henderson,Decision - Split,70,14,0,84
Ricardo Arona,2001-09-24,Guy Mezger,Decision - Split,70,11,0,81
Bryan Vetell,2006-09-23,Ben Rothwell,KO/TKO,0,2,0,2
Fabricio Camoes,2010-03-27,Kurt Pellegrino,Submission,0,0,0,0
Fabricio Camoes,2014-10-25,Anthony Rocco Martin,Submission,0,0,0,0
Fabricio Camoes,2013-12-28,Jim Miller,Submission,0,5,0,5
Fabricio Camoes,2012-01-20,Tommy Hayden,Submission,90,0,0,90
Fabricio Camoes,2012-07-07,Melvin Guillard,Decision - Unanimous,0,0,0,0
Alejandro Perez,2021-10-02,Johnny Eduardo,Submission,90,0,0,90
Alejandro Perez,2016-04-10,Ian Entwistle,KO/TKO,100,48,0,148
Alejandro Perez,2015-06-13,Patrick Williams,Submission,0,0,0,0
Alejandro Perez,2018-04-14,Matthew Lopez,KO/TKO,100,22,0,122
Alejandro Perez,2018-07-14,Eddie Wineland,Decision - Unanimous,80,5,0,85
Alejandro Perez,2022-02-26,Jonathan Martinez,Decision - Unanimous,0,0,0,0
Alejandro Perez,2014-11-15,Jose Quinonez,Decision - Unanimous,80,0,0,80
Alejandro Perez,2017-08-05,Andre Soukhamthath,Decision - Split,70,1,0,71
Alejandro Perez,2015-11-21,Scott Jorgensen,KO/TKO,100,28,0,128
Alejandro Perez,2019-03-02,Cody Stamann,Decision - Unanimous,0,0,0,0
Alejandro Perez,2017-12-09,Iuri Alcantara,Decision - Unanimous,80,0,0,80
Alejandro Perez,2019-07-06,Song Yadong,KO/TKO,0,0,0,0
Lukasz Sajewski,2016-07-07,Gilbert Burns,Submission,0,1,0,1
Lukasz Sajewski,2015-06-20,Nick Hein,Decision - Unanimous,0,0,0,0
Lukasz Sajewski,2016-10-08,Marc Diakiese,KO/TKO,0,0,0,0
Jorge Gurgel,2006-06-28,Mark Hominick,Decision - Unanimous,0,0,0,0
Jorge Gurgel,2008-03-01,John Halverson,Decision - Unanimous,80,24,0,104
Jorge Gurgel,2007-07-07,Diego Saraiva,Decision - Unanimous,80,18,0,98
Jorge Gurgel,2011-03-05,Billy Vaughan,Submission,90,1,0,91
Jorge Gurgel,2008-11-15,Aaron Riley,Decision - Unanimous,0,0,0,0
Jorge Gurgel,2008-07-05,Cole Miller,Submission,0,13,0,13
Jorge Gurgel,2006-09-23,Danny Abbadi,Decision - Split,70,2,0,72
Jorge Gurgel,2007-10-20,Alvin Robinson,Decision - Unanimous,0,0,0,0
Jorge Gurgel,2010-08-21,KJ Noons,KO/TKO,0,0,0,0
Alexis Dufresne,2014-07-06,Sarah Moras,Decision - Unanimous,0,0,0,0
Alexis Dufresne,2015-01-03,Marion Reneau,Decision - Unanimous,0,0,0,0
Guto Inocente,2014-07-06,Derrick Lewis,KO/TKO,0,0,0,0
Guto Inocente,2012-05-19,Virgil Zwicker,Decision - Unanimous,80,37,0,117
Guto Inocente,2014-11-07,Anthony Perosh,Submission,0,0,0,0
Ange Loosa,2021-09-14,Jack Della Maddalena,Decision - Unanimous,0,0,0,0
Ange Loosa,2024-07-13,Gabriel Bonfim,Decision - Unanimous,0,0,0,0
Ange Loosa,2022-04-16,Mounir Lazzez,Decision - Unanimous,0,0,0,0
Ange Loosa,2022-08-20,AJ Fletcher,Decision - Unanimous,80,42,0,122
Ange Loosa,2023-09-02,Rhys McKee,Decision - Unanimous,80,21,0,101
Jake Shields,2007-06-02,Ido Pariente,Submission,90,6,0,96
Jake Shields,2006-04-21,Yushin Okami,Decision - Majority,75,1,0,76
Jake Shields,2008-10-04,Paul Daley,Submission,90,4,25,119
Jake Shields,2008-07-26,Nick Thompson,Submission,90,1,25,116
Jake Shields,2006-01-20,Dave Menne,Decision - Unanimous,80,22,0,102
Jake Shields,2007-02-18,Ray Steinbeiss,Submission,90,0,0,90
Jake Shields,2010-04-17,Dan Henderson,Decision - Unanimous,80,44,25,149
Jake Shields,2009-06-06,Robbie Lawler,Submission,90,13,0,103
Jake Shields,2013-10-09,Demian Maia,Decision - Split,70,11,25,106
Jake Shields,2011-04-30,Georges St-Pierre,Decision - Unanimous,0,0,25,25
Jake Shields,2006-04-21,Carlos Condit,Decision - Unanimous,80,3,0,83
Jake Shields,2009-11-07,Jason Miller,Decision - Unanimous,80,0,25,105
Jake Shields,2012-02-25,Yoshihiro Akiyama,Decision - Unanimous,80,58,0,138
Jake Shields,2013-06-15,Tyron Woodley,Decision - Split,70,22,0,92
Jake Shields,2014-03-15,Hector Lombard,Decision - Unanimous,0,0,0,0
Jake Shields,2007-11-10,Mike Pyle,Submission,90,0,0,90
Jake Shields,2011-09-17,Jake Ellenberger,KO/TKO,0,0,0,0
Jake Shields,2010-10-23,Martin Kampmann,Decision - Split,70,0,0,70
Jake Shields,2007-09-15,Renato Verissimo,KO/TKO,100,24,0,124
Ido Pariente,2007-06-02,Jake Shields,Submission,0,0,0,0
Manon Fiorot,2024-03-30,Erin Blanchfield,Decision - Unanimous,80,42,25,147
Manon Fiorot,2021-10-16,Mayra Bueno Silva,Decision - Unanimous,80,43,0,123
Manon Fiorot,2021-01-20,Victoria Leonardo,KO/TKO,100,36,0,136
Manon Fiorot,2023-09-02,Rose Namajunas,Decision - Unanimous,80,0,0,80
Manon Fiorot,2021-06-05,Tabatha Ricci,KO/TKO,100,67,0,167
Manon Fiorot,2022-03-26,Jennifer Maia,Decision - Unanimous,80,46,0,126
Manon Fiorot,2022-10-22,Katlyn Cerminara,Decision - Unanimous,80,22,0,102
Frankie Saenz,2018-05-19,Henry Briones,Decision - Unanimous,80,22,0,102
Frankie Saenz,2015-08-08,Sirwan Kakai,Decision - Split,70,25,0,95
Frankie Saenz,2015-02-22,Iuri Alcantara,Decision - Unanimous,80,13,0,93
Frankie Saenz,2015-12-12,Urijah Faber,Decision - Unanimous,0,0,0,0
Frankie Saenz,2017-01-15,Augusto Mendes,Decision - Split,0,0,0,0
Frankie Saenz,2017-12-09,Merab Dvalishvili,Decision - Split,70,11,0,81
Frankie Saenz,2014-08-16,Nolan Ticman,Decision - Unanimous,80,42,0,122
Frankie Saenz,2019-03-23,Marlon Vera,KO/TKO,0,0,0,0
Frankie Saenz,2020-08-01,Jonathan Martinez,KO/TKO,0,0,0,0
Frankie Saenz,2016-07-23,Eddie Wineland,KO/TKO,0,3,0,3
Henry Briones,2018-05-19,Frankie Saenz,Decision - Unanimous,0,0,0,0
Henry Briones,2014-11-15,Guido Cannetti,Submission,90,0,0,90
Henry Briones,2015-07-11,Cody Garbrandt,Decision - Unanimous,0,0,0,0
Henry Briones,2016-11-05,Douglas Silva de Andrade,KO/TKO,0,0,0,0
Henry Briones,2017-08-05,Rani Yahya,Submission,0,0,0,0
Felicia Spencer,2021-11-13,Leah Letson,KO/TKO,100,39,0,139
Felicia Spencer,2020-06-06,Amanda Nunes,Decision - Unanimous,0,0,25,25
Felicia Spencer,2020-02-29,Zarah Fairn,KO/TKO,100,27,0,127
Felicia Spencer,2019-05-18,Megan Anderson,Submission,90,19,0,109
Felicia Spencer,2019-07-27,Cristiane Justino,Decision - Unanimous,0,0,0,0
Felicia Spencer,2021-05-22,Norma Dumont,Decision - Split,0,0,0,0
Leah Letson,2021-11-13,Felicia Spencer,KO/TKO,0,0,0,0
Leah Letson,2018-11-30,Julija Stoliarenko,Decision - Split,70,16,0,86
Merab Dvalishvili,2019-05-04,Brad Katona,Decision - Unanimous,80,23,0,103
Merab Dvalishvili,2021-09-25,Marlon Moraes,KO/TKO,100,40,0,140
Merab Dvalishvili,2017-12-09,Frankie Saenz,Decision - Split,0,0,0,0
Merab Dvalishvili,2018-04-21,Ricky Simon,Submission,0,27,0,27
Merab Dvalishvili,2024-02-17,Henry Cejudo,Decision - Unanimous,80,45,0,125
Merab Dvalishvili,2018-09-15,Terrion Ware,Decision - Unanimous,80,54,0,134
Merab Dvalishvili,2020-08-15,John Dodson,Decision - Unanimous,80,23,0,103
Merab Dvalishvili,2020-02-15,Casey Kenney,Decision - Unanimous,80,18,0,98
Merab Dvalishvili,2024-09-14,Sean O'Malley,Decision - Unanimous,80,35,25,140
Merab Dvalishvili,2022-08-20,Jose Aldo,Decision - Unanimous,80,19,0,99
Merab Dvalishvili,2021-05-01,Cody Stamann,Decision - Unanimous,80,23,0,103
Merab Dvalishvili,2023-03-11,Petr Yan,Decision - Unanimous,80,72,25,177
Merab Dvalishvili,2020-06-13,Gustavo Lopez,Decision - Unanimous,80,59,0,139
Elias Silverio,2013-09-04,Joao Zeferino,Decision - Unanimous,80,38,0,118
Elias Silverio,2014-12-20,Rashid Magomedov,KO/TKO,0,0,0,0
Elias Silverio,2014-05-31,Ernest Chavez,Submission,90,11,0,101
Elias Silverio,2014-01-15,Isaac Vallie-Flagg,Decision - Unanimous,80,60,0,140
Elias Silverio,2015-08-23,Shane Campbell,Decision - Unanimous,0,0,0,0
Joao Zeferino,2013-09-04,Elias Silverio,Decision - Unanimous,0,0,0,0
Joao Zeferino,2013-05-18,Rafael Natal,Decision - Unanimous,0,0,0,0
Jake Rosholt,2008-11-05,Nissen Osterneck,KO/TKO,100,0,0,100
Jake Rosholt,2009-08-29,Chris Leben,Submission,90,7,0,97
Jake Rosholt,2009-11-21,Kendall Grove,Submission,0,2,0,2
Jake Rosholt,2009-02-07,Dan Miller,Submission,0,0,0,0
Nissen Osterneck,2008-11-05,Jake Rosholt,KO/TKO,0,0,0,0
Nissen Osterneck,2009-04-01,Jorge Rivera,Decision - Split,0,6,0,6
Victor Hugo,2023-10-03,Eduardo Torres Caut,Submission,90,1,0,91
Victor Hugo,2024-10-26,Farid Basharat,Decision - Unanimous,0,0,0,0
Victor Hugo,2024-04-06,Pedro Falcao,Decision - Unanimous,80,26,0,106
Eduardo Torres Caut,2023-10-03,Victor Hugo,Submission,0,0,0,0
Sedriques Dumas,2024-08-03,Denis Tiuliulin,Decision - Unanimous,80,23,0,103
Sedriques Dumas,2024-03-30,Nursulton Ruziboev,KO/TKO,0,0,0,0
Sedriques Dumas,2022-08-30,Matej Penaz,Submission,90,1,0,91
Sedriques Dumas,2023-06-24,Cody Brundage,Decision - Unanimous,80,14,0,94
Sedriques Dumas,2023-10-21,Abu Azaitar,Decision - Unanimous,80,0,0,80
Sedriques Dumas,2023-03-11,Josh Fremd,Submission,0,0,0,0
Papy Abedi,2013-04-06,Besam Yousef,Decision - Split,70,10,0,80
Papy Abedi,2013-08-28,Dylan Andrews,KO/TKO,0,0,0,0
Papy Abedi,2012-04-14,James Head,Submission,0,0,0,0
Papy Abedi,2011-11-05,Thiago Alves,Submission,0,0,0,0
Besam Yousef,2013-04-06,Papy Abedi,Decision - Split,0,0,0,0
Besam Yousef,2012-04-14,Simeon Thoresen,Submission,0,0,0,0
Gaston Bolanos,2024-11-09,Cortavious Romious,Decision - Unanimous,80,36,0,116
Gaston Bolanos,2023-04-15,Aaron Phillips,Decision - Unanimous,80,46,0,126
Gaston Bolanos,2024-01-13,Marcus McGhee,KO/TKO,0,0,0,0
Cortavious Romious,2024-11-09,Gaston Bolanos,Decision - Unanimous,0,0,0,0
Cortavious Romious,2023-10-10,Ramon Taveras,KO/TKO,0,0,0,0
Cortavious Romious,2024-08-20,Michael Imperato,Decision - Unanimous,80,11,0,91
Sergei Kharitonov,2007-02-24,Mike Russow,Submission,90,0,0,90
Sergei Kharitonov,2004-02-01,Cory Peterson,Submission,90,6,0,96
Sergei Kharitonov,2004-08-15,Antonio Rodrigo Nogueira,Decision - Unanimous,0,0,0,0
Sergei Kharitonov,2005-10-23,Fabricio Werdum,Decision - Split,70,0,0,70
Sergei Kharitonov,2011-09-10,Josh Barnett,Submission,0,0,0,0
Sergei Kharitonov,2004-06-20,Semmy Schilt,KO/TKO,100,9,0,109
Sergei Kharitonov,2010-12-31,Tatsuya Mizuno,KO/TKO,100,6,0,106
Sergei Kharitonov,2005-06-26,Pedro Rizzo,KO/TKO,100,27,0,127
Sergei Kharitonov,2006-09-10,Aleksander Emelianenko,KO/TKO,0,0,0,0
Sergei Kharitonov,2004-04-25,Murilo Rua,KO/TKO,100,27,0,127
Sergei Kharitonov,2009-04-05,Jeff Monson,Submission,0,0,0,0
Sergei Kharitonov,2003-10-05,Jason Suttie,Submission,90,7,0,97
Sergei Kharitonov,2011-02-12,Andrei Arlovski,KO/TKO,100,8,0,108
Sergei Kharitonov,2007-09-17,Alistair Overeem,KO/TKO,100,0,0,100
Sergei Kharitonov,2005-02-20,Mu Bae Choi,KO/TKO,100,28,0,128
Sergei Kharitonov,2006-02-26,Alistair Overeem,KO/TKO,0,0,0,0
Sergei Kharitonov,2008-09-23,Jimmy Ambriz,KO/TKO,100,28,0,128
Mike Russow,2007-02-24,Sergei Kharitonov,Submission,0,4,0,4
Mike Russow,2013-01-26,Shawn Jordan,KO/TKO,0,0,0,0
Mike Russow,2012-01-28,Jon Olav Einemo,Decision - Unanimous,80,0,0,80
Mike Russow,2011-03-26,Jon Madsen,TKO - Doctor's Stoppage,0,0,0,0
Mike Russow,2009-08-29,Justin McCully,Decision - Unanimous,80,10,0,90
Mike Russow,2010-05-29,Todd Duffee,KO/TKO,100,0,0,100
Mike Russow,2012-06-23,Fabricio Werdum,KO/TKO,0,0,0,0
Phillip Miller,2002-11-22,Mark Weir,Submission,90,0,0,90
Phillip Miller,2002-07-13,James Zikic,Decision - Unanimous,80,1,0,81
Mark Weir,2002-11-22,Phillip Miller,Submission,0,9,0,9
Mark Weir,2003-04-25,David Loiseau,KO/TKO,0,0,0,0
Mark Weir,2006-04-02,Denis Kang,KO/TKO,0,0,0,0
Mark Weir,2002-07-13,Eugene Jackson,KO/TKO,100,4,0,104
Cody Stamann,2018-09-08,Aljamain Sterling,Submission,0,0,0,0
Cody Stamann,2017-10-07,Tom Duquesnoy,Decision - Split,70,33,0,103
Cody Stamann,2020-07-15,Jimmie Rivera,Decision - Unanimous,0,0,0,0
Cody Stamann,2020-06-06,Brian Kelleher,Decision - Unanimous,80,32,0,112
Cody Stamann,2022-06-18,Eddie Wineland,KO/TKO,100,24,0,124
Cody Stamann,2022-01-22,Said Nurmagomedov,Submission,0,0,0,0
Cody Stamann,2024-06-08,Taylor Lapilus,Decision - Unanimous,0,0,0,0
Cody Stamann,2024-11-09,Da'Mon Blackshear,Submission,0,0,0,0
Cody Stamann,2019-03-02,Alejandro Perez,Decision - Unanimous,80,7,0,87
Cody Stamann,2023-01-21,Luan Lacerda,Decision - Unanimous,80,23,0,103
Cody Stamann,2021-05-01,Merab Dvalishvili,Decision - Unanimous,0,0,0,0
Cody Stamann,2017-07-08,Terrion Ware,Decision - Unanimous,80,34,0,114
Cody Stamann,2023-05-13,Douglas Silva de Andrade,Decision - Unanimous,0,0,0,0
Cody Stamann,2018-03-03,Bryan Caraway,Decision - Split,70,36,0,106
Marcus Bossett,1994-12-16,Dan Severn,Submission,0,1,0,1
Ryan Bader,2008-12-13,Vinny Magalhaes,KO/TKO,100,11,0,111
Ryan Bader,2015-10-03,Rashad Evans,Decision - Unanimous,80,27,0,107
Ryan Bader,2014-08-16,Ovince Saint Preux,Decision - Unanimous,80,0,25,105
Ryan Bader,2015-01-24,Phil Davis,Decision - Split,70,0,0,70
Ryan Bader,2013-12-06,Anthony Perosh,Decision - Unanimous,80,61,0,141
Ryan Bader,2014-06-14,Rafael Cavalcante,Decision - Unanimous,80,43,0,123
Ryan Bader,2010-02-20,Keith Jardine,KO/TKO,100,14,0,114
Ryan Bader,2009-04-01,Carmelo Marrero,Decision - Unanimous,80,15,0,95
Ryan Bader,2013-01-26,Vladimir Matyushenko,Submission,90,3,0,93
Ryan Bader,2012-08-04,Lyoto Machida,KO/TKO,0,0,0,0
Ryan Bader,2013-09-04,Glover Teixeira,KO/TKO,0,0,25,25
Ryan Bader,2010-09-25,Rogerio Nogueira,Decision - Unanimous,80,14,0,94
Ryan Bader,2012-02-25,Quinton Jackson,Decision - Unanimous,80,39,0,119
Ryan Bader,2011-02-05,Jon Jones,Submission,0,0,0,0
Ryan Bader,2009-10-24,Eric Schafer,Decision - Unanimous,80,27,0,107
Ryan Bader,2016-09-03,Ilir Latifi,KO/TKO,100,4,0,104
Ryan Bader,2016-01-30,Anthony Johnson,KO/TKO,0,0,25,25
Ryan Bader,2011-07-02,Tito Ortiz,Submission,0,0,0,0
Ryan Bader,2011-11-19,Jason Brilz,KO/TKO,100,5,0,105
Ryan Bader,2016-11-19,Rogerio Nogueira,KO/TKO,100,83,25,208
Vinny Magalhaes,2008-12-13,Ryan Bader,KO/TKO,0,0,0,0
Vinny Magalhaes,2009-04-18,Eliot Marshall,Decision - Unanimous,0,0,0,0
Vinny Magalhaes,2013-04-27,Phil Davis,Decision - Unanimous,0,0,0,0
Vinny Magalhaes,2013-08-03,Anthony Perosh,KO/TKO,0,0,0,0
Vinny Magalhaes,2012-09-22,Igor Pokrajac,Submission,90,7,0,97
Dione Barbosa,2024-07-20,Miranda Maverick,Decision - Unanimous,0,0,0,0
Dione Barbosa,2023-09-05,Rainn Guerrero,Submission,90,1,0,91
Dione Barbosa,2024-05-04,Ernesta Kareckaite,Decision - Unanimous,80,0,0,80
Ricardo Abreu,2014-05-31,Wagner Silva,Submission,90,16,0,106
Ricardo Abreu,2015-06-06,Jake Collier,Decision - Split,0,0,0,0
Wagner Silva,2014-05-31,Ricardo Abreu,Submission,0,0,0,0
Wagner Silva,2014-11-08,Colby Covington,Submission,0,0,0,0
Tomoya Miyashita,2009-10-25,Keisuke Fujiwara,Decision - Unanimous,80,11,0,91
Keisuke Fujiwara,2009-10-25,Tomoya Miyashita,Decision - Unanimous,0,0,0,0
Keisuke Fujiwara,2011-07-16,Kenji Osawa,Decision - Unanimous,0,0,0,0
John Maguire,2011-11-05,Justin Edwards,Decision - Unanimous,80,0,0,80
John Maguire,2012-09-29,John Hathaway,Decision - Unanimous,0,0,0,0
John Maguire,2013-06-15,Mitch Clarke,Decision - Unanimous,0,0,0,0
John Maguire,2012-04-14,DaMarques Johnson,Submission,90,0,0,90
John Maguire,2012-11-17,Matthew Riddle,Decision - Unanimous,0,0,0,0
Justin Edwards,2011-11-05,John Maguire,Decision - Unanimous,0,1,0,1
Justin Edwards,2014-01-15,Ramsey Nijem,Decision - Unanimous,0,0,0,0
Justin Edwards,2012-10-05,Josh Neer,Submission,90,6,0,96
Justin Edwards,2013-08-28,Brandon Thatch,KO/TKO,0,0,0,0
Justin Edwards,2015-06-06,Joe Proctor,Submission,0,0,0,0
Justin Edwards,2011-06-04,Clay Harvison,Decision - Split,0,0,0,0
Justin Edwards,2011-09-17,Jorge Lopez,Decision - Unanimous,80,0,0,80
Gadzhi Omargadzhiev,2021-10-26,Jansey Silva,Submission,90,8,0,98
Gadzhi Omargadzhiev,2022-10-22,Abubakar Nurmagomedov,Decision - Unanimous,0,0,0,0
Gadzhi Omargadzhiev,2022-04-16,Caio Borralho,Decision - Unanimous,0,0,0,0
Jansey Silva,2021-10-26,Gadzhi Omargadzhiev,Submission,0,0,0,0
Victoria Leonardo,2022-07-23,Mandy Bohm,Decision - Unanimous,80,0,0,80
Victoria Leonardo,2024-08-24,Wang Cong,KO/TKO,0,0,0,0
Victoria Leonardo,2021-08-07,Melissa Gatto,TKO - Doctor's Stoppage,0,0,0,0
Victoria Leonardo,2021-01-20,Manon Fiorot,KO/TKO,0,0,0,0
Victoria Leonardo,2023-05-20,Natalia Silva,KO/TKO,0,0,0,0
Victoria Leonardo,2020-11-17,Chelsea Hackett,KO/TKO,100,22,0,122
Mandy Bohm,2022-07-23,Victoria Leonardo,Decision - Unanimous,0,13,0,13
Mandy Bohm,2021-09-18,Ariane da Silva,Decision - Unanimous,0,0,0,0
Mandy Bohm,2023-05-13,Ji Yeon Kim,Decision - Split,70,7,0,77
Gina Mazany,2017-11-25,Wu Yanan,Decision - Unanimous,80,16,0,96
Gina Mazany,2021-05-15,Priscila Cachoeira,KO/TKO,0,0,0,0
Gina Mazany,2018-05-27,Lina Lansberg,Decision - Unanimous,0,0,0,0
Gina Mazany,2017-02-19,Sara McMann,Submission,0,0,0,0
Gina Mazany,2020-06-13,Julia Avila,KO/TKO,0,0,0,0
Gina Mazany,2019-03-02,Macy Chiasson,KO/TKO,0,0,0,0
Gina Mazany,2022-04-30,Shanna Young,KO/TKO,0,0,0,0
Gina Mazany,2020-11-28,Rachael Ostovich,KO/TKO,100,31,0,131
Wu Yanan,2017-11-25,Gina Mazany,Decision - Unanimous,0,0,0,0
Wu Yanan,2018-11-24,Lauren Mueller,Submission,90,1,0,91
Wu Yanan,2021-01-16,Joselyne Edwards,Decision - Unanimous,0,0,0,0
Wu Yanan,2019-08-31,Mizuki,Decision - Split,0,30,0,30
Wu Yanan,2022-04-16,Mayra Bueno Silva,Decision - Unanimous,0,0,0,0
Wu Yanan,2022-08-20,Lucie Pudilova,KO/TKO,0,0,0,0
Joe Solecki,2022-06-04,Alex Da Silva,Decision - Majority,75,0,0,75
Joe Solecki,2021-04-10,Jim Miller,Decision - Unanimous,80,8,0,88
Joe Solecki,2023-12-02,Drakkar Klose,KO/TKO,0,0,0,0
Joe Solecki,2024-06-01,Grant Dawson,Decision - Unanimous,0,0,0,0
Joe Solecki,2019-07-09,James Wallace,Submission,90,11,0,101
Joe Solecki,2019-12-07,Matt Wiman,Decision - Unanimous,80,46,0,126
Joe Solecki,2021-10-02,Jared Gordon,Decision - Split,0,0,0,0
Joe Solecki,2020-08-22,Austin Hubbard,Submission,90,4,0,94
Joe Solecki,2023-02-25,Carl Deaton,Submission,90,1,0,91
Alex Da Silva,2022-06-04,Joe Solecki,Decision - Majority,0,2,0,2
Alex Da Silva,2019-04-20,Alexander Yakovlev,Submission,0,0,0,0
Alex Da Silva,2020-09-26,Brad Riddell,Decision - Unanimous,0,0,0,0
Alex Da Silva,2019-08-10,Kazula Vargas,Decision - Unanimous,80,0,0,80
Raoni Barcelos,2023-08-05,Kyler Phillips,Decision - Unanimous,0,0,0,0
Raoni Barcelos,2018-11-30,Chris Gutierrez,Submission,90,9,0,99
Raoni Barcelos,2021-06-26,Timur Valiev,Decision - Majority,0,0,0,0
Raoni Barcelos,2022-10-01,Trevin Jones,Decision - Unanimous,80,62,0,142
Raoni Barcelos,2023-01-14,Umar Nurmagomedov,KO/TKO,0,0,0,0
Raoni Barcelos,2019-12-21,Said Nurmagomedov,Decision - Unanimous,80,0,0,80
Raoni Barcelos,2020-11-07,Khalid Taha,Decision - Unanimous,80,71,0,151
Raoni Barcelos,2018-07-14,Kurt Holobaugh,KO/TKO,100,0,0,100
Raoni Barcelos,2022-01-22,Victor Henry,Decision - Unanimous,0,0,0,0
Raoni Barcelos,2019-05-11,Carlos Huachin,KO/TKO,100,39,0,139
Raoni Barcelos,2024-02-24,Cristian Quinonez,Submission,90,14,0,104
Roland Delorme,2014-08-23,Yuta Sasaki,Submission,0,0,0,0
Roland Delorme,2011-12-03,Josh Ferguson,Submission,90,2,0,92
Roland Delorme,2013-09-21,Alex Caceres,Decision - Split,0,0,0,0
Roland Delorme,2013-06-15,Edwin Figueroa,Decision - Unanimous,80,0,0,80
Roland Delorme,2014-06-14,Michinori Tanaka,Decision - Unanimous,0,0,0,0
Roland Delorme,2012-05-05,Nick Denis,Submission,90,2,0,92
Jesus Aguilar,2022-08-23,Erisson Ferreira,Submission,90,10,0,100
Jesus Aguilar,2024-02-24,Mateus Mendonca,Decision - Split,70,1,0,71
Jesus Aguilar,2023-02-04,Tatsuro Taira,Submission,0,1,0,1
Jesus Aguilar,2023-07-08,Shannon Ross,KO/TKO,100,0,0,100
Jesus Aguilar,2024-08-17,Stewart Nicoll,Submission,90,0,0,90
Erisson Ferreira,2022-08-23,Jesus Aguilar,Submission,0,0,0,0
Erisson Ferreira,2021-11-02,Qiu Lun,Decision - Unanimous,80,0,0,80
Kyle Driscoll,2020-09-15,Dinis Paiva Jr.,Decision - Unanimous,80,2,0,82
Dinis Paiva Jr.,2020-09-15,Kyle Driscoll,Decision - Unanimous,0,0,0,0
Ray Sefo,2009-09-25,Kevin Jordan,Submission,90,0,0,90
Ray Sefo,2011-02-12,Valentijn Overeem,Submission,0,3,0,3
Karo Parisyan,2003-09-26,Dave Strasser,Submission,90,11,0,101
Karo Parisyan,2005-06-04,Matt Serra,Decision - Unanimous,80,30,0,110
Karo Parisyan,2006-08-17,Diego Sanchez,Decision - Unanimous,0,0,0,0
Karo Parisyan,2006-12-13,Drew Fickett,Decision - Unanimous,80,9,0,89
Karo Parisyan,2008-04-02,Thiago Alves,KO/TKO,0,0,0,0
Karo Parisyan,2004-08-21,Nick Diaz,Decision - Split,70,0,0,70
Karo Parisyan,2005-02-05,Chris Lytle,Decision - Unanimous,80,22,0,102
Karo Parisyan,2007-05-26,Joshua Burkman,Decision - Unanimous,80,38,0,118
Karo Parisyan,2004-01-31,Georges St-Pierre,Decision - Unanimous,0,0,0,0
Karo Parisyan,2010-11-20,Dennis Hallman,KO/TKO,0,0,0,0
Karo Parisyan,2006-04-15,Nick Thompson,KO/TKO,100,16,0,116
Karo Parisyan,2007-11-17,Ryo Chonan,Decision - Unanimous,80,14,0,94
Dave Strasser,2003-09-26,Karo Parisyan,Submission,0,0,0,0
Dave Strasser,2003-04-25,Romie Aram,Decision - Unanimous,80,36,0,116
Dave Strasser,2005-01-29,Georges St-Pierre,Submission,0,0,0,0
Vinicius Salvador,2023-07-29,CJ Vergara,Decision - Unanimous,0,0,0,0
Vinicius Salvador,2022-08-02,Shannon Ross,KO/TKO,100,12,0,112
Vinicius Salvador,2023-03-25,Victor Altamirano,Decision - Unanimous,0,0,0,0
Vinicius Salvador,2024-05-18,Adrian Yanez,KO/TKO,0,0,0,0
Khadis Ibragimov,2020-07-18,Roman Dolidze,KO/TKO,0,0,0,0
Khadis Ibragimov,2020-09-26,Danilo Marques,Decision - Unanimous,0,3,0,3
Khadis Ibragimov,2019-08-31,Da Woon Jung,Submission,0,7,0,7
Khadis Ibragimov,2019-11-09,Ed Herman,Decision - Unanimous,0,0,0,0
Rashad Evans,2016-04-16,Glover Teixeira,KO/TKO,0,1,25,26
Rashad Evans,2017-03-04,Daniel Kelly,Decision - Split,0,0,0,0
Rashad Evans,2015-10-03,Ryan Bader,Decision - Unanimous,0,0,0,0
Rashad Evans,2006-06-28,Stephan Bonnar,Decision - Majority,75,5,0,80
Rashad Evans,2012-01-28,Phil Davis,Decision - Unanimous,80,11,25,116
Rashad Evans,2017-08-05,Sam Alvey,Decision - Split,0,0,0,0
Rashad Evans,2013-06-15,Dan Henderson,Decision - Split,70,0,0,70
Rashad Evans,2005-11-05,Brad Imes,Decision - Split,70,6,0,76
Rashad Evans,2004-06-03,Jaime Jara,Decision - Unanimous,80,0,0,80
Rashad Evans,2004-06-02,Bryan Pardoe,KO/TKO,100,18,0,118
Rashad Evans,2012-04-21,Jon Jones,Decision - Unanimous,0,0,25,25
Rashad Evans,2006-04-06,Sam Hoger,Decision - Split,70,5,0,75
Rashad Evans,2018-06-09,Anthony Smith,KO/TKO,0,0,0,0
Rashad Evans,2007-01-25,Sean Salmon,KO/TKO,100,3,0,103
Rashad Evans,2006-09-23,Jason Lambert,KO/TKO,100,19,0,119
Rashad Evans,2011-08-06,Tito Ortiz,KO/TKO,100,43,0,143
Rashad Evans,2010-01-02,Thiago Silva,Decision - Unanimous,80,0,0,80
Rashad Evans,2004-06-03,Hector Ramirez,Decision - Unanimous,80,0,0,80
Rashad Evans,2008-09-06,Chuck Liddell,KO/TKO,100,3,0,103
Rashad Evans,2010-05-29,Quinton Jackson,Decision - Unanimous,80,12,0,92
Rashad Evans,2013-11-16,Chael Sonnen,KO/TKO,100,17,0,117
Rashad Evans,2009-05-23,Lyoto Machida,KO/TKO,0,0,25,25
Rashad Evans,2007-11-17,Michael Bisping,Decision - Split,70,0,0,70
Rashad Evans,2008-12-27,Forrest Griffin,KO/TKO,100,0,25,125
Rashad Evans,2013-02-02,Rogerio Nogueira,Decision - Unanimous,0,0,0,0
David Avellan,2008-11-05,Aaron Simpson,KO/TKO,0,0,0,0
Rafael Fiziev,2020-07-18,Marc Diakiese,Decision - Unanimous,80,10,0,90
Rafael Fiziev,2020-12-12,Renato Moicano,KO/TKO,100,6,0,106
Rafael Fiziev,2022-07-09,Rafael Dos Anjos,KO/TKO,100,10,25,135
Rafael Fiziev,2021-12-04,Brad Riddell,KO/TKO,100,7,0,107
Rafael Fiziev,2023-03-18,Justin Gaethje,Decision - Majority,0,0,0,0
Rafael Fiziev,2021-08-07,Bobby Green,Decision - Unanimous,80,0,0,80
Rafael Fiziev,2019-04-20,Magomed Mustafaev,KO/TKO,0,0,0,0
Rafael Fiziev,2023-09-23,Mateusz Gamrot,KO/TKO,0,2,25,27
Rafael Fiziev,2019-10-26,Alex White,Decision - Unanimous,80,11,0,91
Thiago Silva,2008-05-24,Antonio Mendes,KO/TKO,100,14,0,114
Thiago Silva,2007-05-26,James Irvin,KO/TKO,100,0,0,100
Thiago Silva,2007-02-28,Tatsuya Mizuno,KO/TKO,100,5,0,105
Thiago Silva,2005-12-03,Rodrigo Gripp de Sousa,TKO - Doctor's Stoppage,0,27,0,27
Thiago Silva,2006-11-09,Dino Pezao,KO/TKO,100,12,0,112
Thiago Silva,2013-10-09,Matt Hamill,Decision - Unanimous,80,26,0,106
Thiago Silva,2007-09-08,Tomasz Drwal,KO/TKO,100,5,0,105
Thiago Silva,2007-11-17,Houston Alexander,KO/TKO,100,20,0,120
Thiago Silva,2012-04-14,Alexander Gustafsson,Decision - Unanimous,0,0,0,0
Thiago Silva,2006-09-27,Dave Dalgliesh,Submission,90,2,0,92
Thiago Silva,2005-09-10,Rubens Xavier,KO/TKO,100,15,0,115
Thiago Silva,2010-01-02,Rashad Evans,Decision - Unanimous,0,19,0,19
Thiago Silva,2009-01-31,Lyoto Machida,KO/TKO,0,0,0,0
Thiago Silva,2009-08-29,Keith Jardine,KO/TKO,100,2,0,102
Thiago Silva,2006-11-30,Vitor Vianna,KO/TKO,100,5,0,105
Thiago Silva,2013-06-08,Rafael Cavalcante,KO/TKO,100,13,0,113
Antonio Mendes,2008-05-24,Thiago Silva,KO/TKO,0,0,0,0
Antonio Mendes,2009-01-17,Eric Schafer,KO/TKO,0,0,0,0
Ricky Simon,2018-08-04,Montel Jackson,Decision - Unanimous,80,0,0,80
Ricky Simon,2017-08-08,Donavon Frelow,Decision - Split,70,12,0,82
Ricky Simon,2024-06-29,Vinicius Oliveira,Decision - Unanimous,0,0,0,0
Ricky Simon,2019-12-07,Rob Font,Decision - Unanimous,0,0,0,0
Ricky Simon,2024-01-13,Mario Bautista,Decision - Unanimous,0,0,0,0
Ricky Simon,2021-12-18,Raphael Assuncao,KO/TKO,100,11,0,111
Ricky Simon,2018-04-21,Merab Dvalishvili,Submission,90,0,0,90
Ricky Simon,2019-07-13,Urijah Faber,KO/TKO,0,0,0,0
Ricky Simon,2022-07-16,Jack Shore,Submission,90,6,0,96
Ricky Simon,2021-02-13,Brian Kelleher,Decision - Unanimous,80,26,0,106
Ricky Simon,2021-01-20,Gaetano Pirrello,Submission,90,11,0,101
Ricky Simon,2020-05-13,Ray Borg,Decision - Split,70,20,0,90
Ricky Simon,2023-04-29,Song Yadong,KO/TKO,0,0,25,25
Ricky Simon,2019-02-09,Rani Yahya,Decision - Unanimous,80,7,0,87
Montel Jackson,2018-08-04,Ricky Simon,Decision - Unanimous,0,17,0,17
Montel Jackson,2021-09-18,JP Buys,Decision - Unanimous,80,17,0,97
Montel Jackson,2022-11-12,Julio Arce,Decision - Unanimous,80,22,0,102
Montel Jackson,2021-03-20,Jesse Strader,KO/TKO,100,1,0,101
Montel Jackson,2020-07-18,Brett Johns,Decision - Unanimous,0,15,0,15
Montel Jackson,2019-04-13,Andre Soukhamthath,Decision - Unanimous,80,34,0,114
Montel Jackson,2018-12-29,Brian Kelleher,Submission,90,4,0,94
Montel Jackson,2018-06-12,Rico DiSciullo,KO/TKO,100,33,0,133
Montel Jackson,2020-01-25,Felipe Colares,Decision - Unanimous,80,68,0,148
Montel Jackson,2024-07-13,Da'Mon Blackshear,KO/TKO,100,3,0,103
Montel Jackson,2023-04-22,Rani Yahya,KO/TKO,100,2,0,102
Amanda Lemos,2022-07-16,Michelle Waterson-Gomez,Submission,90,0,0,90
Amanda Lemos,2017-07-16,Leslie Smith,KO/TKO,0,0,0,0
Amanda Lemos,2021-07-17,Montserrat Conejo Ruiz,KO/TKO,100,4,0,104
Amanda Lemos,2022-11-05,Marina Rodriguez,KO/TKO,100,10,25,135
Amanda Lemos,2023-08-19,Zhang Weili,Decision - Unanimous,0,0,25,25
Amanda Lemos,2019-12-21,Miranda Granger,Submission,90,4,0,94
Amanda Lemos,2021-03-06,Livinha Souza,KO/TKO,100,28,0,128
Amanda Lemos,2024-07-20,Virna Jandiroba,Submission,0,0,25,25
Amanda Lemos,2022-04-23,Jessica Andrade,Submission,0,4,25,29
Amanda Lemos,2021-12-18,Angela Hill,Decision - Split,70,2,0,72
Amanda Lemos,2024-02-17,Mackenzie Dern,Decision - Unanimous,80,20,0,100
Amanda Lemos,2020-08-22,Mizuki,Decision - Unanimous,80,26,0,106
Ben Alloway,2012-12-14,Manuel Rodriguez,KO/TKO,100,12,0,112
Ben Alloway,2013-04-06,Ryan LaFlare,Decision - Unanimous,0,0,0,0
Ben Alloway,2013-08-28,Zak Cummings,Submission,0,1,0,1
Manuel Rodriguez,2012-12-14,Ben Alloway,KO/TKO,0,0,0,0
Crezio de Souza,1997-06-15,Dan Henderson,KO/TKO,0,0,0,0
Josh Neer,2006-01-16,Melvin Guillard,Submission,90,0,0,90
Josh Neer,2009-02-07,Mac Danzig,Submission,90,13,0,103
Josh Neer,2013-02-23,Court McGee,Decision - Unanimous,0,0,0,0
Josh Neer,2012-01-20,Duane Ludwig,Submission,90,0,0,90
Josh Neer,2006-04-06,Joe Stevenson,Decision - Unanimous,80,15,0,95
Josh Neer,2006-08-26,Nick Diaz,Submission,0,0,0,0
Josh Neer,2012-06-08,Mike Pyle,KO/TKO,0,1,0,1
Josh Neer,2009-08-08,Kurt Pellegrino,Decision - Unanimous,0,3,0,3
Josh Neer,2012-10-05,Justin Edwards,Submission,0,0,0,0
Josh Neer,2008-09-17,Nate Diaz,Decision - Split,0,0,0,0
Josh Neer,2009-10-24,Gleison Tibau,Decision - Unanimous,0,2,0,2
Josh Neer,2008-04-02,Din Thomas,Decision - Unanimous,80,60,0,140
Josh Neer,2005-08-06,Drew Fickett,Submission,0,0,0,0
Josh Neer,2011-10-01,Keith Wisniewski,TKO - Doctor's Stoppage,0,52,0,52
Josh Neer,2006-07-08,Joshua Burkman,Decision - Unanimous,0,0,0,0
Mirsad Bektic,2015-05-30,Lucas Martins,KO/TKO,100,32,0,132
Mirsad Bektic,2015-01-24,Paul Redmond,Decision - Unanimous,80,32,0,112
Mirsad Bektic,2020-02-08,Dan Ige,Decision - Split,0,0,0,0
Mirsad Bektic,2018-01-27,Godofredo Pepey,KO/TKO,100,7,0,107
Mirsad Bektic,2020-09-19,Damon Jackson,Submission,0,1,0,1
Mirsad Bektic,2014-04-19,Chas Skelly,Decision - Majority,75,8,0,83
Mirsad Bektic,2017-03-04,Darren Elkins,KO/TKO,0,32,0,32
Mirsad Bektic,2018-06-09,Ricardo Lamas,Decision - Split,70,0,0,70
Mirsad Bektic,2016-10-08,Russell Doane,Submission,90,0,0,90
Mirsad Bektic,2019-07-13,Josh Emmett,KO/TKO,0,0,0,0
Paddy Holohan,2014-07-19,Josh Sampo,Submission,90,7,0,97
Paddy Holohan,2015-10-24,Louis Smolka,Submission,0,0,0,0
Paddy Holohan,2015-07-18,Vaughan Lee,Decision - Unanimous,80,1,0,81
Paddy Holohan,2015-01-18,Shane Howell,Decision - Unanimous,80,20,0,100
Paddy Holohan,2014-10-04,Chris Kelades,Decision - Unanimous,0,0,0,0
Josh Sampo,2014-07-19,Paddy Holohan,Submission,0,0,0,0
Josh Sampo,2013-11-30,Ryan Benoit,Submission,90,10,0,100
Josh Sampo,2015-05-23,Justin Scoggins,Decision - Unanimous,0,0,0,0
Josh Sampo,2014-02-22,Zach Makovsky,Decision - Unanimous,0,0,0,0
Islam Makhachev,2018-07-28,Kajan Johnson,Submission,90,0,0,90
Islam Makhachev,2017-02-11,Nik Lentz,Decision - Unanimous,80,30,0,110
Islam Makhachev,2021-03-06,Drew Dober,Submission,90,5,0,95
Islam Makhachev,2018-01-20,Gleison Tibau,KO/TKO,100,1,0,101
Islam Makhachev,2019-09-07,Davi Ramos,Decision - Unanimous,80,36,0,116
Islam Makhachev,2021-07-17,Thiago Moises,Submission,90,48,25,163
Islam Makhachev,2015-10-03,Adriano Martins,KO/TKO,0,1,0,1
Islam Makhachev,2021-10-30,Dan Hooker,Submission,90,0,0,90
Islam Makhachev,2022-10-22,Charles Oliveira,Submission,90,11,25,126
Islam Makhachev,2015-05-23,Leo Kuntz,Submission,90,25,0,115
Islam Makhachev,2022-02-26,Bobby Green,KO/TKO,100,5,25,130
Islam Makhachev,2023-02-11,Alexander Volkanovski,Decision - Unanimous,80,0,25,105
Islam Makhachev,2024-06-01,Dustin Poirier,Submission,90,14,25,129
Islam Makhachev,2016-09-17,Chris Wade,Decision - Unanimous,80,7,0,87
Islam Makhachev,2019-04-20,Arman Tsarukyan,Decision - Unanimous,80,1,0,81
Islam Makhachev,2023-10-21,Alexander Volkanovski,KO/TKO,100,20,25,145
Matheus Nicolau,2015-11-07,Bruno Korea,Submission,90,19,0,109
Matheus Nicolau,2024-10-19,Asu Almabayev,Decision - Unanimous,0,0,0,0
Matheus Nicolau,2023-04-15,Brandon Royval,KO/TKO,0,0,0,0
Matheus Nicolau,2024-04-27,Alex Perez,KO/TKO,0,0,25,25
Matheus Nicolau,2016-07-08,John Moraga,Decision - Split,70,10,0,80
Matheus Nicolau,2022-03-26,David Dvorak,Decision - Unanimous,80,0,0,80
Matheus Nicolau,2017-12-30,Louis Smolka,Decision - Unanimous,80,38,0,118
Matheus Nicolau,2022-12-03,Matt Schnell,KO/TKO,100,12,0,112
Matheus Nicolau,2021-10-09,Tim Elliott,Decision - Unanimous,80,0,0,80
Matheus Nicolau,2018-07-28,Dustin Ortiz,KO/TKO,0,0,0,0
Matheus Nicolau,2021-03-13,Manel Kape,Decision - Split,70,0,0,70
Bruno Korea,2015-11-07,Matheus Nicolau,Submission,0,0,0,0
Bruno Korea,2021-09-07,CJ Vergara,KO/TKO,0,0,0,0
Dave Menne,2006-12-13,Luigi Fioravanti,KO/TKO,0,0,0,0
Dave Menne,2006-01-20,Jake Shields,Decision - Unanimous,0,0,0,0
Dave Menne,2002-01-11,Murilo Bustamante,KO/TKO,0,5,25,30
Dave Menne,2000-03-10,Fabiano Iha,Decision - Unanimous,80,29,0,109
Dave Menne,2006-06-28,Josh Koscheck,Decision - Unanimous,0,0,0,0
Dave Menne,2001-09-28,Gil Castillo,Decision - Unanimous,80,61,25,166
Dave Menne,2002-09-27,Phil Baroni,KO/TKO,0,0,0,0
Yusuke Kawaguchi,2010-09-25,James Thompson,Decision - Split,70,0,0,70
Guram Kutateladze,2020-10-17,Mateusz Gamrot,Decision - Split,70,0,0,70
Guram Kutateladze,2024-08-03,Jordan Vucenic,Decision - Unanimous,80,0,0,80
Guram Kutateladze,2022-06-18,Damir Ismagulov,Decision - Split,0,0,0,0
Guram Kutateladze,2023-07-01,Elves Brener,KO/TKO,0,20,0,20
Mateusz Gamrot,2020-10-17,Guram Kutateladze,Decision - Split,0,15,0,15
Mateusz Gamrot,2023-03-04,Jalin Turner,Decision - Split,70,0,0,70
Mateusz Gamrot,2021-04-10,Scott Holtzman,KO/TKO,100,29,0,129
Mateusz Gamrot,2024-03-09,Rafael Dos Anjos,Decision - Unanimous,80,21,0,101
Mateusz Gamrot,2021-12-18,Diego Ferreira,KO/TKO,100,0,0,100
Mateusz Gamrot,2021-07-17,Jeremy Stephens,Submission,90,1,0,91
Mateusz Gamrot,2022-10-22,Beneil Dariush,Decision - Unanimous,0,0,0,0
Mateusz Gamrot,2023-09-23,Rafael Fiziev,KO/TKO,100,0,25,125
Mateusz Gamrot,2022-06-25,Arman Tsarukyan,Decision - Unanimous,80,0,25,105
Mateusz Gamrot,2024-08-17,Dan Hooker,Decision - Split,0,0,0,0
David Loiseau,2005-06-04,Charles McCarthy,KO/TKO,100,20,0,120
David Loiseau,2005-02-05,Gideon Ray,TKO - Doctor's Stoppage,0,6,0,6
David Loiseau,2003-09-26,Jorge Rivera,Decision - Unanimous,0,0,0,0
David Loiseau,2003-04-25,Mark Weir,KO/TKO,100,14,0,114
David Loiseau,2005-10-03,Evan Tanner,TKO - Doctor's Stoppage,0,0,0,0
David Loiseau,2010-06-12,Mario Miranda,KO/TKO,0,0,0,0
David Loiseau,2006-09-23,Mike Swick,Decision - Unanimous,0,4,0,4
David Loiseau,2009-04-18,Ed Herman,Decision - Unanimous,0,0,0,0
David Loiseau,2006-03-04,Rich Franklin,Decision - Unanimous,0,0,25,25
Charles McCarthy,2005-06-04,David Loiseau,KO/TKO,0,0,0,0
Charles McCarthy,2006-11-11,Gideon Ray,Submission,90,0,0,90
Charles McCarthy,2008-04-19,Michael Bisping,KO/TKO,0,0,0,0
Anthony Hamilton,2016-02-21,Shamil Abdurakhimov,Decision - Unanimous,0,0,0,0
Anthony Hamilton,2014-08-30,Ruan Potts,KO/TKO,100,50,0,150
Anthony Hamilton,2015-04-11,Daniel Omielanczuk,Decision - Unanimous,80,47,0,127
Anthony Hamilton,2016-07-30,Damian Grabowski,KO/TKO,100,8,0,108
Anthony Hamilton,2017-09-16,Daniel Spitz,KO/TKO,0,0,0,0
Anthony Hamilton,2014-06-28,Aleksei Oleinik,Submission,0,0,0,0
Anthony Hamilton,2014-12-06,Todd Duffee,KO/TKO,0,0,0,0
Anthony Hamilton,2017-11-18,Adam Wieczorek,Decision - Unanimous,0,0,0,0
Anthony Hamilton,2017-02-04,Marcel Fortuna,KO/TKO,0,0,0,0
Anthony Hamilton,2016-12-09,Francis Ngannou,Submission,0,0,0,0
Tai Tuivasa,2023-09-09,Alexander Volkov,Submission,0,0,0,0
Tai Tuivasa,2024-08-17,Jairzinho Rozenstruik,Decision - Split,0,0,0,0
Tai Tuivasa,2019-06-08,Blagoy Ivanov,Decision - Unanimous,0,0,0,0
Tai Tuivasa,2022-02-12,Derrick Lewis,KO/TKO,100,0,0,100
Tai Tuivasa,2018-12-01,Junior Dos Santos,KO/TKO,0,0,25,25
Tai Tuivasa,2021-03-20,Harry Hunsucker,KO/TKO,100,12,0,112
Tai Tuivasa,2022-12-03,Sergei Pavlovich,KO/TKO,0,0,0,0
Tai Tuivasa,2019-10-05,Serghei Spivac,Submission,0,0,0,0
Tai Tuivasa,2024-03-16,Marcin Tybura,Submission,0,0,25,25
Tai Tuivasa,2022-09-03,Ciryl Gane,KO/TKO,0,0,25,25
Tai Tuivasa,2020-10-24,Stefan Struve,KO/TKO,100,14,0,114
Tai Tuivasa,2017-11-18,Rashad Coulter,KO/TKO,100,12,0,112
Tai Tuivasa,2021-07-10,Greg Hardy,KO/TKO,100,5,0,105
Tai Tuivasa,2021-12-11,Augusto Sakai,KO/TKO,100,13,0,113
Tai Tuivasa,2018-06-09,Andrei Arlovski,Decision - Unanimous,80,3,0,83
Tai Tuivasa,2018-02-10,Cyril Asker,KO/TKO,100,35,0,135
Jadson Costa,2004-02-15,Takanori Gomi,KO/TKO,0,0,0,0
Gan McGee,2000-11-17,Josh Barnett,KO/TKO,0,0,0,0
Gan McGee,2004-04-25,Semmy Schilt,Submission,0,3,0,3
Gan McGee,2004-02-01,Heath Herring,Decision - Split,0,0,0,0
Gan McGee,2003-09-26,Tim Sylvia,KO/TKO,0,0,25,25
Gan McGee,2003-02-28,Alexandre Dantas,KO/TKO,100,8,0,108
Gan McGee,2002-09-27,Pedro Rizzo,KO/TKO,100,3,0,103
Antwain Britt,2010-11-19,Ovince Saint Preux,Decision - Unanimous,0,0,0,0
Antwain Britt,2011-11-18,Lumumba Sayers,KO/TKO,0,0,0,0
Antwain Britt,2010-05-15,Rafael Cavalcante,KO/TKO,0,1,0,1
Preston Parsons,2022-04-23,Evan Elder,Decision - Unanimous,80,48,0,128
Preston Parsons,2021-07-17,Daniel Rodriguez,KO/TKO,0,0,0,0
Preston Parsons,2024-01-13,Matthew Semelsberger,Decision - Unanimous,80,19,0,99
Preston Parsons,2024-07-27,Oban Elliott,Decision - Unanimous,0,0,0,0
Preston Parsons,2023-03-25,Trevin Giles,Decision - Split,0,0,0,0
Evan Elder,2022-04-23,Preston Parsons,Decision - Unanimous,0,0,0,0
Evan Elder,2023-02-18,Nazim Sadykhov,TKO - Doctor's Stoppage,0,6,0,6
Evan Elder,2023-07-15,Genaro Valdez,Decision - Unanimous,80,32,0,112
Evan Elder,2024-07-13,Darrius Flowers,Submission,90,21,0,111
Alan Baudot,2020-10-10,Tom Aspinall,KO/TKO,0,0,0,0
Alan Baudot,2022-06-25,Josh Parisian,KO/TKO,0,7,0,7
Alan Baudot,2022-02-19,Parker Porter,Decision - Unanimous,0,12,0,12
Jonathan Martinez,2020-10-17,Thomas Almeida,Decision - Unanimous,80,9,0,89
Jonathan Martinez,2018-10-27,Andre Soukhamthath,Decision - Unanimous,0,0,0,0
Jonathan Martinez,2023-03-11,Said Nurmagomedov,Decision - Unanimous,80,0,0,80
Jonathan Martinez,2024-05-04,Jose Aldo,Decision - Unanimous,0,0,0,0
Jonathan Martinez,2019-07-13,Pingyuan Liu,KO/TKO,100,5,0,105
Jonathan Martinez,2020-08-01,Frankie Saenz,KO/TKO,100,40,0,140
Jonathan Martinez,2022-02-26,Alejandro Perez,Decision - Unanimous,80,22,0,102
Jonathan Martinez,2019-02-09,Wulijiburen,Decision - Unanimous,80,30,0,110
Jonathan Martinez,2021-10-23,Zviad Lazishvili,Decision - Unanimous,80,29,0,109
Jonathan Martinez,2021-03-13,Davey Grant,KO/TKO,0,0,0,0
Jonathan Martinez,2022-05-21,Vince Morales,Decision - Unanimous,80,37,0,117
Jonathan Martinez,2020-02-08,Andre Ewell,Decision - Split,0,0,0,0
Jonathan Martinez,2024-11-16,Marcus McGhee,Decision - Unanimous,0,0,0,0
Jonathan Martinez,2022-10-15,Cub Swanson,KO/TKO,100,11,0,111
Jonathan Martinez,2023-10-14,Adrian Yanez,KO/TKO,100,16,0,116
Thomas Almeida,2020-10-17,Jonathan Martinez,Decision - Unanimous,0,0,0,0
Thomas Almeida,2016-11-19,Albert Morales,KO/TKO,100,23,0,123
Thomas Almeida,2015-07-11,Brad Pickett,KO/TKO,100,4,0,104
Thomas Almeida,2016-05-29,Cody Garbrandt,KO/TKO,0,0,25,25
Thomas Almeida,2018-01-20,Rob Font,KO/TKO,0,0,0,0
Thomas Almeida,2017-07-22,Jimmie Rivera,Decision - Unanimous,0,2,0,2
Thomas Almeida,2015-04-25,Yves Jabouin,KO/TKO,100,11,0,111
Thomas Almeida,2014-11-08,Tim Gorman,Decision - Unanimous,80,53,0,133
Thomas Almeida,2015-11-07,Anthony Birchak,KO/TKO,100,0,0,100
Thomas Almeida,2021-03-27,Sean O'Malley,KO/TKO,0,0,0,0
Viviane Araujo,2019-05-11,Talita Bernardo,KO/TKO,100,15,0,115
Viviane Araujo,2019-07-27,Alexis Davis,Decision - Unanimous,80,0,0,80
Viviane Araujo,2021-01-20,Roxanne Modafferi,Decision - Unanimous,80,40,0,120
Viviane Araujo,2022-10-15,Alexa Grasso,Decision - Unanimous,0,0,25,25
Viviane Araujo,2021-05-15,Katlyn Cerminara,Decision - Unanimous,0,0,0,0
Viviane Araujo,2024-11-16,Karine Silva,Decision - Unanimous,80,0,0,80
Viviane Araujo,2022-05-14,Andrea Lee,Decision - Unanimous,80,0,0,80
Viviane Araujo,2024-02-03,Natalia Silva,Decision - Unanimous,0,0,0,0
Viviane Araujo,2020-09-05,Montana De La Rosa,Decision - Unanimous,80,0,0,80
Viviane Araujo,2023-10-14,Jennifer Maia,Decision - Unanimous,80,0,0,80
Viviane Araujo,2019-12-14,Jessica Eye,Decision - Unanimous,0,0,0,0
Viviane Araujo,2023-03-04,Amanda Ribas,Decision - Unanimous,0,0,0,0
Talita Bernardo,2019-05-11,Viviane Araujo,KO/TKO,0,0,0,0
Talita Bernardo,2018-10-27,Sarah Moras,Decision - Unanimous,80,23,0,103
Talita Bernardo,2018-01-14,Irene Aldana,Decision - Unanimous,0,0,0,0
Talita Bernardo,2017-09-02,Marion Reneau,KO/TKO,0,0,0,0
Tom Blackledge,2011-02-26,Anthony Perosh,Submission,0,1,0,1
Scott Fiedler,1996-07-12,Brian Johnston,KO/TKO,0,1,0,1
Damir Ismagulov,2019-02-23,Joel Alvarez,Decision - Unanimous,80,26,0,106
Damir Ismagulov,2022-12-17,Arman Tsarukyan,Decision - Unanimous,0,2,0,2
Damir Ismagulov,2021-05-22,Rafael Alves,Decision - Unanimous,80,26,0,106
Damir Ismagulov,2022-06-18,Guram Kutateladze,Decision - Split,70,1,0,71
Damir Ismagulov,2023-07-01,Grant Dawson,Decision - Unanimous,0,0,0,0
Damir Ismagulov,2018-12-01,Alex Gorgees,Decision - Unanimous,80,24,0,104
Damir Ismagulov,2019-08-31,Thiago Moises,Decision - Unanimous,80,35,0,115
Joel Alvarez,2019-02-23,Damir Ismagulov,Decision - Unanimous,0,0,0,0
Joel Alvarez,2024-08-03,Elves Brener,KO/TKO,100,50,0,150
Joel Alvarez,2020-07-18,Joe Duffy,Submission,90,4,0,94
Joel Alvarez,2024-12-14,Drakkar Klose,KO/TKO,100,13,0,113
Joel Alvarez,2019-06-01,Danilo Belluardo,KO/TKO,100,6,0,106
Joel Alvarez,2022-02-26,Arman Tsarukyan,KO/TKO,0,0,0,0
Joel Alvarez,2023-07-22,Marc Diakiese,Submission,90,22,0,112
Joel Alvarez,2020-10-24,Alexander Yakovlev,Submission,90,3,0,93
Joel Alvarez,2021-11-13,Thiago Moises,KO/TKO,100,33,0,133
Mats Nilsson,2015-01-03,Omari Akhmedov,Decision - Unanimous,0,0,0,0
Mats Nilsson,2014-03-08,Luke Barnatt,KO/TKO,0,0,0,0
Michael Morales,2022-07-30,Adam Fugitt,KO/TKO,100,19,0,119
Michael Morales,2024-08-24,Neil Magny,KO/TKO,100,29,0,129
Michael Morales,2023-11-18,Jake Matthews,Decision - Unanimous,80,27,0,107
Michael Morales,2022-01-22,Trevin Giles,KO/TKO,100,18,0,118
Michael Morales,2023-07-01,Max Griffin,Decision - Unanimous,80,36,0,116
Michael Morales,2021-09-21,Nikolay Veretennikov,Decision - Unanimous,80,1,0,81
Jimmy Crute,2019-02-09,Sam Alvey,KO/TKO,100,11,0,111
Jimmy Crute,2018-07-24,Chris Birchler,KO/TKO,100,24,0,124
Jimmy Crute,2021-12-04,Jamahal Hill,KO/TKO,0,2,0,2
Jimmy Crute,2020-10-17,Modestas Bukauskas,KO/TKO,100,10,0,110
Jimmy Crute,2019-09-14,Misha Cirkunov,Submission,0,15,0,15
Jimmy Crute,2023-07-08,Alonzo Menifield,Submission,0,5,0,5
Jimmy Crute,2020-02-22,Michal Oleksiejczuk,Submission,90,0,0,90
Jimmy Crute,2018-12-01,Paul Craig,Submission,90,5,0,95
Jimmy Crute,2021-04-24,Anthony Smith,TKO - Doctor's Stoppage,0,0,0,0
Artem Lobov,2016-11-19,Teruto Ishihara,Decision - Unanimous,80,34,0,114
Artem Lobov,2018-10-27,Michael Johnson,Decision - Unanimous,0,0,0,0
Artem Lobov,2016-08-20,Chris Avila,Decision - Unanimous,80,11,0,91
Artem Lobov,2017-04-22,Cub Swanson,Decision - Unanimous,0,0,25,25
Artem Lobov,2015-12-11,Ryan Hall,Decision - Unanimous,0,0,0,0
Artem Lobov,2017-10-21,Andre Fili,Decision - Unanimous,0,0,0,0
Artem Lobov,2016-02-06,Alex White,Decision - Unanimous,0,0,0,0
Teruto Ishihara,2016-11-19,Artem Lobov,Decision - Unanimous,0,0,0,0
Teruto Ishihara,2019-02-09,Kyung Ho Kang,Submission,0,0,0,0
Teruto Ishihara,2017-07-07,Gray Maynard,Decision - Unanimous,0,0,0,0
Teruto Ishihara,2018-06-23,Petr Yan,KO/TKO,0,0,0,0
Teruto Ishihara,2016-03-05,Julian Erosa,KO/TKO,100,11,0,111
Teruto Ishihara,2017-09-22,Rolando Dy,Decision - Unanimous,80,2,0,82
Teruto Ishihara,2018-02-10,Jose Quinonez,Decision - Unanimous,0,0,0,0
Teruto Ishihara,2016-08-06,Horacio Gutierrez,KO/TKO,100,8,0,108
Nazim Sadykhov,2023-07-15,Terrance McKinney,Submission,90,2,0,92
Nazim Sadykhov,2022-08-16,Ahmad Hassanzada,KO/TKO,100,22,0,122
Nazim Sadykhov,2023-02-18,Evan Elder,TKO - Doctor's Stoppage,0,0,0,0
Terrance McKinney,2023-07-15,Nazim Sadykhov,Submission,0,0,0,0
Terrance McKinney,2021-06-12,Matt Frevola,KO/TKO,100,4,0,104
Terrance McKinney,2022-02-26,Fares Ziam,Submission,90,2,0,92
Terrance McKinney,2022-08-06,Erick Gonzalez,Submission,90,9,0,99
Terrance McKinney,2023-08-12,Mike Breeden,KO/TKO,100,29,0,129
Terrance McKinney,2023-01-21,Ismael Bonfim,KO/TKO,0,0,0,0
Terrance McKinney,2024-05-11,Esteban Ribovics,KO/TKO,0,0,0,0
Terrance McKinney,2023-10-14,Brendon Marotte,KO/TKO,100,13,0,113
Terrance McKinney,2019-07-23,Sean Woodson,KO/TKO,0,4,0,4
Terrance McKinney,2022-03-12,Drew Dober,KO/TKO,0,19,0,19
Yoshiki Takahashi,1997-02-07,Wallid Ismail,Decision - Unanimous,80,19,0,99
Yoshiki Takahashi,2004-04-25,Heath Herring,KO/TKO,0,0,0,0
Yoshiki Takahashi,2006-07-01,Vitor Belfort,KO/TKO,0,2,0,2
Yoshiki Takahashi,2005-02-20,Igor Vovchanchyn,KO/TKO,0,0,0,0
Wallid Ismail,1997-02-07,Yoshiki Takahashi,Decision - Unanimous,0,0,0,0
Wallid Ismail,1998-10-11,Akira Shoji,KO/TKO,0,0,0,0
Wallid Ismail,2001-07-29,Shungo Oyama,Submission,90,15,0,105
Wallid Ismail,2002-02-24,Alex Stiebling,Decision - Unanimous,0,0,0,0
Alen Amedovski,2019-04-20,Krzysztof Jotko,Decision - Unanimous,0,0,0,0
Alen Amedovski,2022-05-21,Joseph Holmes,Submission,0,0,0,0
Alen Amedovski,2019-09-28,John Phillips,KO/TKO,0,0,0,0
Alen Amedovski,2022-09-17,Joe Pyfer,KO/TKO,0,0,0,0
Allen Crowder,2019-06-22,Jairzinho Rozenstruik,KO/TKO,0,0,0,0
Allen Crowder,2019-01-19,Greg Hardy,DQ,0,0,0,0
Allen Crowder,2017-12-02,Justin Willis,KO/TKO,0,0,0,0
Allen Crowder,2017-08-29,Don'Tale Mayes,KO/TKO,100,28,0,128
Lisa Ellis,2015-05-09,Bec Rawlings,Submission,0,0,0,0
Lisa Ellis,2014-12-12,Felice Herrig,Submission,0,0,0,0
Lisa Ellis,2012-04-28,Jessica Penne,KO/TKO,0,2,0,2
Ahmad Hassanzada,2022-08-16,Nazim Sadykhov,KO/TKO,0,0,0,0
Ahmad Hassanzada,2024-09-17,Dylan Mantello,Submission,90,0,0,90
Alex White,2018-09-08,Jim Miller,Submission,0,0,0,0
Alex White,2014-12-06,Clay Collard,Decision - Unanimous,0,0,0,0
Alex White,2017-01-15,Anthony Rocco Martin,Decision - Unanimous,0,0,0,0
Alex White,2019-03-09,Dan Moret,Decision - Unanimous,80,7,0,87
Alex White,2018-01-14,James Krause,Decision - Unanimous,0,21,0,21
Alex White,2014-04-19,Estevan Payan,KO/TKO,100,10,0,110
Alex White,2017-09-09,Mitch Clarke,KO/TKO,100,29,0,129
Alex White,2019-10-26,Rafael Fiziev,Decision - Unanimous,0,0,0,0
Alex White,2014-07-16,Lucas Martins,KO/TKO,0,0,0,0
Alex White,2016-02-06,Artem Lobov,Decision - Unanimous,80,55,0,135
Matthew Riddle,2009-02-07,Steve Bruno,Decision - Unanimous,80,26,0,106
Matthew Riddle,2010-08-01,DaMarques Johnson,KO/TKO,100,33,0,133
Matthew Riddle,2009-11-14,Nick Osipczak,KO/TKO,0,0,0,0
Matthew Riddle,2012-02-04,Henry Martinez,Decision - Split,70,7,0,77
Matthew Riddle,2008-06-21,Dante Rivera,Decision - Unanimous,80,26,0,106
Matthew Riddle,2009-08-08,Dan Cramer,Decision - Unanimous,80,42,0,122
Matthew Riddle,2011-09-17,Lance Benoist,Decision - Unanimous,0,0,0,0
Matthew Riddle,2010-12-11,Sean Pierson,Decision - Unanimous,0,0,0,0
Matthew Riddle,2012-11-17,John Maguire,Decision - Unanimous,80,8,0,88
Matthew Riddle,2010-03-27,Greg Soto,DQ,0,26,0,26
Steve Bruno,2009-02-07,Matthew Riddle,Decision - Unanimous,0,0,0,0
Steve Bruno,2008-08-09,Chris Wilson,Decision - Unanimous,0,0,0,0
Steve Bruno,2008-12-10,Johnny Rees,Submission,90,0,0,90
Mark Eddiva,2016-03-19,Dan Hooker,Submission,0,0,0,0
Mark Eddiva,2014-05-31,Edimilson Souza,KO/TKO,0,0,0,0
Mark Eddiva,2015-05-16,Levan Makashvili,Decision - Split,0,5,0,5
Mark Eddiva,2014-03-01,Jumabieke Tuerxun,Decision - Unanimous,80,37,0,117
Brandon Lewis,2022-09-13,Daniel Marcos,Decision - Unanimous,0,0,0,0
Brandon Lewis,2021-09-14,Mo Miller,Decision - Unanimous,0,0,0,0
Dokonjonosuke Mishima,2006-11-18,Joe Stevenson,Submission,0,0,0,0
Dokonjonosuke Mishima,2003-10-05,Ralph Gracie,Decision - Unanimous,0,8,0,8
Dokonjonosuke Mishima,2005-05-22,Yves Edwards,Submission,0,0,0,0
Dokonjonosuke Mishima,2007-04-05,Kenny Florian,Submission,0,0,0,0
Dokonjonosuke Mishima,2004-07-19,Marcus Aurelio,Decision - Split,70,11,0,81
Dokonjonosuke Mishima,2005-09-25,Charles Bennett,Submission,90,5,0,95
Jimmy Ambriz,2010-03-22,Ikuhisa Minowa,Submission,0,0,0,0
Jimmy Ambriz,2005-10-14,Ricco Rodriguez,KO/TKO,0,0,0,0
Jimmy Ambriz,2008-09-23,Sergei Kharitonov,KO/TKO,0,0,0,0
Mara Romero Borella,2019-08-03,Lauren Murphy,KO/TKO,0,0,0,0
Mara Romero Borella,2018-01-27,Katlyn Cerminara,Decision - Unanimous,0,11,0,11
Mara Romero Borella,2020-02-15,Montana De La Rosa,Decision - Unanimous,0,0,0,0
Mara Romero Borella,2020-05-16,Cortney Casey,Submission,0,0,0,0
Mara Romero Borella,2019-02-02,Taila Santos,Decision - Split,70,0,0,70
Mara Romero Borella,2020-09-19,Mayra Bueno Silva,Submission,0,4,0,4
Mara Romero Borella,2017-10-07,Kalindra Faria,Submission,90,3,0,93
Cheick Kongo,2006-07-08,Gilbert Aldana,TKO - Doctor's Stoppage,0,18,0,18
Cheick Kongo,2010-03-21,Paul Buentello,KO/TKO,100,50,0,150
Cheick Kongo,2011-10-29,Matt Mitrione,Decision - Unanimous,80,23,0,103
Cheick Kongo,2009-04-18,Antoni Hardonk,KO/TKO,100,44,0,144
Cheick Kongo,2008-12-27,Mostapha Al-Turk,KO/TKO,100,30,0,130
Cheick Kongo,2009-12-12,Frank Mir,Submission,0,0,0,0
Cheick Kongo,2006-10-14,Carmelo Marrero,Decision - Split,0,2,0,2
Cheick Kongo,2007-09-08,Mirko Filipovic,Decision - Unanimous,80,48,0,128
Cheick Kongo,2007-04-21,Assuerio Silva,Decision - Majority,75,51,0,126
Cheick Kongo,2012-07-21,Shawn Jordan,Decision - Unanimous,80,23,0,103
Cheick Kongo,2008-03-01,Heath Herring,Decision - Split,0,0,0,0
Cheick Kongo,2008-08-09,Dan Evensen,KO/TKO,100,21,0,121
Cheick Kongo,2011-06-26,Pat Barry,KO/TKO,100,2,0,102
Cheick Kongo,2012-02-25,Mark Hunt,KO/TKO,0,0,0,0
Cheick Kongo,2006-08-26,Christian Wellisch,KO/TKO,100,17,0,117
Cheick Kongo,2009-06-13,Cain Velasquez,Decision - Unanimous,0,0,0,0
Cheick Kongo,2013-04-27,Roy Nelson,KO/TKO,0,2,0,2
Gilbert Aldana,2006-07-08,Cheick Kongo,TKO - Doctor's Stoppage,0,0,0,0
Gilbert Aldana,2006-02-04,Paul Buentello,KO/TKO,0,0,0,0
Sergio Pettis,2016-04-23,Chris Kelades,Decision - Unanimous,80,26,0,106
Sergio Pettis,2019-09-21,Tyson Nam,Decision - Unanimous,80,56,0,136
Sergio Pettis,2017-12-02,Henry Cejudo,Decision - Unanimous,0,0,0,0
Sergio Pettis,2018-10-06,Jussier Formiga,Decision - Unanimous,0,12,0,12
Sergio Pettis,2015-03-14,Ryan Benoit,KO/TKO,0,11,0,11
Sergio Pettis,2017-01-15,John Moraga,Decision - Unanimous,80,15,0,95
Sergio Pettis,2014-06-07,Yaotzin Meza,Decision - Unanimous,80,11,0,91
Sergio Pettis,2014-01-25,Alex Caceres,Submission,0,0,0,0
Sergio Pettis,2018-06-09,Joseph Benavidez,Decision - Split,70,15,0,85
Sergio Pettis,2013-11-16,Will Campuzano,Decision - Unanimous,80,40,0,120
Sergio Pettis,2018-12-15,Rob Font,Decision - Unanimous,0,0,0,0
Sergio Pettis,2015-10-03,Chris Cariaso,Decision - Unanimous,80,0,0,80
Sergio Pettis,2017-08-05,Brandon Moreno,Decision - Unanimous,80,31,25,136
Sergio Pettis,2014-12-06,Matt Hobar,Decision - Unanimous,80,42,0,122
Chris Kelades,2016-04-23,Sergio Pettis,Decision - Unanimous,0,0,0,0
Chris Kelades,2015-08-23,Chris Beal,Decision - Split,70,3,0,73
Chris Kelades,2015-02-14,Ray Borg,Submission,0,0,0,0
Chris Kelades,2014-10-04,Paddy Holohan,Decision - Unanimous,80,24,0,104
Nora Cornolle,2023-09-02,Joselyne Edwards,Decision - Unanimous,80,22,0,102
Nora Cornolle,2024-09-28,Jacqueline Cavalcanti,Decision - Split,0,0,0,0
Nora Cornolle,2024-04-06,Melissa Mullins,KO/TKO,100,25,0,125
Erik Silva,2022-08-09,Anvar Boynazarov,KO/TKO,100,12,0,112
Erik Silva,2024-02-24,Muhammad Naimov,KO/TKO,0,0,0,0
Erik Silva,2022-12-10,TJ Brown,Submission,0,0,0,0
Anvar Boynazarov,2022-08-09,Erik Silva,KO/TKO,0,0,0,0
MarQuel Mederos,2024-02-03,Landon Quinones,Decision - Unanimous,80,5,0,85
MarQuel Mederos,2023-10-10,Issa Isakov,KO/TKO,100,16,0,116
Landon Quinones,2024-02-03,MarQuel Mederos,Decision - Unanimous,0,0,0,0
Landon Quinones,2023-09-09,Nasrat Haqparast,Decision - Unanimous,0,0,0,0
Dong Hyun Kim,2014-03-01,John Hathaway,KO/TKO,100,0,25,125
Dong Hyun Kim,2013-03-02,Siyar Bahadurzada,Decision - Unanimous,80,18,0,98
Dong Hyun Kim,2011-01-01,Nate Diaz,Decision - Unanimous,80,0,0,80
Dong Hyun Kim,2012-11-10,Paulo Thiago,Decision - Unanimous,80,20,0,100
Dong Hyun Kim,2011-07-02,Carlos Condit,KO/TKO,0,0,0,0
Dong Hyun Kim,2008-09-06,Matt Brown,Decision - Split,70,0,0,70
Dong Hyun Kim,2015-05-23,Joshua Burkman,Submission,90,10,0,100
Dong Hyun Kim,2017-06-17,Colby Covington,Decision - Unanimous,0,0,0,0
Dong Hyun Kim,2009-07-11,TJ Grant,Decision - Unanimous,80,7,0,87
Dong Hyun Kim,2011-12-30,Sean Pierson,Decision - Unanimous,80,21,0,101
Dong Hyun Kim,2010-05-29,Amir Sadollah,Decision - Unanimous,80,20,0,100
Dong Hyun Kim,2014-08-23,Tyron Woodley,KO/TKO,0,0,0,0
Dong Hyun Kim,2015-11-28,Dominic Waters,KO/TKO,100,6,0,106
Dong Hyun Kim,2012-07-07,Demian Maia,KO/TKO,0,7,0,7
Dong Hyun Kim,2013-10-09,Erick Silva,KO/TKO,100,0,0,100
Dong Hyun Kim,2016-12-30,Tarec Saffiedine,Decision - Split,70,0,0,70
Dong Hyun Kim,2008-05-24,Jason Tan,KO/TKO,100,75,0,175
Danny Roberts,2021-10-16,Ramazan Emeev,Decision - Split,70,0,0,70
Danny Roberts,2023-07-22,Jonny Parsons,KO/TKO,0,0,0,0
Danny Roberts,2022-11-19,Jack Della Maddalena,KO/TKO,0,0,0,0
Danny Roberts,2016-04-23,Dominique Steele,Decision - Unanimous,80,26,0,106
Danny Roberts,2019-03-16,Claudio Silva,Submission,0,7,0,7
Danny Roberts,2016-10-08,Mike Perry,KO/TKO,0,0,0,0
Danny Roberts,2017-12-16,Nordine Taleb,KO/TKO,0,0,0,0
Danny Roberts,2022-05-07,Francisco Trinaldo,Decision - Unanimous,0,0,0,0
Danny Roberts,2015-12-10,Nathan Coy,Submission,90,0,0,90
Danny Roberts,2018-03-17,Oliver Enkamp,KO/TKO,100,0,0,100
Danny Roberts,2018-07-22,David Zawada,Decision - Split,70,12,0,82
Danny Roberts,2017-07-16,Bobby Nash,KO/TKO,100,0,0,100
Danny Roberts,2019-11-09,Zelim Imadaev,KO/TKO,100,9,0,109
Danny Roberts,2019-05-18,Michel Pereira,KO/TKO,0,0,0,0
Mark De La Rosa,2020-06-13,Jordan Espinosa,Decision - Unanimous,0,0,0,0
Mark De La Rosa,2018-07-14,Elias Garcia,Submission,90,6,0,96
Mark De La Rosa,2019-08-31,Kai Kara-France,Decision - Unanimous,0,0,0,0
Mark De La Rosa,2017-12-30,Tim Elliott,Submission,0,0,0,0
Mark De La Rosa,2020-02-15,Raulian Paiva,KO/TKO,0,0,0,0
Mark De La Rosa,2019-03-30,Alex Perez,Decision - Unanimous,0,0,0,0
Mark De La Rosa,2018-11-10,Joby Sanchez,Decision - Split,70,11,0,81
Mikhail Iloukhine,2003-06-08,Quinton Jackson,KO/TKO,0,0,0,0
Jessica-Rose Clark,2022-02-19,Stephanie Egger,Submission,0,0,0,0
Jessica-Rose Clark,2019-11-09,Pannie Kianzad,Decision - Unanimous,0,0,0,0
Jessica-Rose Clark,2020-09-19,Sarah Alpar,KO/TKO,100,64,0,164
Jessica-Rose Clark,2023-05-13,Tainara Lisboa,Submission,0,0,0,0
Jessica-Rose Clark,2021-10-23,Joselyne Edwards,Decision - Unanimous,80,0,0,80
Jessica-Rose Clark,2018-06-23,Jessica Eye,Decision - Unanimous,0,0,0,0
Jessica-Rose Clark,2017-11-18,Bec Rawlings,Decision - Split,70,36,0,106
Jessica-Rose Clark,2022-07-02,Julija Stoliarenko,Submission,0,3,0,3
Jessica-Rose Clark,2018-01-14,Paige VanZant,Decision - Unanimous,80,1,0,81
Joseph Gigliotti,2016-08-06,Trevor Smith,Decision - Unanimous,0,0,0,0
Joseph Gigliotti,2016-12-09,Gerald Meerschaert,Submission,0,0,0,0
Luke Cummo,2005-11-05,Joe Stevenson,Decision - Unanimous,0,0,0,0
Luke Cummo,2008-08-09,Tamdan McCrory,Decision - Unanimous,0,0,0,0
Luke Cummo,2006-06-28,Jonathan Goulet,Decision - Majority,0,0,0,0
Luke Cummo,2007-09-19,Edilberto de Oliveira,KO/TKO,100,1,0,101
Luke Cummo,2008-03-01,Luigi Fioravanti,Decision - Unanimous,0,0,0,0
Luke Cummo,2006-04-06,Jason Von Flue,Decision - Unanimous,80,26,0,106
Luke Cummo,2007-04-07,Josh Haynes,KO/TKO,100,29,0,129
Luana Santos,2023-08-12,Juliana Miller,KO/TKO,100,39,0,139
Luana Santos,2024-07-13,Mariya Agapova,Submission,90,0,0,90
Luana Santos,2024-08-17,Casey O'Neill,Decision - Unanimous,0,0,0,0
Luana Santos,2023-12-09,Stephanie Egger,Decision - Unanimous,80,9,0,89
Juliana Miller,2023-08-12,Luana Santos,KO/TKO,0,0,0,0
Juliana Miller,2023-03-18,Veronica Hardy,Decision - Unanimous,0,0,0,0
Juliana Miller,2022-08-06,Brogan Walker,KO/TKO,100,24,0,124
Steven Graham,1997-05-30,Dmitri Stepanov,Submission,90,0,0,90
Steven Graham,1997-05-30,Randy Couture,KO/TKO,0,0,0,0
Dmitri Stepanov,1997-05-30,Steven Graham,Submission,0,1,0,1
Kiyoshi Tamura,2003-08-10,Hidehiko Yoshida,Submission,0,7,0,7
Kiyoshi Tamura,2003-12-31,Rony Sefo,Submission,90,1,0,91
Kiyoshi Tamura,2006-02-26,Antonio Rodrigo Nogueira,Submission,0,0,0,0
Kiyoshi Tamura,2005-02-20,Aliev Makhmud,KO/TKO,100,8,0,108
Kiyoshi Tamura,2002-02-24,Wanderlei Silva,KO/TKO,0,0,0,0
Kiyoshi Tamura,2005-06-26,Makoto Takimoto,Decision - Unanimous,80,31,0,111
Kiyoshi Tamura,2006-12-31,Ikuhisa Minowa,KO/TKO,100,0,0,100
Kiyoshi Tamura,2008-12-31,Kazushi Sakuraba,Decision - Unanimous,80,13,0,93
Kiyoshi Tamura,2008-04-29,Masakatsu Funaki,KO/TKO,100,5,0,105
Kiyoshi Tamura,2002-06-23,Bob Sapp,KO/TKO,0,0,0,0
Kiyoshi Tamura,2002-11-24,Nobuhiko Takada,KO/TKO,100,36,0,136
Igor Pokrajac,2009-09-19,Vladimir Matyushenko,Decision - Unanimous,0,0,0,0
Igor Pokrajac,2011-12-10,Krzysztof Soszynski,KO/TKO,100,17,0,117
Igor Pokrajac,2014-12-20,Marcos Rogerio de Lima,KO/TKO,0,0,0,0
Igor Pokrajac,2013-11-09,Rafael Cavalcante,KO/TKO,0,0,0,0
Igor Pokrajac,2010-12-04,Stephan Bonnar,Decision - Unanimous,0,0,0,0
Igor Pokrajac,2010-02-20,James Te Huna,KO/TKO,0,3,0,3
Igor Pokrajac,2013-06-15,Ryan Jimmo,Decision - Unanimous,0,0,0,0
Igor Pokrajac,2011-03-03,Todd Brown,KO/TKO,100,2,0,102
Igor Pokrajac,2012-09-22,Vinny Magalhaes,Submission,0,0,0,0
Igor Pokrajac,2012-05-15,Fabio Maldonado,Decision - Unanimous,80,0,0,80
Igor Pokrajac,2010-08-01,James Irvin,Submission,90,7,0,97
Igor Pokrajac,2016-04-10,Jan Blachowicz,Decision - Unanimous,0,0,0,0
Gideon Ray,2005-02-05,David Loiseau,TKO - Doctor's Stoppage,0,0,0,0
Gideon Ray,2006-11-11,Charles McCarthy,Submission,0,7,0,7
Gideon Ray,2005-08-06,Mike Swick,KO/TKO,0,0,0,0
Reza Madadi,2012-10-13,Cristiano Marcello,Decision - Split,0,5,0,5
Reza Madadi,2013-04-06,Michael Johnson,Submission,90,14,0,104
Reza Madadi,2012-04-14,Yoislandy Izquierdo,Submission,90,0,0,90
Reza Madadi,2016-05-08,Yan Cabral,KO/TKO,100,0,0,100
Reza Madadi,2015-10-24,Norman Parke,Decision - Unanimous,0,0,0,0
Reza Madadi,2017-03-18,Joe Duffy,Decision - Unanimous,0,0,0,0
Reza Madadi,2017-05-28,Joaquim Silva,Decision - Split,0,0,0,0
Nursulton Ruziboev,2024-03-30,Sedriques Dumas,KO/TKO,100,11,0,111
Nursulton Ruziboev,2024-05-11,Joaquin Buckley,Decision - Unanimous,0,0,0,0
Nursulton Ruziboev,2023-07-01,Brunno Ferreira,KO/TKO,100,3,0,103
Jesse Butler,2023-06-03,Jim Miller,KO/TKO,0,0,0,0
Jesse Butler,2024-06-08,Brad Katona,Decision - Unanimous,0,0,0,0
Jonathan Goulet,2007-12-08,Paul Georgieff,Submission,90,0,0,90
Jonathan Goulet,2006-06-28,Luke Cummo,Decision - Majority,75,5,0,80
Jonathan Goulet,2005-10-03,Jay Hieron,TKO - Doctor's Stoppage,0,4,0,4
Jonathan Goulet,2008-04-19,Kuniyoshi Hironaka,KO/TKO,100,10,0,110
Jonathan Goulet,2006-08-17,Josh Koscheck,KO/TKO,0,0,0,0
Jonathan Goulet,2007-09-19,Dustin Hazelett,Submission,0,0,0,0
Jonathan Goulet,2010-05-08,Marcus Davis,KO/TKO,0,0,0,0
Jonathan Goulet,2006-01-16,Duane Ludwig,KO/TKO,0,0,0,0
Jonathan Goulet,2008-12-10,Mike Swick,KO/TKO,0,0,0,0
Paul Georgieff,2007-12-08,Jonathan Goulet,Submission,0,1,0,1
Keith Jardine,2012-07-14,Roger Gracie,Decision - Unanimous,0,0,0,0
Keith Jardine,2006-04-06,Stephan Bonnar,Decision - Unanimous,0,31,0,31
Keith Jardine,2006-12-30,Forrest Griffin,KO/TKO,100,19,0,119
Keith Jardine,2010-02-20,Ryan Bader,KO/TKO,0,0,0,0
Keith Jardine,2006-02-04,Mike Whitehead,Decision - Unanimous,80,17,0,97
Keith Jardine,2008-05-24,Wanderlei Silva,KO/TKO,0,0,0,0
Keith Jardine,2002-06-19,Philip Preece,Decision - Unanimous,80,0,0,80
Keith Jardine,2002-12-15,Bryan Pardoe,KO/TKO,100,3,0,103
Keith Jardine,2007-05-26,Houston Alexander,KO/TKO,0,0,0,0
Keith Jardine,2009-08-29,Thiago Silva,KO/TKO,0,0,0,0
Keith Jardine,2005-11-05,Kerry Schall,KO/TKO,100,33,0,133
Keith Jardine,2003-06-14,George Allen,Decision - Unanimous,80,23,0,103
Keith Jardine,2012-01-07,Luke Rockhold,KO/TKO,0,0,25,25
Keith Jardine,2006-06-24,Wilson Gouveia,Decision - Unanimous,80,19,0,99
Keith Jardine,2001-08-19,Amir Rahnavardi,Submission,90,0,0,90
Keith Jardine,2010-06-19,Matt Hamill,Decision - Majority,0,0,0,0
Keith Jardine,2007-09-22,Chuck Liddell,Decision - Split,70,52,0,122
Keith Jardine,2008-10-18,Brandon Vera,Decision - Split,70,2,0,72
Keith Jardine,2009-03-07,Quinton Jackson,Decision - Unanimous,0,8,0,8
Dave Galera,2014-01-04,Royston Wee,Decision - Unanimous,0,17,0,17
Eperaim Ginting,2023-05-28,Daermisi Zhawupasi,Submission,0,0,0,0
Felice Herrig,2015-04-18,Paige VanZant,Decision - Unanimous,0,0,0,0
Felice Herrig,2014-12-12,Lisa Ellis,Submission,90,4,0,94
Felice Herrig,2017-06-25,Justine Kish,Decision - Unanimous,80,7,0,87
Felice Herrig,2018-10-06,Michelle Waterson-Gomez,Decision - Unanimous,0,0,0,0
Felice Herrig,2016-07-23,Kailin Curran,Submission,90,8,0,98
Felice Herrig,2018-04-07,Karolina Kowalkiewicz,Decision - Split,0,0,0,0
Felice Herrig,2020-08-15,Virna Jandiroba,Submission,0,0,0,0
Felice Herrig,2022-06-04,Karolina Kowalkiewicz,Submission,0,0,0,0
Felice Herrig,2017-02-04,Alexa Grasso,Decision - Unanimous,80,0,0,80
Felice Herrig,2017-12-02,Cortney Casey,Decision - Split,70,0,0,70
Patrick Smith,1995-07-14,Rudyard Moncayo,Submission,90,6,0,96
Patrick Smith,1994-03-11,Johnny Rhodes,Submission,90,1,0,91
Patrick Smith,1994-03-11,Scott Morris,KO/TKO,100,13,0,113
Patrick Smith,1994-03-11,Ray Wizard,Submission,90,0,0,90
Patrick Smith,1993-11-12,Ken Shamrock,Submission,0,3,0,3
Patrick Smith,1994-03-11,Royce Gracie,KO/TKO,0,0,0,0
Rudyard Moncayo,1995-07-14,Patrick Smith,Submission,0,0,0,0
Uros Medic,2021-03-06,Aalon Cruz,KO/TKO,100,45,0,145
Uros Medic,2023-11-18,Myktybek Orolbai,Submission,0,6,0,6
Uros Medic,2020-08-04,Mikey Gonzalez,KO/TKO,100,30,0,130
Uros Medic,2021-09-25,Jalin Turner,Submission,0,0,0,0
Uros Medic,2024-04-27,Tim Means,KO/TKO,100,0,0,100
Uros Medic,2022-05-21,Omar Morales,KO/TKO,100,14,0,114
Uros Medic,2023-07-29,Matthew Semelsberger,KO/TKO,100,17,0,117
Aalon Cruz,2021-03-06,Uros Medic,KO/TKO,0,0,0,0
Aalon Cruz,2019-07-30,Steven Nguyen,KO/TKO,100,40,0,140
Aalon Cruz,2020-02-29,Spike Carlyle,KO/TKO,0,0,0,0
Renee Forte,2013-02-16,Terry Etim,Decision - Unanimous,80,34,0,114
Renee Forte,2013-09-21,John Makdessi,KO/TKO,0,0,0,0
Renee Forte,2012-10-13,Sergio Moraes,Submission,0,10,0,10
Renee Forte,2014-03-15,Francisco Trevino,Decision - Unanimous,0,0,0,0
Terry Etim,2013-02-16,Renee Forte,Decision - Unanimous,0,0,0,0
Terry Etim,2008-10-18,Sam Stout,Decision - Unanimous,80,14,0,94
Terry Etim,2007-09-08,Gleison Tibau,Decision - Unanimous,0,4,0,4
Terry Etim,2011-11-05,Edward Faaloloto,Submission,90,5,0,95
Terry Etim,2007-04-21,Matt Grice,Submission,90,0,0,90
Terry Etim,2009-11-14,Shannon Gugerty,Submission,90,6,0,96
Terry Etim,2010-04-10,Rafael Dos Anjos,Submission,0,0,0,0
Terry Etim,2012-01-14,Edson Barboza,KO/TKO,0,0,0,0
Terry Etim,2009-06-13,Justin Buchholz,Submission,90,4,0,94
Terry Etim,2009-02-21,Brian Cobb,KO/TKO,100,19,0,119
Terry Etim,2008-05-24,Rich Clementi,Decision - Unanimous,0,3,0,3
Jason High,2009-07-20,Andre Galvao,Decision - Split,70,11,0,81
Jason High,2013-08-28,James Head,Submission,90,1,0,91
Jason High,2009-04-05,Yuya Shirai,Submission,90,3,0,93
Jason High,2012-07-14,Nate Moore,Submission,90,0,0,90
Jason High,2014-06-07,Rafael Dos Anjos,KO/TKO,0,0,0,0
Jason High,2013-11-16,Anthony Lapsley,Decision - Unanimous,80,0,0,80
Jason High,2010-03-31,Charlie Brenneman,Decision - Unanimous,0,0,0,0
Jason High,2009-07-20,Marius Zaromskis,KO/TKO,0,0,0,0
Jason High,2010-12-31,Hayato Sakurai,Decision - Split,70,9,0,79
Jason High,2009-01-24,Jay Hieron,KO/TKO,0,0,0,0
Jason High,2013-06-08,Erick Silva,Submission,0,0,0,0
Vinicius Oliveira,2023-09-26,Victor Madrigal,KO/TKO,100,22,0,122
Vinicius Oliveira,2024-03-02,Benardo Sopaj,KO/TKO,100,22,0,122
Vinicius Oliveira,2024-06-29,Ricky Simon,Decision - Unanimous,80,54,0,134
Victor Madrigal,2023-09-26,Vinicius Oliveira,KO/TKO,0,0,0,0
Chris Barnett,2021-11-06,Gian Villante,KO/TKO,100,8,0,108
Chris Barnett,2024-10-26,Kennedy Nzechukwu,KO/TKO,0,0,0,0
Chris Barnett,2022-09-10,Jake Collier,KO/TKO,100,3,0,103
Chris Barnett,2021-05-22,Ben Rothwell,Submission,0,0,0,0
Chris Barnett,2022-04-16,Martin Buday,Decision - Unanimous,0,0,0,0
Youssef Zalal,2020-08-08,Peter Barrett,Decision - Unanimous,80,31,0,111
Youssef Zalal,2024-08-10,Jarno Errens,Submission,90,4,0,94
Youssef Zalal,2020-02-08,Austin Lingo,Decision - Unanimous,80,19,0,99
Youssef Zalal,2021-02-06,SeungWoo Choi,Decision - Unanimous,0,0,0,0
Youssef Zalal,2021-06-05,Sean Woodson,Decision - Split,0,2,0,2
Youssef Zalal,2024-03-23,Billy Quarantillo,Submission,90,23,0,113
Youssef Zalal,2024-11-02,Jack Shore,Submission,90,5,0,95
Youssef Zalal,2020-10-10,Ilia Topuria,Decision - Unanimous,0,4,0,4
Youssef Zalal,2020-06-27,Jordan Griffin,Decision - Unanimous,80,31,0,111
Peter Barrett,2020-08-08,Youssef Zalal,Decision - Unanimous,0,0,0,0
Peter Barrett,2019-08-27,SangHoon Yoo,Decision - Unanimous,80,34,0,114
Peter Barrett,2020-12-12,Chase Hooper,Submission,0,0,0,0
Aiemann Zahabi,2023-06-10,Aoriqileng,KO/TKO,100,0,0,100
Aiemann Zahabi,2019-05-04,Vince Morales,Decision - Unanimous,0,0,0,0
Aiemann Zahabi,2022-07-09,Ricky Turcios,Decision - Unanimous,80,27,0,107
Aiemann Zahabi,2021-02-20,Drako Rodriguez,KO/TKO,100,0,0,100
Aiemann Zahabi,2024-11-02,Pedro Munhoz,Decision - Unanimous,80,14,0,94
Aiemann Zahabi,2017-02-19,Reginaldo Vieira,Decision - Unanimous,80,0,0,80
Aiemann Zahabi,2024-03-02,Javid Basharat,Decision - Unanimous,80,8,0,88
Aiemann Zahabi,2017-11-04,Ricardo Ramos,KO/TKO,0,4,0,4
Aoriqileng,2023-06-10,Aiemann Zahabi,KO/TKO,0,0,0,0
Aoriqileng,2023-10-07,Johnny Munoz,Decision - Unanimous,80,37,0,117
Aoriqileng,2022-08-20,Jay Perrin,Decision - Unanimous,80,0,0,80
Aoriqileng,2021-04-24,Jeff Molina,Decision - Unanimous,0,0,0,0
Aoriqileng,2022-04-23,Cameron Else,KO/TKO,100,31,0,131
Aoriqileng,2021-11-20,Cody Durden,Decision - Unanimous,0,5,0,5
Aoriqileng,2024-09-14,Raul Rosas Jr.,Decision - Unanimous,0,0,0,0
Marco Tulio,2023-08-29,Yousri Belgaroui,Decision - Unanimous,80,15,0,95
Marco Tulio,2024-08-27,Matthieu Duclos,KO/TKO,100,22,0,122
Yousri Belgaroui,2023-08-29,Marco Tulio,Decision - Unanimous,0,0,0,0
Yousri Belgaroui,2024-09-10,Taiga Iwasaki,KO/TKO,100,64,0,164
Manuel Torres,2022-05-14,Frank Camacho,KO/TKO,100,18,0,118
Manuel Torres,2021-10-26,Kolton Englund,KO/TKO,100,20,0,120
Manuel Torres,2023-06-17,Nikolas Motta,KO/TKO,100,6,0,106
Manuel Torres,2024-02-24,Chris Duncan,Submission,90,2,0,92
Manuel Torres,2024-09-14,Ignacio Bahamondes,KO/TKO,0,0,0,0
Trevor Harris,2006-07-28,Colley  Bradford,Submission,90,3,0,93
Colley  Bradford,2006-07-28,Trevor Harris,Submission,0,0,0,0
Kristof Midoux,2003-03-22,Fabricio Werdum,Submission,0,1,0,1
Kristof Midoux,2006-08-17,Jake O'Brien,KO/TKO,0,0,0,0
James Head,2013-08-28,Jason High,Submission,0,0,0,0
James Head,2012-07-21,Brian Ebersole,Decision - Split,70,2,0,72
James Head,2012-04-14,Papy Abedi,Submission,90,10,0,100
James Head,2012-12-15,Mike Pyle,KO/TKO,0,4,0,4
James Head,2011-06-11,Nick Ring,Submission,0,0,0,0
Phil Davis,2010-04-10,Alexander Gustafsson,Submission,90,14,0,104
Phil Davis,2012-01-28,Rashad Evans,Decision - Unanimous,0,0,25,25
Phil Davis,2015-01-24,Ryan Bader,Decision - Split,0,9,0,9
Phil Davis,2013-04-27,Vinny Magalhaes,Decision - Unanimous,80,50,0,130
Phil Davis,2010-02-06,Brian Stann,Decision - Unanimous,80,43,0,123
Phil Davis,2013-08-03,Lyoto Machida,Decision - Unanimous,80,0,0,80
Phil Davis,2014-04-26,Anthony Johnson,Decision - Unanimous,0,0,0,0
Phil Davis,2010-11-20,Tim Boetsch,Submission,90,26,0,116
Phil Davis,2011-03-26,Rogerio Nogueira,Decision - Unanimous,80,34,0,114
Phil Davis,2010-08-07,Rodney Wallace,Decision - Unanimous,80,57,0,137
Phil Davis,2014-10-25,Glover Teixeira,Decision - Unanimous,80,40,0,120
Hayder Hassan,2015-12-19,Vicente Luque,Submission,0,3,0,3
Hayder Hassan,2015-07-12,Kamaru Usman,Submission,0,0,0,0
Mallory Martin,2020-08-29,Hannah Cifers,Submission,90,0,0,90
Mallory Martin,2019-12-07,Virna Jandiroba,Submission,0,2,0,2
Mallory Martin,2019-08-20,Micol Di Segni,Decision - Unanimous,80,0,0,80
Mallory Martin,2021-12-04,Cheyanne Vlismas,Decision - Unanimous,0,0,0,0
Mallory Martin,2021-02-13,Polyana Viana,Submission,0,1,0,1
Hannah Cifers,2020-08-29,Mallory Martin,Submission,0,27,0,27
Hannah Cifers,2020-01-25,Angela Hill,KO/TKO,0,0,0,0
Hannah Cifers,2019-08-17,Jodie Esquibel,Decision - Unanimous,80,27,0,107
Hannah Cifers,2020-06-13,Mariya Agapova,Submission,0,0,0,0
Hannah Cifers,2020-05-30,Mackenzie Dern,Submission,0,2,0,2
Hannah Cifers,2018-11-10,Maycee Barber,KO/TKO,0,0,0,0
Hannah Cifers,2019-03-02,Polyana Viana,Decision - Split,70,0,0,70
Dustin Pague,2013-10-19,Kyoji Horiguchi,KO/TKO,0,0,0,0
Dustin Pague,2012-08-11,Chico Camus,Decision - Unanimous,0,0,0,0
Dustin Pague,2011-12-03,John Albert,KO/TKO,0,0,0,0
Dustin Pague,2012-06-08,Jared Papazian,Submission,90,0,0,90
Dustin Pague,2013-06-15,Yves Jabouin,Decision - Split,0,0,0,0
Dustin Pague,2012-06-22,Ken Stone,Decision - Split,0,0,0,0
Corey Hill,2008-01-23,Joe Veres,KO/TKO,100,29,0,129
Corey Hill,2008-12-10,Dale Hartt,KO/TKO,0,0,0,0
Corey Hill,2008-07-05,Justin Buchholz,Submission,0,10,0,10
Joe Veres,2008-01-23,Corey Hill,KO/TKO,0,0,0,0
Joe Veres,2007-09-19,Gray Maynard,KO/TKO,0,0,0,0
Jens Pulver,2002-01-11,BJ Penn,Decision - Majority,75,0,25,100
Jens Pulver,2008-11-05,Leonard Garcia,KO/TKO,0,0,0,0
Jens Pulver,2000-03-10,David Velasquez,KO/TKO,100,34,0,134
Jens Pulver,2006-09-23,Joe Lauzon,KO/TKO,0,0,0,0
Jens Pulver,2008-06-01,Urijah Faber,Decision - Unanimous,0,0,25,25
Jens Pulver,2000-11-17,John Lewis,KO/TKO,100,1,0,101
Jens Pulver,2001-02-23,Caol Uno,Decision - Unanimous,80,0,25,105
Jens Pulver,2010-03-06,Javier Vazquez,Submission,0,5,0,5
Jens Pulver,2001-09-28,Dennis Hallman,Decision - Unanimous,80,12,25,117
Jens Pulver,2004-12-31,Takanori Gomi,KO/TKO,0,0,0,0
Jens Pulver,2000-06-09,Joao Roque,Decision - Unanimous,80,0,0,80
Jens Pulver,2009-01-25,Urijah Faber,Submission,0,0,0,0
Jens Pulver,2007-12-12,Cub Swanson,Submission,90,0,0,90
Jens Pulver,2009-06-07,Josh Grispi,Submission,0,0,0,0
Jens Pulver,1999-06-01,Joe Stevenson,KO/TKO,100,3,0,103
Jens Pulver,2007-06-23,BJ Penn,Submission,0,0,0,0
Jens Pulver,2005-09-25,Hayato Sakurai,KO/TKO,0,0,0,0
Jens Pulver,2006-04-02,Kenji Arai,KO/TKO,100,6,0,106
Jens Pulver,2005-05-22,Tomomi Iwama,KO/TKO,100,2,0,102
JeongYeong Lee,2024-02-03,Blake Bilder,Decision - Unanimous,80,30,0,110
JeongYeong Lee,2022-06-10,Xie Bin,Submission,90,7,0,97
JeongYeong Lee,2023-02-04,Yizha,Decision - Split,70,1,0,71
JeongYeong Lee,2024-07-20,Hyder Amil,KO/TKO,0,0,0,0
JeongYeong Lee,2022-10-23,Lu Kai,KO/TKO,100,1,0,101
Blake Bilder,2024-02-03,JeongYeong Lee,Decision - Unanimous,0,0,0,0
Blake Bilder,2023-06-10,Kyle Nelson,Decision - Unanimous,0,0,0,0
Blake Bilder,2023-02-11,Shane Young,Decision - Unanimous,80,31,0,111
Blake Bilder,2022-08-30,Alexander Morgan,Submission,90,0,0,90
Akira Kikuchi,2007-02-17,Shinya Aoki,Decision - Split,0,49,0,49
Geoff Neal,2019-07-27,Niko Price,KO/TKO,100,17,0,117
Geoff Neal,2020-12-19,Stephen Thompson,Decision - Unanimous,0,0,25,25
Geoff Neal,2019-12-14,Mike Perry,KO/TKO,100,10,0,110
Geoff Neal,2022-08-06,Vicente Luque,KO/TKO,100,24,0,124
Geoff Neal,2017-07-25,Chase Waldon,KO/TKO,100,11,0,111
Geoff Neal,2024-02-17,Ian Machado Garry,Decision - Split,0,0,0,0
Geoff Neal,2018-09-08,Frank Camacho,KO/TKO,100,34,0,134
Geoff Neal,2018-02-18,Brian Camozzi,Submission,90,7,0,97
Geoff Neal,2021-12-11,Santiago Ponzinibbio,Decision - Split,70,0,0,70
Geoff Neal,2019-01-19,Belal Muhammad,Decision - Unanimous,80,8,0,88
Geoff Neal,2023-03-04,Shavkat Rakhmonov,Submission,0,0,0,0
Geoff Neal,2024-10-26,Rafael Dos Anjos,KO/TKO,100,14,0,114
Geoff Neal,2021-05-08,Neil Magny,Decision - Unanimous,0,0,0,0
Julian Erosa,2021-02-20,Nate Landwehr,KO/TKO,100,6,0,106
Julian Erosa,2023-04-29,Fernando Padilla,KO/TKO,0,0,0,0
Julian Erosa,2019-03-09,Grant Dawson,Decision - Unanimous,0,0,0,0
Julian Erosa,2021-06-19,SeungWoo Choi,KO/TKO,0,0,0,0
Julian Erosa,2024-07-13,Christian Rodriguez,Submission,90,2,0,92
Julian Erosa,2022-12-17,Alex Caceres,KO/TKO,0,0,0,0
Julian Erosa,2024-03-23,Ricardo Ramos,Submission,90,0,0,90
Julian Erosa,2020-06-27,Sean Woodson,Submission,90,0,0,90
Julian Erosa,2018-11-10,Devonte Smith,KO/TKO,0,0,0,0
Julian Erosa,2016-03-05,Teruto Ishihara,KO/TKO,0,0,0,0
Julian Erosa,2018-06-26,Jamall Emmers,KO/TKO,100,3,0,103
Julian Erosa,2021-09-04,Charles Jourdain,Submission,90,18,0,108
Julian Erosa,2022-02-05,Steven Peterson,Decision - Split,70,7,0,77
Julian Erosa,2015-12-11,Marcin Wrzosek,Decision - Split,70,9,0,79
Julian Erosa,2019-05-18,Julio Arce,KO/TKO,0,0,0,0
Julian Erosa,2022-09-10,Hakeem Dawodu,Decision - Unanimous,80,18,0,98
Justin Scoggins,2013-12-06,Richie Vaculik,KO/TKO,100,25,0,125
Justin Scoggins,2014-07-06,Dustin Ortiz,Decision - Split,0,0,0,0
Justin Scoggins,2017-06-17,Yuta Sasaki,Submission,0,16,0,16
Justin Scoggins,2014-09-05,John Moraga,Submission,0,9,0,9
Justin Scoggins,2018-07-14,Said Nurmagomedov,Decision - Split,0,0,0,0
Justin Scoggins,2015-05-23,Josh Sampo,Decision - Unanimous,80,29,0,109
Justin Scoggins,2016-02-06,Ray Borg,Decision - Unanimous,80,37,0,117
Justin Scoggins,2016-11-19,Pedro Munhoz,Submission,0,16,0,16
Justin Scoggins,2014-03-15,Will Campuzano,Decision - Unanimous,80,57,0,137
Jarred Brooks,2017-10-28,Deiveson Figueiredo,Decision - Split,0,11,0,11
Jarred Brooks,2018-09-08,Robert Sanchez,Decision - Split,70,8,0,78
Jarred Brooks,2018-06-01,Jose Torres,KO/TKO,0,9,0,9
Jarred Brooks,2017-07-29,Eric Shelton,Decision - Split,70,0,0,70
Luiz Cane,2011-03-19,Eliot Marshall,KO/TKO,100,27,0,127
Luiz Cane,2012-10-13,Chris Camozzi,Decision - Unanimous,0,0,0,0
Luiz Cane,2008-06-07,Jason Lambert,KO/TKO,100,7,0,107
Luiz Cane,2010-05-29,Cyrille Diabate,KO/TKO,0,0,0,0
Luiz Cane,2011-08-27,Stanislav Nedkov,KO/TKO,0,0,0,0
Luiz Cane,2008-10-18,Rameau Thierry Sokoudjou,KO/TKO,100,13,0,113
Luiz Cane,2007-12-29,James Irvin,DQ,0,4,0,4
Luiz Cane,2009-11-21,Rogerio Nogueira,KO/TKO,0,0,0,0
Luiz Cane,2009-04-18,Steve Cantwell,Decision - Unanimous,80,18,0,98
Eliot Marshall,2011-03-19,Luiz Cane,KO/TKO,0,0,0,0
Eliot Marshall,2009-09-19,Jason Brilz,Decision - Split,70,2,0,72
Eliot Marshall,2009-04-18,Vinny Magalhaes,Decision - Unanimous,80,10,0,90
Eliot Marshall,2008-12-13,Jules Bruchez,Submission,90,7,0,97
Eliot Marshall,2011-10-29,Brandon Vera,Decision - Unanimous,0,0,0,0
Eliot Marshall,2010-03-21,Vladimir Matyushenko,Decision - Split,0,0,0,0
James Bochnovic,2017-07-08,Trevin Giles,KO/TKO,0,0,0,0
James Bochnovic,2018-05-12,Markus Perez,Submission,0,0,0,0
Jimi Manuwa,2015-09-05,Anthony Johnson,KO/TKO,0,0,0,0
Jimi Manuwa,2013-10-26,Ryan Jimmo,KO/TKO,100,12,0,112
Jimi Manuwa,2015-04-11,Jan Blachowicz,Decision - Unanimous,80,0,0,80
Jimi Manuwa,2014-03-08,Alexander Gustafsson,KO/TKO,0,0,25,25
Jimi Manuwa,2018-03-17,Jan Blachowicz,Decision - Unanimous,0,0,0,0
Jimi Manuwa,2017-07-29,Volkan Oezdemir,KO/TKO,0,0,0,0
Jimi Manuwa,2016-10-08,Ovince Saint Preux,KO/TKO,100,19,0,119
Jimi Manuwa,2018-12-08,Thiago Santos,KO/TKO,0,0,0,0
Jimi Manuwa,2013-02-16,Cyrille Diabate,TKO - Doctor's Stoppage,0,9,0,9
Jimi Manuwa,2012-09-29,Kyle Kingsbury,TKO - Doctor's Stoppage,0,25,0,25
Jimi Manuwa,2019-06-01,Aleksandar Rakic,KO/TKO,0,0,0,0
Jimi Manuwa,2017-03-18,Corey Anderson,KO/TKO,100,0,0,100
Jean Silva,2023-09-05,Kevin Vallejos,Decision - Unanimous,80,16,0,96
Jean Silva,2024-07-13,Drew Dober,TKO - Doctor's Stoppage,0,0,0,0
Jean Silva,2024-06-29,Charles Jourdain,KO/TKO,100,11,0,111
Jean Silva,2005-07-17,Takanori Gomi,Decision - Unanimous,0,0,0,0
Jean Silva,2024-01-13,Westin Wilson,KO/TKO,100,14,0,114
Kevin Vallejos,2023-09-05,Jean Silva,Decision - Unanimous,0,0,0,0
Kevin Vallejos,2024-09-24,Cam Teague,KO/TKO,100,34,0,134
Daichi Abe,2017-09-22,Hyun Gyu Lim,Decision - Unanimous,80,20,0,100
Daichi Abe,2018-06-23,Li Jingliang,Decision - Unanimous,0,0,0,0
Daichi Abe,2018-02-10,Luke Jumeau,Decision - Unanimous,0,0,0,0
Hyun Gyu Lim,2017-09-22,Daichi Abe,Decision - Unanimous,0,0,0,0
Hyun Gyu Lim,2014-09-20,Takenori Sato,KO/TKO,100,9,0,109
Hyun Gyu Lim,2016-08-20,Mike Perry,KO/TKO,0,0,0,0
Hyun Gyu Lim,2013-03-02,Marcelo Guimaraes,KO/TKO,100,15,0,115
Hyun Gyu Lim,2013-08-31,Pascal Krauss,KO/TKO,100,5,0,105
Hyun Gyu Lim,2014-01-04,Tarec Saffiedine,Decision - Unanimous,0,2,25,27
Hyun Gyu Lim,2015-05-16,Neil Magny,KO/TKO,0,0,0,0
Corey Anderson,2018-07-22,Glover Teixeira,Decision - Unanimous,80,28,0,108
Corey Anderson,2019-11-02,Johnny Walker,KO/TKO,100,21,0,121
Corey Anderson,2018-04-21,Patrick Cummins,Decision - Unanimous,80,33,0,113
Corey Anderson,2018-12-29,Ilir Latifi,Decision - Unanimous,80,7,0,87
Corey Anderson,2016-05-14,Mauricio Rua,Decision - Split,0,7,0,7
Corey Anderson,2014-07-06,Matt Van Buren,KO/TKO,100,22,0,122
Corey Anderson,2020-02-15,Jan Blachowicz,KO/TKO,0,0,25,25
Corey Anderson,2015-09-05,Jan Blachowicz,Decision - Unanimous,80,64,0,144
Corey Anderson,2015-04-18,Gian Villante,KO/TKO,0,41,0,41
Corey Anderson,2014-12-06,Justin Jones,Decision - Unanimous,80,17,0,97
Corey Anderson,2017-11-04,Ovince Saint Preux,KO/TKO,0,7,0,7
Corey Anderson,2016-12-09,Sean O'Connell,KO/TKO,100,57,0,157
Corey Anderson,2016-03-05,Tom Lawlor,Decision - Unanimous,80,24,0,104
Corey Anderson,2015-11-07,Fabio Maldonado,Decision - Unanimous,80,34,0,114
Corey Anderson,2017-03-18,Jimi Manuwa,KO/TKO,0,0,0,0
Hakeem Dawodu,2018-12-08,Kyle Bochniak,Decision - Split,70,61,0,131
Hakeem Dawodu,2019-11-02,Julio Arce,Decision - Split,70,23,0,93
Hakeem Dawodu,2021-06-12,Movsar Evloev,Decision - Unanimous,0,0,0,0
Hakeem Dawodu,2022-02-05,Michael Trizano,Decision - Unanimous,80,71,0,151
Hakeem Dawodu,2020-09-26,Zubaira Tukhugov,Decision - Split,70,34,0,104
Hakeem Dawodu,2023-08-12,Cub Swanson,Decision - Unanimous,0,18,0,18
Hakeem Dawodu,2018-07-28,Austin Arnett,Decision - Unanimous,80,52,0,132
Hakeem Dawodu,2019-07-27,Yoshinori Horie,KO/TKO,100,41,0,141
Hakeem Dawodu,2022-09-10,Julian Erosa,Decision - Unanimous,0,0,0,0
Hakeem Dawodu,2018-03-17,Danny Henry,Submission,0,1,0,1
Eryk Anders,2019-04-13,Khalil Rountree Jr.,Decision - Unanimous,0,0,0,0
Eryk Anders,2022-12-03,Kyle Daukaus,KO/TKO,100,12,0,112
Eryk Anders,2017-12-09,Markus Perez,Decision - Unanimous,80,49,0,129
Eryk Anders,2019-06-29,Vinicius Moreira,KO/TKO,100,9,0,109
Eryk Anders,2021-06-12,Darren Stewart,Decision - Unanimous,80,11,0,91
Eryk Anders,2019-10-12,Gerald Meerschaert,Decision - Split,70,0,0,70
Eryk Anders,2020-05-16,Krzysztof Jotko,Decision - Unanimous,0,0,0,0
Eryk Anders,2017-07-22,Rafael Natal,KO/TKO,100,9,0,109
Eryk Anders,2018-12-08,Elias Theodorou,Decision - Split,0,0,0,0
Eryk Anders,2018-09-22,Thiago Santos,KO/TKO,0,0,25,25
Eryk Anders,2023-06-10,Marc-Andre Barriault,Decision - Unanimous,0,0,0,0
Eryk Anders,2022-05-21,JunYong Park,Decision - Split,0,0,0,0
Eryk Anders,2018-02-03,Lyoto Machida,Decision - Split,0,0,25,25
Eryk Anders,2018-08-25,Tim Williams,KO/TKO,100,0,0,100
Eryk Anders,2024-03-02,Jamie Pickett,Decision - Unanimous,80,3,0,83
Eryk Anders,2021-12-11,Andre Muniz,Submission,0,0,0,0
Eryk Anders,2024-12-07,Chris Weidman,KO/TKO,100,46,0,146
Billy Evangelista,2011-03-05,Jorge Masvidal,Decision - Unanimous,0,0,0,0
Billy Evangelista,2008-06-27,Nam Phan,Decision - Split,70,0,0,70
Billy Evangelista,2007-09-29,Clint Coronel,Decision - Split,70,10,0,80
Billy Evangelista,2011-12-17,KJ Noons,Decision - Unanimous,0,7,0,7
Billy Evangelista,2008-10-03,Luke Caudillo,Decision - Unanimous,80,51,0,131
Rousimar Palhares,2013-10-09,Mike Pierce,Submission,90,0,0,90
Rousimar Palhares,2009-01-17,Jeremy Horn,Decision - Unanimous,80,11,0,91
Rousimar Palhares,2012-01-14,Mike Massenzio,Submission,90,4,0,94
Rousimar Palhares,2007-08-04,Flavio Luiz Moura,Submission,90,0,0,90
Rousimar Palhares,2009-12-12,Lucio Linhares,Submission,90,0,0,90
Rousimar Palhares,2008-09-06,Dan Henderson,Decision - Unanimous,0,0,0,0
Rousimar Palhares,2007-12-06,Daniel Acacio,Submission,90,6,0,96
Rousimar Palhares,2010-03-27,Tomasz Drwal,Submission,90,0,0,90
Rousimar Palhares,2012-05-05,Alan Belcher,KO/TKO,0,0,0,0
Rousimar Palhares,2012-12-14,Hector Lombard,KO/TKO,0,0,0,0
Rousimar Palhares,2010-09-15,Nate Marquardt,KO/TKO,0,0,0,0
Rousimar Palhares,2007-03-10,Helio Dipp,Submission,90,2,0,92
Rousimar Palhares,2006-11-25,Claudio Mattos,Submission,90,1,0,91
Rousimar Palhares,2011-03-03,David Branch,Submission,90,0,0,90
Rousimar Palhares,2007-12-06,Fabio Nascimento,Submission,90,2,0,92
Rousimar Palhares,2011-08-27,Dan Miller,Decision - Unanimous,80,25,0,105
Rousimar Palhares,2008-05-24,Ivan Salaverry,Submission,90,0,0,90
Mike Pierce,2013-10-09,Rousimar Palhares,Submission,0,2,0,2
Mike Pierce,2012-12-14,Seth Baczynski,Decision - Unanimous,80,0,0,80
Mike Pierce,2012-02-04,Josh Koscheck,Decision - Split,0,8,0,8
Mike Pierce,2009-12-12,Jon Fitch,Decision - Unanimous,0,0,0,0
Mike Pierce,2013-07-06,David Mitchell,KO/TKO,100,0,0,100
Mike Pierce,2010-03-21,Julio Paulino,Decision - Unanimous,80,22,0,102
Mike Pierce,2010-08-28,Amilcar Alves,Submission,90,27,0,117
Mike Pierce,2011-08-06,Johny Hendricks,Decision - Split,0,0,0,0
Mike Pierce,2011-02-05,Kenny Robertson,KO/TKO,100,7,0,107
Mike Pierce,2015-12-11,Ryan LaFlare,Decision - Unanimous,0,0,0,0
Mike Pierce,2011-11-12,Paul Bradley,Decision - Split,70,12,0,82
Mike Pierce,2012-10-05,Aaron Simpson,KO/TKO,100,0,0,100
Mike Pierce,2009-03-01,Justin Haskins,KO/TKO,100,15,0,115
Mike Pierce,2012-06-08,Carlos Eduardo Rocha,Decision - Unanimous,80,15,0,95
Mike Pierce,2009-09-16,Brock Larson,Decision - Unanimous,80,16,0,96
Kevin Jackson,1997-12-21,Frank Shamrock,Submission,0,1,0,1
Kevin Jackson,1997-07-27,Todd Butler,KO/TKO,100,2,0,102
Kevin Jackson,1998-03-13,Jerry Bohlander,Submission,0,13,0,13
Kevin Jackson,1997-07-27,Tony Fryklund,Submission,90,2,0,92
Lyle Beerbohm,2008-02-23,Ray Perales,Submission,90,25,0,115
Lyle Beerbohm,2010-05-15,Vitor Ribeiro,Decision - Split,70,19,0,89
Lyle Beerbohm,2011-04-09,Shinya Aoki,Submission,0,0,0,0
Lyle Beerbohm,2011-02-18,Pat Healy,Decision - Unanimous,0,0,0,0
Ray Perales,2008-02-23,Lyle Beerbohm,Submission,0,0,0,0
Chelsea Chandler,2024-08-10,Yana Santos,Decision - Unanimous,0,0,0,0
Chelsea Chandler,2022-10-01,Julija Stoliarenko,KO/TKO,100,26,0,126
Chelsea Chandler,2023-07-15,Norma Dumont,Decision - Unanimous,0,0,0,0
Chelsea Chandler,2024-03-16,Josiane Nunes,Decision - Unanimous,80,11,0,91
Robert Peralta,2012-09-29,Jason Young,KO/TKO,100,5,0,105
Robert Peralta,2014-05-31,Rony Jason,Decision - Split,70,21,0,91
Robert Peralta,2011-04-09,Hiroyuki Takaya,Decision - Split,70,36,0,106
Robert Peralta,2014-08-16,Thiago Tavares,Submission,0,0,0,0
Robert Peralta,2013-04-06,Akira Corassani,Decision - Unanimous,0,19,0,19
Robert Peralta,2013-12-28,Estevan Payan,KO/TKO,100,2,0,102
Robert Peralta,2011-09-17,Mike Lullo,Decision - Unanimous,80,29,0,109
Robert Peralta,2015-04-04,Clay Guida,Decision - Unanimous,0,0,0,0
Jason Young,2012-09-29,Robert Peralta,KO/TKO,0,0,0,0
Jason Young,2011-06-11,Dustin Poirier,Decision - Unanimous,0,0,0,0
Jason Young,2011-11-05,Michihiro Omigawa,Decision - Unanimous,0,7,0,7
Jason Young,2012-04-14,Eric Wisely,Decision - Unanimous,80,8,0,88
Matt Dixon,2020-08-18,Orion Cosce,KO/TKO,0,0,0,0
Todd Butler,1997-07-27,Kevin Jackson,KO/TKO,0,0,0,0
Mitch Clarke,2011-12-10,John Cholish,KO/TKO,0,0,0,0
Mitch Clarke,2016-07-07,Joe Duffy,Submission,0,0,0,0
Mitch Clarke,2012-07-21,Anton Kuivanen,Decision - Split,0,0,0,0
Mitch Clarke,2015-04-04,Michael Chiesa,Decision - Unanimous,0,6,0,6
Mitch Clarke,2013-06-15,John Maguire,Decision - Unanimous,80,26,0,106
Mitch Clarke,2014-05-24,Al Iaquinta,Submission,90,0,0,90
Mitch Clarke,2017-09-09,Alex White,KO/TKO,0,0,0,0
Jutaro Nakao,2004-10-30,Shinya Aoki,KO/TKO,100,1,0,101
Jutaro Nakao,2005-07-17,Marcus Aurelio,Decision - Unanimous,0,0,0,0
Jutaro Nakao,2002-03-22,Sean Sherk,Decision - Unanimous,0,0,0,0
Jutaro Nakao,2001-09-28,Tony DeSouza,KO/TKO,100,7,0,107
Tom Duquesnoy,2017-10-07,Cody Stamann,Decision - Split,0,0,0,0
Tom Duquesnoy,2018-03-17,Terrion Ware,Decision - Unanimous,80,0,0,80
Tom Duquesnoy,2017-04-15,Patrick Williams,KO/TKO,100,0,0,100
Cat Zingano,2015-02-28,Ronda Rousey,Submission,0,0,25,25
Cat Zingano,2014-09-27,Amanda Nunes,KO/TKO,100,18,0,118
Cat Zingano,2018-12-29,Megan Anderson,KO/TKO,0,0,0,0
Cat Zingano,2016-07-09,Julianna Pena,Decision - Unanimous,0,0,0,0
Cat Zingano,2018-07-14,Marion Reneau,Decision - Unanimous,80,19,0,99
Cat Zingano,2013-04-13,Miesha Tate,KO/TKO,100,12,0,112
Cat Zingano,2018-03-03,Ketlen Vieira,Decision - Split,0,18,0,18
Mariya Agapova,2024-07-13,Luana Santos,Submission,0,1,0,1
Mariya Agapova,2022-09-17,Gillian Robertson,Submission,0,35,0,35
Mariya Agapova,2022-03-05,Maryna Moroz,Submission,0,0,0,0
Mariya Agapova,2020-06-13,Hannah Cifers,Submission,90,18,0,108
Mariya Agapova,2021-10-09,Sabina Mazo,Submission,90,31,0,121
Mariya Agapova,2020-08-22,Shana Dobson,KO/TKO,0,0,0,0
Mariya Agapova,2019-07-30,Tracy Cortez,Decision - Unanimous,0,0,0,0
Cody Brundage,2022-12-17,Michal Oleksiejczuk,KO/TKO,0,0,0,0
Cody Brundage,2021-09-25,Nick Maximov,Decision - Unanimous,0,14,0,14
Cody Brundage,2022-03-12,Dalcha Lungiambula,Submission,90,0,0,90
Cody Brundage,2023-06-24,Sedriques Dumas,Decision - Unanimous,0,0,0,0
Cody Brundage,2023-04-29,Rodolfo Vieira,Submission,0,10,0,10
Cody Brundage,2023-09-23,Jacob Malkoun,DQ,0,0,0,0
Cody Brundage,2024-04-13,Bo Nickal,Submission,0,0,0,0
Cody Brundage,2022-07-09,Tresean Gore,KO/TKO,100,7,0,107
Cody Brundage,2020-09-01,William Knight,KO/TKO,0,4,0,4
Cody Brundage,2023-12-02,Zachary Reese,KO/TKO,100,5,0,105
Gunnar Nelson,2019-03-16,Leon Edwards,Decision - Split,0,0,0,0
Gunnar Nelson,2012-09-29,DaMarques Johnson,Submission,90,8,0,98
Gunnar Nelson,2014-10-04,Rick Story,Decision - Split,0,0,25,25
Gunnar Nelson,2022-03-19,Takashi Sato,Decision - Unanimous,80,35,0,115
Gunnar Nelson,2014-07-19,Zak Cummings,Submission,90,0,0,90
Gunnar Nelson,2015-12-12,Demian Maia,Decision - Unanimous,0,0,0,0
Gunnar Nelson,2017-07-16,Santiago Ponzinibbio,KO/TKO,0,0,25,25
Gunnar Nelson,2017-03-18,Alan Jouban,Submission,90,0,0,90
Gunnar Nelson,2013-02-16,Jorge Santiago,Decision - Unanimous,80,0,0,80
Gunnar Nelson,2019-09-28,Gilbert Burns,Decision - Unanimous,0,0,0,0
Gunnar Nelson,2015-07-11,Brandon Thatch,Submission,90,0,0,90
Gunnar Nelson,2018-12-08,Alex Oliveira,Submission,90,0,0,90
Gunnar Nelson,2014-03-08,Omari Akhmedov,Submission,90,10,0,100
Gunnar Nelson,2016-05-08,Albert Tumenov,Submission,90,6,0,96
Gunnar Nelson,2023-03-18,Bryan Barberena,Submission,90,3,0,93
Roosevelt Roberts,2024-09-28,Ludovit Klein,Decision - Unanimous,0,0,0,0
Roosevelt Roberts,2018-11-30,Darrell Horcher,Submission,90,6,0,96
Roosevelt Roberts,2019-11-09,Alexander Yakovlev,Decision - Unanimous,80,8,0,88
Roosevelt Roberts,2020-06-20,Jim Miller,Submission,0,0,0,0
Roosevelt Roberts,2021-08-21,Ignacio Bahamondes,KO/TKO,0,0,0,0
Roosevelt Roberts,2019-04-27,Thomas Gifford,Decision - Unanimous,80,23,0,103
Roosevelt Roberts,2023-11-11,Mateusz Rebecki,Submission,0,0,0,0
Roosevelt Roberts,2019-06-29,Vinc Pichel,Decision - Unanimous,0,0,0,0
Roosevelt Roberts,2018-07-31,Garrett Gross,Submission,90,22,0,112
Roosevelt Roberts,2020-05-30,Brok Weaver,Submission,90,26,0,116
Ramon Taveras,2023-10-10,Cortavious Romious,KO/TKO,100,3,0,103
Ramon Taveras,2024-12-14,Davey Grant,Decision - Unanimous,0,0,0,0
Ramon Taveras,2024-01-20,Serhiy Sidey,Decision - Split,70,0,0,70
Ramon Taveras,2023-09-05,Serhiy Sidey,KO/TKO,0,0,0,0
Alvaro Herrera Mendoza,2017-08-05,Jordan Rinaldi,Submission,0,0,0,0
Alvaro Herrera Mendoza,2016-07-07,Vicente Luque,Submission,0,0,0,0
Alvaro Herrera Mendoza,2018-07-28,Devin Powell,KO/TKO,0,0,0,0
Alvaro Herrera Mendoza,2015-11-21,Vernon Ramos Ho,KO/TKO,100,2,0,102
Scott Askham,2015-06-20,Antonio Dos Santos,KO/TKO,100,0,0,100
Scott Askham,2016-09-03,Jack Hermansson,Decision - Unanimous,0,0,0,0
Scott Askham,2017-03-18,Brad Scott,Decision - Split,0,14,0,14
Scott Askham,2016-02-27,Chris Dempsey,KO/TKO,100,1,0,101
Scott Askham,2014-10-04,Magnus Cedenblad,Decision - Unanimous,0,19,0,19
Scott Askham,2015-10-24,Krzysztof Jotko,Decision - Split,0,0,0,0
Antonio Dos Santos,2015-06-20,Scott Askham,KO/TKO,0,0,0,0
Antonio Dos Santos,2014-12-20,Daniel Sarafian,KO/TKO,0,13,0,13
Jason Knight,2017-07-29,Ricardo Lamas,KO/TKO,0,0,0,0
Jason Knight,2015-12-11,Tatsuya Kawajiri,Decision - Unanimous,0,0,0,0
Jason Knight,2017-05-13,Chas Skelly,KO/TKO,100,30,0,130
Jason Knight,2018-11-03,Jordan Rinaldi,Decision - Unanimous,0,0,0,0
Jason Knight,2018-05-27,Makwan Amirkhani,Decision - Split,0,2,0,2
Jason Knight,2016-11-26,Dan Hooker,Decision - Unanimous,80,12,0,92
Jason Knight,2016-07-23,Jim Alers,Decision - Split,70,35,0,105
Jason Knight,2017-01-28,Alex Caceres,Submission,90,4,0,94
Jason Knight,2017-12-09,Gabriel Benitez,Decision - Unanimous,0,0,0,0
Claudio Ribeiro,2022-08-16,Ivan Valenzuela,KO/TKO,100,4,0,104
Claudio Ribeiro,2023-05-06,Joseph Holmes,KO/TKO,100,20,0,120
Claudio Ribeiro,2023-01-14,Abdul Razak Alhassan,KO/TKO,0,2,0,2
Claudio Ribeiro,2023-07-29,Roman Kopylov,KO/TKO,0,0,0,0
Claudio Ribeiro,2024-03-02,Christian Leroy Duncan,KO/TKO,0,0,0,0
Ivan Valenzuela,2022-08-16,Claudio Ribeiro,KO/TKO,0,0,0,0
Andrew Craig,2013-01-19,Ronny Markes,Decision - Unanimous,0,15,0,15
Andrew Craig,2015-07-15,Lyman Good,KO/TKO,0,0,0,0
Andrew Craig,2012-03-02,Kyle Noke,Decision - Unanimous,80,0,0,80
Andrew Craig,2013-07-06,Chris Leben,Decision - Split,70,34,0,104
Andrew Craig,2013-10-26,Luke Barnatt,Submission,0,0,0,0
Andrew Craig,2014-06-28,Cezar Ferreira,Decision - Unanimous,0,0,0,0
Andrew Craig,2012-07-11,Rafael Natal,KO/TKO,100,0,0,100
Muslim Salikhov,2024-07-13,Santiago Ponzinibbio,Decision - Split,70,5,0,75
Muslim Salikhov,2022-07-16,Li Jingliang,KO/TKO,0,0,0,0
Muslim Salikhov,2020-07-11,Elizeu Zaleski dos Santos,Decision - Split,70,0,0,70
Muslim Salikhov,2022-11-19,Andre Fialho,KO/TKO,100,39,0,139
Muslim Salikhov,2024-11-23,Song Kenan,KO/TKO,100,11,0,111
Muslim Salikhov,2024-02-03,Randy Brown,KO/TKO,0,0,0,0
Muslim Salikhov,2017-11-25,Alex Garcia,Submission,0,4,0,4
Muslim Salikhov,2019-10-26,Laureano Staropoli,Decision - Unanimous,80,21,0,101
Muslim Salikhov,2023-06-17,Nicolas Dalby,Decision - Unanimous,0,0,0,0
Muslim Salikhov,2019-09-07,Nordine Taleb,KO/TKO,100,4,0,104
Muslim Salikhov,2021-06-05,Francisco Trinaldo,Decision - Unanimous,80,23,0,103
Muslim Salikhov,2018-04-14,Ricky Rainey,KO/TKO,100,6,0,106
Santiago Ponzinibbio,2024-07-13,Muslim Salikhov,Decision - Split,0,0,0,0
Santiago Ponzinibbio,2021-01-16,Li Jingliang,KO/TKO,0,0,0,0
Santiago Ponzinibbio,2015-06-27,Lorenz Larkin,KO/TKO,0,0,0,0
Santiago Ponzinibbio,2017-07-16,Gunnar Nelson,KO/TKO,100,2,25,127
Santiago Ponzinibbio,2015-02-22,Sean Strickland,Decision - Unanimous,80,6,0,86
Santiago Ponzinibbio,2018-11-17,Neil Magny,KO/TKO,100,7,25,132
Santiago Ponzinibbio,2016-08-06,Zak Cummings,Decision - Unanimous,80,23,0,103
Santiago Ponzinibbio,2022-05-21,Michel Pereira,Decision - Split,0,0,0,0
Santiago Ponzinibbio,2021-06-05,Miguel Baeza,Decision - Unanimous,80,17,0,97
Santiago Ponzinibbio,2013-11-09,Ryan LaFlare,Decision - Unanimous,0,0,0,0
Santiago Ponzinibbio,2015-12-10,Andreas Stahl,KO/TKO,100,34,0,134
Santiago Ponzinibbio,2023-04-08,Kevin Holland,KO/TKO,0,0,0,0
Santiago Ponzinibbio,2021-12-11,Geoff Neal,Decision - Split,0,6,0,6
Santiago Ponzinibbio,2017-02-19,Nordine Taleb,Decision - Unanimous,80,5,0,85
Santiago Ponzinibbio,2022-12-10,Alex Morono,KO/TKO,100,28,0,128
Santiago Ponzinibbio,2017-12-16,Mike Perry,Decision - Unanimous,80,27,0,107
Santiago Ponzinibbio,2016-04-16,Court McGee,KO/TKO,100,3,0,103
Santiago Ponzinibbio,2014-09-13,Wendell Oliveira Marques,KO/TKO,100,2,0,102
Ode Osbourne,2019-07-16,Armando Villarreal,Submission,90,5,0,95
Ode Osbourne,2022-06-04,Zarrukh Adashev,KO/TKO,100,0,0,100
Ode Osbourne,2021-08-07,Manel Kape,KO/TKO,0,0,0,0
Ode Osbourne,2021-11-06,CJ Vergara,Decision - Unanimous,80,0,0,80
Ode Osbourne,2024-09-14,Ronaldo Rodriguez,Decision - Unanimous,0,2,0,2
Ode Osbourne,2023-08-05,Asu Almabayev,Submission,0,0,0,0
Ode Osbourne,2023-02-25,Charles Johnson,Decision - Split,70,0,0,70
Ode Osbourne,2020-01-18,Brian Kelleher,Submission,0,2,0,2
Ode Osbourne,2024-03-16,Jafel Filho,Submission,0,0,0,0
Ode Osbourne,2021-02-06,Jerome Rivera,KO/TKO,100,3,0,103
Ode Osbourne,2022-08-13,Tyson Nam,KO/TKO,0,2,0,2
Armando Villarreal,2019-07-16,Ode Osbourne,Submission,0,0,0,0
Polyana Viana,2024-01-20,Gillian Robertson,KO/TKO,0,0,0,0
Polyana Viana,2018-08-04,JJ Aldrich,Decision - Unanimous,0,6,0,6
Polyana Viana,2023-08-12,Iasmin Lucindo,Submission,0,0,0,0
Polyana Viana,2018-02-03,Maia Stevenson,Submission,90,6,0,96
Polyana Viana,2022-05-21,Tabatha Ricci,Decision - Unanimous,0,3,0,3
Polyana Viana,2022-11-05,Jinh Yu Frey,KO/TKO,100,5,0,105
Polyana Viana,2019-08-10,Veronica Hardy,Submission,0,0,0,0
Polyana Viana,2021-02-13,Mallory Martin,Submission,90,0,0,90
Polyana Viana,2020-08-29,Emily Whitmire,Submission,90,7,0,97
Polyana Viana,2019-03-02,Hannah Cifers,Decision - Split,0,10,0,10
Nassourdine Imavov,2021-07-24,Ian Heinisch,KO/TKO,100,15,0,115
Nassourdine Imavov,2023-01-14,Sean Strickland,Decision - Unanimous,0,0,25,25
Nassourdine Imavov,2024-02-03,Roman Dolidze,Decision - Majority,75,78,25,178
Nassourdine Imavov,2024-09-28,Brendan Allen,Decision - Unanimous,80,27,0,107
Nassourdine Imavov,2022-09-03,Joaquin Buckley,Decision - Unanimous,80,5,0,85
Nassourdine Imavov,2020-10-03,Jordan Williams,Decision - Unanimous,80,38,0,118
Nassourdine Imavov,2021-11-06,Edmen Shahbazyan,KO/TKO,100,20,0,120
Nassourdine Imavov,2021-02-20,Phil Hawes,Decision - Majority,0,26,0,26
Nassourdine Imavov,2024-06-08,Jared Cannonier,KO/TKO,100,18,25,143
Ian Heinisch,2021-07-24,Nassourdine Imavov,KO/TKO,0,0,0,0
Ian Heinisch,2019-12-14,Omari Akhmedov,Decision - Unanimous,0,0,0,0
Ian Heinisch,2018-07-31,Justin Sumter,KO/TKO,100,5,0,105
Ian Heinisch,2019-05-18,Antonio Carlos Junior,Decision - Unanimous,80,24,0,104
Ian Heinisch,2020-06-06,Gerald Meerschaert,KO/TKO,100,17,0,117
Ian Heinisch,2018-11-17,Cezar Ferreira,Decision - Unanimous,80,29,0,109
Ian Heinisch,2019-08-17,Derek Brunson,Decision - Unanimous,0,0,0,0
Ian Heinisch,2021-02-13,Kelvin Gastelum,Decision - Unanimous,0,0,0,0
Shauna Bannon,2024-07-27,Alice Ardelean,Decision - Split,70,20,0,90
Shauna Bannon,2023-07-22,Bruna Brasil,Decision - Unanimous,0,0,0,0
Alice Ardelean,2024-07-27,Shauna Bannon,Decision - Split,0,0,0,0
Alice Ardelean,2024-10-19,Melissa Martinez,Decision - Unanimous,0,20,0,20
Shohei Nose,2022-10-23,Rinya Nakamura,KO/TKO,0,0,0,0
Shohei Nose,2022-06-10,Wulijiburen,KO/TKO,100,5,0,105
Shohei Nose,2023-05-28,Xiao Long,Decision - Split,0,0,0,0
Shohei Nose,2024-05-19,SuYoung You,Decision - Unanimous,0,0,0,0
Tony Kelley,2020-10-10,Ali AlQaisi,Decision - Unanimous,80,0,0,80
Tony Kelley,2021-12-11,Randy Costa,KO/TKO,100,51,0,151
Tony Kelley,2020-08-15,Kai Kamaka,Decision - Unanimous,0,0,0,0
Tony Kelley,2022-06-18,Adrian Yanez,KO/TKO,0,0,0,0
Ali AlQaisi,2020-10-10,Tony Kelley,Decision - Unanimous,0,6,0,6
Ali AlQaisi,2020-08-08,Irwin Rivera,Decision - Split,0,8,0,8
Cory Peterson,2004-02-01,Sergei Kharitonov,Submission,0,0,0,0
Elise Reed,2023-06-03,Jinh Yu Frey,Decision - Unanimous,80,25,0,105
Elise Reed,2021-07-24,Sijara Eubanks,KO/TKO,0,0,0,0
Elise Reed,2022-05-21,Sam Hughes,KO/TKO,0,0,0,0
Elise Reed,2022-09-10,Melissa Martinez,Decision - Unanimous,80,0,0,80
Elise Reed,2023-09-16,Loopy Godinez,Submission,0,0,0,0
Elise Reed,2022-03-19,Cory McKenna,Decision - Split,70,16,0,86
Elise Reed,2024-10-19,Jessica Penne,Decision - Unanimous,80,63,0,143
Elise Reed,2023-02-11,Loma Lookboonmee,Submission,0,0,0,0
Jinh Yu Frey,2023-06-03,Elise Reed,Decision - Unanimous,0,0,0,0
Jinh Yu Frey,2021-07-31,Ashley Yoder,Decision - Unanimous,80,0,0,80
Jinh Yu Frey,2021-03-13,Gloria de Paula,Decision - Unanimous,80,0,0,80
Jinh Yu Frey,2020-10-03,Loma Lookboonmee,Decision - Unanimous,0,0,0,0
Jinh Yu Frey,2022-11-05,Polyana Viana,KO/TKO,0,0,0,0
Jinh Yu Frey,2022-06-25,Vanessa Demopoulos,Decision - Split,0,0,0,0
Jinh Yu Frey,2020-06-27,Kay Hansen,Submission,0,0,0,0
Jinh Yu Frey,2023-10-21,Viktoriia Dudakova,Decision - Unanimous,0,0,0,0
Zarrukh Adashev,2020-06-13,Tyson Nam,KO/TKO,0,0,0,0
Zarrukh Adashev,2021-01-20,Sumudaerji,Decision - Unanimous,0,0,0,0
Zarrukh Adashev,2022-06-04,Ode Osbourne,KO/TKO,0,0,0,0
Zarrukh Adashev,2021-07-31,Ryan Benoit,Decision - Unanimous,80,41,0,121
Thiago Moises,2023-09-02,Benoit Saint Denis,KO/TKO,0,0,0,0
Thiago Moises,2018-08-12,Gleidson Cutis,KO/TKO,100,23,0,123
Thiago Moises,2023-01-21,Melquizael Costa,Submission,90,0,0,90
Thiago Moises,2020-05-13,Michael Johnson,Submission,90,0,0,90
Thiago Moises,2021-07-17,Islam Makhachev,Submission,0,0,25,25
Thiago Moises,2020-10-31,Bobby Green,Decision - Unanimous,80,0,0,80
Thiago Moises,2024-03-16,Mitch Ramirez,KO/TKO,100,9,0,109
Thiago Moises,2021-02-27,Alexander Hernandez,Decision - Unanimous,80,3,0,83
Thiago Moises,2024-06-08,Ludovit Klein,Decision - Unanimous,0,0,0,0
Thiago Moises,2018-11-10,Beneil Dariush,Decision - Unanimous,0,0,0,0
Thiago Moises,2019-08-31,Damir Ismagulov,Decision - Unanimous,0,0,0,0
Thiago Moises,2022-06-25,Christos Giagos,Submission,90,1,0,91
Thiago Moises,2021-11-13,Joel Alvarez,KO/TKO,0,0,0,0
Thiago Moises,2019-05-11,Kurt Holobaugh,Decision - Unanimous,80,27,0,107
Jamal Pogues,2024-02-03,Thomas Petersen,Decision - Unanimous,80,7,0,87
Jamal Pogues,2022-08-09,Paulo Renato Junior,Decision - Unanimous,80,0,0,80
Jamal Pogues,2019-08-20,Marcos Brigagao,Decision - Unanimous,80,3,0,83
Jamal Pogues,2023-07-22,Mick Parkin,Decision - Unanimous,0,0,0,0
Jamal Pogues,2023-02-18,Josh Parisian,Decision - Unanimous,80,0,0,80
Thomas Petersen,2024-02-03,Jamal Pogues,Decision - Unanimous,0,0,0,0
Thomas Petersen,2023-08-29,Chandler Cole,Submission,90,7,0,97
Thomas Petersen,2024-07-20,Mohammed Usman,Decision - Unanimous,80,13,0,93
Andre Pederneiras,1999-07-16,Pat Miletich,TKO - Doctor's Stoppage,0,0,25,25
Juan Puerta,2021-11-02,Shang Zhifa,Decision - Split,70,0,0,70
Shang Zhifa,2021-11-02,Juan Puerta,Decision - Split,0,0,0,0
Ramiro Hernandez,2014-01-25,Hugo Viana,Decision - Unanimous,0,0,0,0
Ramiro Hernandez,2013-09-04,Lucas Martins,Submission,0,0,0,0
Denis Kang,2005-07-17,Andrei Semenov,Decision - Unanimous,80,12,0,92
Denis Kang,2012-12-31,Melvin Manhoef,KO/TKO,0,0,0,0
Denis Kang,2007-10-28,Yoshihiro Akiyama,KO/TKO,0,6,0,6
Denis Kang,2006-11-05,Kazuo Misaki,Decision - Split,0,1,0,1
Denis Kang,2009-11-14,Michael Bisping,KO/TKO,0,0,0,0
Denis Kang,2005-04-03,Takahiro Oba,Submission,90,7,0,97
Denis Kang,2006-11-05,Akihiro Gono,Decision - Unanimous,80,3,0,83
Denis Kang,2006-08-27,Amar Suloev,Submission,90,9,0,99
Denis Kang,2006-06-04,Murilo Rua,KO/TKO,100,9,0,109
Denis Kang,2006-04-02,Mark Weir,KO/TKO,100,17,0,117
Denis Kang,2009-01-17,Alan Belcher,Submission,0,17,0,17
Denis Kang,2008-04-29,Gegard Mousasi,Submission,0,0,0,0
Denis Kang,2009-04-18,Xavier Foupa-Pokam,Decision - Unanimous,80,8,0,88
Andrei Semenov,2005-07-17,Denis Kang,Decision - Unanimous,0,0,0,0
Andrei Semenov,2002-05-10,Ivan Salaverry,KO/TKO,0,0,0,0
Andrei Semenov,2002-01-11,Ricardo Almeida,KO/TKO,100,0,0,100
Ronald Jhun,2006-12-08,Eugene Jackson,Submission,0,0,25,25
Ronald Jhun,2004-08-21,Chris Lytle,Submission,0,0,0,0
Matthew Lopez,2016-07-13,Rani Yahya,Submission,0,0,0,0
Matthew Lopez,2018-04-14,Alejandro Perez,KO/TKO,0,0,0,0
Matthew Lopez,2016-12-10,Mitch Gagnon,Decision - Unanimous,80,0,0,80
Matthew Lopez,2018-12-08,Brad Katona,Decision - Unanimous,0,0,0,0
Matthew Lopez,2017-06-03,Johnny Eduardo,KO/TKO,100,27,0,127
Matthew Lopez,2017-11-11,Raphael Assuncao,KO/TKO,0,0,0,0
Enrique Barzola,2016-08-27,Kyle Bochniak,Decision - Split,0,14,0,14
Enrique Barzola,2019-10-26,Movsar Evloev,Decision - Unanimous,0,7,0,7
Enrique Barzola,2017-05-13,Gabriel Benitez,Decision - Unanimous,80,0,0,80
Enrique Barzola,2019-03-30,Kevin Aguilar,Decision - Unanimous,0,0,0,0
Enrique Barzola,2018-05-19,Brandon Davis,Decision - Unanimous,80,22,0,102
Enrique Barzola,2016-11-05,Chris Avila,Decision - Unanimous,80,43,0,123
Enrique Barzola,2019-08-10,Bobby Moffett,Decision - Split,70,0,0,70
Enrique Barzola,2018-01-20,Matt Bessette,Decision - Unanimous,80,12,0,92
Enrique Barzola,2015-11-21,Horacio Gutierrez,Decision - Unanimous,80,28,0,108
Vitor Petrino,2024-03-02,Tyson Pedro,Decision - Unanimous,80,0,0,80
Vitor Petrino,2024-05-04,Anthony Smith,Submission,0,0,0,0
Vitor Petrino,2023-03-11,Anton Turkalj,Decision - Unanimous,80,6,0,86
Vitor Petrino,2024-12-14,Dustin Jacoby,KO/TKO,0,0,0,0
Vitor Petrino,2023-07-08,Marcin Prachnio,Submission,90,0,0,90
Vitor Petrino,2023-11-04,Modestas Bukauskas,KO/TKO,100,0,0,100
Vitor Petrino,2022-09-06,Rodolfo Bellato,KO/TKO,100,24,0,124
Johnny Munoz,2023-10-07,Aoriqileng,Decision - Unanimous,0,0,0,0
Johnny Munoz,2021-08-07,Jamey Simmons,Submission,90,7,0,97
Johnny Munoz,2023-06-03,Daniel Santos,Decision - Unanimous,0,0,0,0
Johnny Munoz,2020-08-01,Nate Maness,Decision - Unanimous,0,28,0,28
Johnny Munoz,2022-06-04,Tony Gravely,KO/TKO,0,0,0,0
Johnny Munoz,2022-11-05,Liudvik Sholinian,Decision - Unanimous,80,22,0,102
Zak Cummings,2018-05-19,Michel Prazeres,Decision - Split,0,0,0,0
Zak Cummings,2015-07-25,Dominique Steele,KO/TKO,100,12,0,112
Zak Cummings,2018-12-15,Trevor Smith,Decision - Unanimous,80,2,0,82
Zak Cummings,2009-09-25,Tim Kennedy,Submission,0,0,0,0
Zak Cummings,2014-07-19,Gunnar Nelson,Submission,0,5,0,5
Zak Cummings,2014-05-10,Yan Cabral,Decision - Unanimous,80,5,0,85
Zak Cummings,2019-09-07,Omari Akhmedov,Decision - Unanimous,0,0,0,0
Zak Cummings,2016-08-06,Santiago Ponzinibbio,Decision - Unanimous,0,0,0,0
Zak Cummings,2013-08-28,Ben Alloway,Submission,90,0,0,90
Zak Cummings,2016-04-10,Nicolas Dalby,Decision - Unanimous,80,0,0,80
Zak Cummings,2023-04-15,Ed Herman,KO/TKO,100,46,0,146
Zak Cummings,2019-05-18,Trevin Giles,Submission,90,3,0,93
Zak Cummings,2017-04-15,Nathan Coy,Submission,90,2,0,92
Zak Cummings,2016-11-19,Alexander Yakovlev,Submission,90,6,0,96
Zak Cummings,2020-08-29,Alessio Di Chirico,Decision - Unanimous,80,1,0,81
Sean Spencer,2013-01-26,Rafael Natal,Submission,0,0,0,0
Sean Spencer,2016-02-06,Mike Pyle,KO/TKO,0,0,0,0
Sean Spencer,2014-03-15,Alex Garcia,Decision - Split,0,0,0,0
Sean Spencer,2014-09-13,Paulo Thiago,Decision - Unanimous,80,27,0,107
Sean Spencer,2013-09-04,Yuri Villefort,Decision - Split,70,30,0,100
Sean Spencer,2013-11-30,Drew Dober,Decision - Unanimous,80,44,0,124
Sean Spencer,2015-01-18,Cathal Pendred,Decision - Unanimous,0,3,0,3
Sean Spencer,2016-09-10,Yancy Medeiros,Submission,0,0,0,0
Kendall Grove,2010-12-04,Demian Maia,Decision - Unanimous,0,0,0,0
Kendall Grove,2009-03-07,Jason Day,KO/TKO,100,4,0,104
Kendall Grove,2007-08-25,Patrick Cote,KO/TKO,0,0,0,0
Kendall Grove,2009-11-21,Jake Rosholt,Submission,90,0,0,90
Kendall Grove,2009-08-08,Ricardo Almeida,Decision - Unanimous,0,0,0,0
Kendall Grove,2008-06-21,Evan Tanner,Decision - Split,70,32,0,102
Kendall Grove,2008-01-19,Jorge Rivera,KO/TKO,0,0,0,0
Kendall Grove,2011-05-28,Tim Boetsch,Decision - Unanimous,0,3,0,3
Kendall Grove,2010-04-10,Mark Munoz,KO/TKO,0,0,0,0
Kendall Grove,2007-04-07,Alan Belcher,Submission,90,33,0,123
Kendall Grove,2006-10-10,Chris Price,KO/TKO,100,8,0,108
Kendall Grove,2006-06-24,Ed Herman,Decision - Unanimous,80,0,0,80
Kendall Grove,2010-07-03,Goran Reljic,Decision - Split,70,14,0,84
Cam Rowston,2024-08-20,Torrez Finney,Decision - Unanimous,0,4,0,4
Luigi Vendramini,2021-06-12,Fares Ziam,Decision - Majority,0,0,0,0
Luigi Vendramini,2020-10-03,Jessin Ayari,KO/TKO,100,11,0,111
Luigi Vendramini,2021-09-04,Paddy Pimblett,KO/TKO,0,0,0,0
Luigi Vendramini,2018-09-22,Elizeu Zaleski dos Santos,KO/TKO,0,0,0,0
Ian McCall,2007-12-12,Charlie Valencia,Submission,0,0,0,0
Ian McCall,2007-09-05,Coty Wheeler,KO/TKO,100,49,0,149
Ian McCall,2015-01-31,John Lineker,Decision - Unanimous,0,2,0,2
Ian McCall,2013-08-03,Iliarde Santos,Decision - Unanimous,80,49,0,129
Ian McCall,2009-01-25,Dominick Cruz,Decision - Unanimous,0,0,0,0
Ian McCall,2013-02-02,Joseph Benavidez,Decision - Unanimous,0,0,0,0
Ian McCall,2012-06-08,Demetrious Johnson,Decision - Unanimous,0,0,0,0
Ian McCall,2014-07-19,Brad Pickett,Decision - Unanimous,80,34,0,114
Fernie Garcia,2023-08-26,Rinya Nakamura,Decision - Unanimous,0,0,0,0
Fernie Garcia,2021-10-05,Joshua Weems,KO/TKO,100,0,0,100
Fernie Garcia,2022-11-19,Brady Hiestand,Decision - Unanimous,0,2,0,2
Fernie Garcia,2024-02-10,Hyder Amil,KO/TKO,0,0,0,0
Fernie Garcia,2022-05-07,Journey Newson,Decision - Unanimous,0,0,0,0
DaMarques Johnson,2011-03-26,Amir Sadollah,KO/TKO,0,0,0,0
DaMarques Johnson,2012-09-29,Gunnar Nelson,Submission,0,0,0,0
DaMarques Johnson,2011-11-12,Clay Harvison,KO/TKO,100,0,0,100
DaMarques Johnson,2011-01-22,Mike Guymon,Submission,90,1,0,91
DaMarques Johnson,2010-04-10,Brad Blackburn,KO/TKO,100,0,0,100
DaMarques Johnson,2010-08-01,Matthew Riddle,KO/TKO,0,0,0,0
DaMarques Johnson,2009-12-12,Edgar Garcia,Submission,90,0,0,90
DaMarques Johnson,2012-04-14,John Maguire,Submission,0,9,0,9
DaMarques Johnson,2012-08-04,Mike Swick,KO/TKO,0,0,0,0
DaMarques Johnson,2009-06-20,James Wilks,Submission,0,0,0,0
Kurt Holobaugh,2024-03-23,Trey Ogden,Decision - Unanimous,0,0,0,0
Kurt Holobaugh,2024-07-20,Kaynan Kruschewsky,Decision - Unanimous,80,3,0,83
Kurt Holobaugh,2013-04-27,Steven Siler,Decision - Unanimous,0,0,0,0
Kurt Holobaugh,2018-07-14,Raoni Barcelos,KO/TKO,0,20,0,20
Kurt Holobaugh,2023-08-19,Austin Hubbard,Submission,90,17,0,107
Kurt Holobaugh,2018-11-03,Shane Burgos,Submission,0,4,0,4
Kurt Holobaugh,2013-01-12,Pat Healy,Decision - Unanimous,0,6,0,6
Kurt Holobaugh,2019-05-11,Thiago Moises,Decision - Unanimous,0,0,0,0
Raheam Forest,2023-09-26,Danny Barlow,KO/TKO,0,0,0,0
Alex Perez,2020-06-06,Jussier Formiga,KO/TKO,100,11,0,111
Alex Perez,2017-08-08,Kevin Gray,Submission,90,3,0,93
Alex Perez,2024-04-27,Matheus Nicolau,KO/TKO,100,6,25,131
Alex Perez,2022-07-30,Alexandre Pantoja,Submission,0,2,0,2
Alex Perez,2018-08-04,Jose Torres,KO/TKO,100,55,0,155
Alex Perez,2024-06-15,Tatsuro Taira,KO/TKO,0,10,25,35
Alex Perez,2020-01-25,Jordan Espinosa,Submission,90,0,0,90
Alex Perez,2024-03-02,Muhammad Mokaev,Decision - Unanimous,0,0,0,0
Alex Perez,2019-03-30,Mark De La Rosa,Decision - Unanimous,80,34,0,114
Alex Perez,2020-11-21,Deiveson Figueiredo,Submission,0,1,25,26
Alex Perez,2018-11-30,Joseph Benavidez,KO/TKO,0,0,0,0
Alex Perez,2018-02-24,Eric Shelton,Decision - Unanimous,80,0,0,80
Alex Perez,2017-12-09,Carls John De Tomas,Submission,90,16,0,106
Clayton Carpenter,2024-10-12,Lucas Rocha,Submission,90,17,0,107
Clayton Carpenter,2022-08-09,Edgar Chairez,Decision - Unanimous,80,28,0,108
Clayton Carpenter,2023-02-18,Juancamilo Ronderos,Submission,90,2,0,92
Lucas Rocha,2024-10-12,Clayton Carpenter,Submission,0,0,0,0
Lucas Rocha,2023-10-10,Davi Bittencourt,KO/TKO,100,0,0,100
Christos Giagos,2021-05-15,Sean Soriano,Submission,90,0,0,90
Christos Giagos,2018-09-22,Charles Oliveira,Submission,0,0,0,0
Christos Giagos,2015-06-06,Chris Wade,Decision - Unanimous,0,0,0,0
Christos Giagos,2019-06-01,Damir Hadzovic,Decision - Unanimous,80,23,0,103
Christos Giagos,2020-12-19,Carlton Minus,Decision - Unanimous,80,3,0,83
Christos Giagos,2024-04-06,Ignacio Bahamondes,KO/TKO,0,0,0,0
Christos Giagos,2018-12-01,Mizuto Hirota,Decision - Unanimous,80,12,0,92
Christos Giagos,2023-09-16,Daniel Zellhuber,Submission,0,2,0,2
Christos Giagos,2014-10-25,Gilbert Burns,Submission,0,0,0,0
Christos Giagos,2019-08-17,Drakkar Klose,Decision - Unanimous,0,0,0,0
Christos Giagos,2023-04-22,Ricky Glenn,KO/TKO,100,7,0,107
Christos Giagos,2021-09-18,Arman Tsarukyan,KO/TKO,0,0,0,0
Christos Giagos,2015-03-21,Jorge de Oliveira,Submission,90,18,0,108
Christos Giagos,2022-06-25,Thiago Moises,Submission,0,0,0,0
Sean Soriano,2021-05-15,Christos Giagos,Submission,0,11,0,11
Sean Soriano,2015-01-18,Charles Rosa,Submission,0,32,0,32
Sean Soriano,2014-09-05,Chas Skelly,Decision - Unanimous,0,11,0,11
Sean Soriano,2021-11-20,Shayilan Nuerdanbieke,Decision - Unanimous,0,18,0,18
Sean Soriano,2014-01-04,Tatsuya Kawajiri,Submission,0,0,0,0
Takenori Sato,2014-09-20,Hyun Gyu Lim,KO/TKO,0,0,0,0
Takenori Sato,2014-02-15,Erick Silva,KO/TKO,0,0,0,0
Kevin Ferguson,2009-12-05,Houston Alexander,Decision - Unanimous,80,0,0,80
Kevin Ferguson,2007-11-10,Bo Cantrell,KO/TKO,100,3,0,103
Kevin Ferguson,2008-02-16,David Abbott,KO/TKO,100,12,0,112
Kevin Ferguson,2008-05-31,James Thompson,KO/TKO,100,0,0,100
Kevin Ferguson,2008-10-04,Seth Petruzelli,KO/TKO,0,0,0,0
Kevin Ferguson,2010-05-08,Matt Mitrione,KO/TKO,0,0,0,0
Houston Alexander,2009-12-05,Kevin Ferguson,Decision - Unanimous,0,16,0,16
Houston Alexander,2007-11-17,Thiago Silva,KO/TKO,0,0,0,0
Houston Alexander,2007-09-08,Alessio Sakara,KO/TKO,100,17,0,117
Houston Alexander,2007-05-26,Keith Jardine,KO/TKO,100,12,0,112
Houston Alexander,2008-09-17,Eric Schafer,Submission,0,0,0,0
Houston Alexander,2008-04-02,James Irvin,KO/TKO,0,0,0,0
Rinat Fakhretdinov,2024-06-22,Nicolas Dalby,Decision - Split,70,2,0,72
Rinat Fakhretdinov,2022-06-04,Andreas Michailidis,Decision - Unanimous,80,27,0,107
Rinat Fakhretdinov,2023-07-01,Kevin Lee,Submission,90,8,0,98
Rinat Fakhretdinov,2022-12-17,Bryan Battle,Decision - Unanimous,80,40,0,120
Rinat Fakhretdinov,2024-10-26,Carlos Leal,Decision - Unanimous,80,2,0,82
Wilson Gouveia,2007-04-05,Seth Petruzelli,Submission,90,9,0,99
Wilson Gouveia,2007-05-26,Carmelo Marrero,Submission,90,17,0,107
Wilson Gouveia,2008-05-24,Goran Reljic,KO/TKO,0,0,0,0
Wilson Gouveia,2009-02-21,Nate Marquardt,KO/TKO,0,0,0,0
Wilson Gouveia,2009-12-12,Alan Belcher,KO/TKO,0,8,0,8
Wilson Gouveia,2006-08-26,Wes Combs,Submission,90,0,0,90
Wilson Gouveia,2008-09-17,Ryan Jensen,Submission,90,0,0,90
Wilson Gouveia,2006-06-24,Keith Jardine,Decision - Unanimous,0,0,0,0
Wilson Gouveia,2008-01-19,Jason Lambert,KO/TKO,100,0,0,100
Wilson Gouveia,2008-12-13,Jason MacDonald,KO/TKO,100,12,0,112
Rob Kimmons,2011-03-03,Dongi Yang,KO/TKO,0,0,0,0
Rob Kimmons,2009-04-01,Joe Vedepo,Submission,90,3,0,93
Rob Kimmons,2010-08-01,Steve Steinbeiss,Decision - Unanimous,80,0,0,80
Rob Kimmons,2009-10-24,Jorge Rivera,KO/TKO,0,0,0,0
Rob Kimmons,2008-09-17,Dan Miller,Submission,0,0,0,0
Rob Kimmons,2010-11-13,Kyle Noke,Submission,0,0,0,0
Rob Kimmons,2008-06-21,Rob Yundt,Submission,90,4,0,94
Sean Pierson,2012-09-22,Lance Benoist,Decision - Unanimous,80,0,0,80
Sean Pierson,2012-06-08,Jake Hecht,Decision - Unanimous,80,4,0,84
Sean Pierson,2011-12-30,Dong Hyun Kim,Decision - Unanimous,0,0,0,0
Sean Pierson,2011-04-30,Jake Ellenberger,KO/TKO,0,0,0,0
Sean Pierson,2010-12-11,Matthew Riddle,Decision - Unanimous,80,77,0,157
Sean Pierson,2013-06-15,Kenny Robertson,Decision - Majority,75,0,0,75
Lance Benoist,2012-09-22,Sean Pierson,Decision - Unanimous,0,17,0,17
Lance Benoist,2014-06-07,Bobby Voelker,Decision - Unanimous,80,19,0,99
Lance Benoist,2011-09-17,Matthew Riddle,Decision - Unanimous,80,13,0,93
Lance Benoist,2012-06-08,Seth Baczynski,Decision - Split,0,10,0,10
Miguel Baeza,2019-06-25,Victor Reyna,Decision - Unanimous,80,0,0,80
Miguel Baeza,2020-05-16,Matt Brown,KO/TKO,100,4,0,104
Miguel Baeza,2021-11-13,Khaos Williams,KO/TKO,0,0,0,0
Miguel Baeza,2022-04-16,Andre Fialho,KO/TKO,0,0,0,0
Miguel Baeza,2021-06-05,Santiago Ponzinibbio,Decision - Unanimous,0,0,0,0
Miguel Baeza,2024-06-08,Punahele Soriano,Decision - Unanimous,0,0,0,0
Miguel Baeza,2020-11-28,Takashi Sato,Submission,90,25,0,115
Miguel Baeza,2019-10-12,Hector Aldana,KO/TKO,100,27,0,127
Victor Reyna,2019-06-25,Miguel Baeza,Decision - Unanimous,0,28,0,28
Victor Reyna,2020-08-18,Louis Cosce,KO/TKO,0,0,0,0
Norman Parke,2012-12-14,Colin Fletcher,Decision - Unanimous,80,0,0,80
Norman Parke,2015-05-30,Francisco Trinaldo,Decision - Unanimous,0,0,0,0
Norman Parke,2016-02-27,Rustam Khabilov,Decision - Unanimous,0,0,0,0
Norman Parke,2013-10-26,Jon Tuck,Decision - Unanimous,80,14,0,94
Norman Parke,2013-07-06,Kazuki Tokudome,Decision - Unanimous,80,25,0,105
Norman Parke,2014-07-19,Naoyuki Kotani,KO/TKO,100,26,0,126
Norman Parke,2015-10-24,Reza Madadi,Decision - Unanimous,80,14,0,94
Norman Parke,2015-01-18,Gleison Tibau,Decision - Split,0,5,0,5
Colin Fletcher,2012-12-14,Norman Parke,Decision - Unanimous,0,14,0,14
Colin Fletcher,2013-03-16,Mike Ricci,Decision - Unanimous,0,0,0,0
Kevin Holland,2021-04-10,Marvin Vettori,Decision - Unanimous,0,13,25,38
Kevin Holland,2023-07-29,Michael Chiesa,Submission,90,5,0,95
Kevin Holland,2019-06-22,Alessio Di Chirico,Decision - Unanimous,80,7,0,87
Kevin Holland,2022-12-03,Stephen Thompson,KO/TKO,0,0,25,25
Kevin Holland,2020-10-31,Charlie Ontiveros,Submission,90,9,0,99
Kevin Holland,2019-03-30,Gerald Meerschaert,Decision - Split,70,17,0,87
Kevin Holland,2020-09-19,Darren Stewart,Decision - Split,70,17,0,87
Kevin Holland,2019-10-18,Brendan Allen,Submission,0,12,0,12
Kevin Holland,2023-09-16,Jack Della Maddalena,Decision - Split,0,22,0,22
Kevin Holland,2024-06-01,Michal Oleksiejczuk,Submission,90,0,0,90
Kevin Holland,2018-06-12,Will Santiago,Decision - Unanimous,80,61,0,141
Kevin Holland,2024-10-05,Roman Dolidze,KO/TKO,0,0,0,0
Kevin Holland,2020-05-16,Anthony Hernandez,KO/TKO,100,14,0,114
Kevin Holland,2020-12-12,Jacare Souza,KO/TKO,100,13,0,113
Kevin Holland,2022-03-05,Alex Oliveira,KO/TKO,100,29,0,129
Kevin Holland,2018-08-04,Thiago Santos,Decision - Unanimous,0,0,0,0
Kevin Holland,2023-04-08,Santiago Ponzinibbio,KO/TKO,100,22,0,122
Kevin Holland,2021-03-20,Derek Brunson,Decision - Unanimous,0,0,25,25
Kevin Holland,2024-03-09,Michael Page,Decision - Unanimous,0,0,0,0
Kevin Holland,2022-06-18,Tim Means,Submission,90,15,0,105
Kevin Holland,2020-08-08,Joaquin Buckley,KO/TKO,100,39,0,139
Kevin Holland,2018-11-24,John Phillips,Submission,90,72,0,162
Kevin Holland,2022-09-10,Khamzat Chimaev,Submission,0,0,25,25
Kleydson Rodrigues,2021-09-21,Santo Curatolo,Decision - Unanimous,80,70,0,150
Kleydson Rodrigues,2023-09-02,Farid Basharat,Submission,0,3,0,3
Kleydson Rodrigues,2022-05-07,CJ Vergara,Decision - Split,0,10,0,10
Kleydson Rodrigues,2024-05-18,Alatengheili,Decision - Unanimous,0,19,0,19
Kleydson Rodrigues,2023-02-11,Shannon Ross,KO/TKO,100,13,0,113
Santo Curatolo,2021-09-21,Kleydson Rodrigues,Decision - Unanimous,0,0,0,0
Tim McKenzie,2009-04-01,Aaron Simpson,KO/TKO,0,0,0,0
Tim McKenzie,2008-06-01,Jeremy Lang,Submission,90,3,0,93
Tim McKenzie,2008-03-26,Steve Cantwell,Submission,0,0,0,0
Steve Garcia,2021-10-09,Charlie Ontiveros,KO/TKO,100,27,0,127
Steve Garcia,2019-08-20,Desmond Torres,KO/TKO,100,32,0,132
Steve Garcia,2020-02-29,Luis Pena,Decision - Unanimous,0,0,0,0
Steve Garcia,2022-10-29,Chase Hooper,KO/TKO,100,19,0,119
Steve Garcia,2023-12-09,Melquizael Costa,KO/TKO,100,23,0,123
Steve Garcia,2022-06-11,Maheshate,KO/TKO,0,0,0,0
Steve Garcia,2024-09-07,Kyle Nelson,KO/TKO,100,21,0,121
Steve Garcia,2024-07-20,SeungWoo Choi,KO/TKO,100,6,0,106
Steve Garcia,2023-04-08,Shayilan Nuerdanbieke,KO/TKO,100,0,0,100
Sam Hoger,2005-04-09,Bobby Southworth,Decision - Unanimous,80,1,0,81
Sam Hoger,2006-04-06,Rashad Evans,Decision - Split,0,0,0,0
Sam Hoger,2005-08-06,Stephan Bonnar,Decision - Unanimous,0,0,0,0
Sam Hoger,2005-11-19,Jeff Newton,Submission,90,8,0,98
Sam Hoger,2007-02-03,Lyoto Machida,Decision - Unanimous,0,0,0,0
Bobby Southworth,2005-04-09,Sam Hoger,Decision - Unanimous,0,0,0,0
Bobby Southworth,2008-06-27,Anthony Ruiz,Decision - Unanimous,80,0,25,105
Bobby Southworth,2007-11-16,Anthony Ruiz,TKO - Doctor's Stoppage,0,0,0,0
Bobby Southworth,2008-11-21,Renato Sobral,TKO - Doctor's Stoppage,0,0,25,25
Bobby Southworth,2001-03-25,Vitor Belfort,Submission,0,0,0,0
Bobby Southworth,2007-09-29,Bill Mahood,Submission,90,2,0,92
Cristian Quinonez,2021-10-26,Xiao Long,Decision - Unanimous,80,0,0,80
Cristian Quinonez,2022-09-03,Khalid Taha,KO/TKO,100,13,0,113
Cristian Quinonez,2023-06-17,Kyung Ho Kang,Submission,0,0,0,0
Cristian Quinonez,2024-02-24,Raoni Barcelos,Submission,0,0,0,0
Casey O'Neill,2023-03-18,Jennifer Maia,Decision - Unanimous,0,0,0,0
Casey O'Neill,2021-06-19,Lara Procopio,Submission,90,30,0,120
Casey O'Neill,2023-12-16,Ariane da Silva,Submission,0,0,0,0
Casey O'Neill,2024-08-17,Luana Santos,Decision - Unanimous,80,42,0,122
Casey O'Neill,2022-02-12,Roxanne Modafferi,Decision - Split,70,109,0,179
Casey O'Neill,2021-10-02,Antonina Shevchenko,KO/TKO,100,12,0,112
Casey O'Neill,2021-02-20,Shana Dobson,KO/TKO,100,33,0,133
Montserrat Conejo Ruiz,2021-03-20,Cheyanne Vlismas,Decision - Unanimous,80,0,0,80
Montserrat Conejo Ruiz,2023-08-12,Jaqueline Amorim,KO/TKO,0,0,0,0
Montserrat Conejo Ruiz,2021-07-17,Amanda Lemos,KO/TKO,0,0,0,0
Montserrat Conejo Ruiz,2023-11-04,Eduarda Moura,KO/TKO,0,0,0,0
Cheyanne Vlismas,2021-03-20,Montserrat Conejo Ruiz,Decision - Unanimous,0,16,0,16
Cheyanne Vlismas,2022-12-17,Cory McKenna,Decision - Unanimous,0,11,0,11
Cheyanne Vlismas,2020-08-18,Hilarie Rose,Decision - Unanimous,80,57,0,137
Cheyanne Vlismas,2021-07-31,Gloria de Paula,KO/TKO,100,6,0,106
Cheyanne Vlismas,2021-12-04,Mallory Martin,Decision - Unanimous,80,54,0,134
Damir Hadzovic,2022-07-23,Marc Diakiese,Decision - Unanimous,0,0,0,0
Damir Hadzovic,2020-03-14,Renato Moicano,Submission,0,0,0,0
Damir Hadzovic,2017-05-28,Marcin Held,KO/TKO,100,0,0,100
Damir Hadzovic,2019-06-01,Christos Giagos,Decision - Unanimous,0,0,0,0
Damir Hadzovic,2016-04-10,Mairbek Taisumov,KO/TKO,0,0,0,0
Damir Hadzovic,2018-02-03,Alan Patrick,Decision - Unanimous,0,0,0,0
Damir Hadzovic,2018-07-22,Nick Hein,Decision - Split,70,28,0,98
Damir Hadzovic,2021-06-26,Yancy Medeiros,Decision - Unanimous,80,18,0,98
Damir Hadzovic,2019-02-23,Marco Polo Reyes,KO/TKO,100,34,0,134
Chase Gormley,2010-03-21,Brendan Schaub,KO/TKO,0,0,0,0
Chase Gormley,2009-10-24,Stefan Struve,Submission,0,0,0,0
Bibiano Fernandes,2010-03-22,Joachim Hansen,Decision - Split,70,0,0,70
Bibiano Fernandes,2009-10-06,Joe Warren,Submission,90,3,0,93
Bibiano Fernandes,2009-03-08,Takafumi Otsuka,Decision - Unanimous,80,11,0,91
Bibiano Fernandes,2011-12-31,Rodolfo Marques Diniz,Decision - Unanimous,80,43,0,123
Bibiano Fernandes,2009-10-06,Hiroyuki Takaya,Decision - Split,70,0,0,70
Bibiano Fernandes,2012-12-31,Yoshiro Maeda,Submission,90,0,0,90
Bibiano Fernandes,2011-12-31,Antonio Banuelos,KO/TKO,100,16,0,116
Bibiano Fernandes,2011-09-24,Takafumi Otsuka,Submission,90,0,0,90
Bibiano Fernandes,2010-12-31,Hiroyuki Takaya,Decision - Unanimous,0,0,0,0
Bibiano Fernandes,2009-05-26,Masakazu Imanari,Decision - Unanimous,80,33,0,113
Li Jingliang,2022-07-16,Muslim Salikhov,KO/TKO,100,15,0,115
Li Jingliang,2020-03-07,Neil Magny,Decision - Unanimous,0,0,0,0
Li Jingliang,2022-09-10,Daniel Rodriguez,Decision - Split,0,0,0,0
Li Jingliang,2017-01-28,Bobby Nash,KO/TKO,100,0,0,100
Li Jingliang,2014-05-24,David Michaud,Decision - Split,70,20,0,90
Li Jingliang,2016-07-08,Anton Zafir,KO/TKO,100,1,0,101
Li Jingliang,2021-01-16,Santiago Ponzinibbio,KO/TKO,100,10,0,110
Li Jingliang,2021-10-30,Khamzat Chimaev,Submission,0,0,0,0
Li Jingliang,2017-06-17,Frank Camacho,Decision - Unanimous,80,59,0,139
Li Jingliang,2015-09-26,Keita Nakamura,Submission,0,39,0,39
Li Jingliang,2014-10-04,Nordine Taleb,Decision - Split,0,0,0,0
Li Jingliang,2019-08-31,Elizeu Zaleski dos Santos,KO/TKO,100,5,0,105
Li Jingliang,2017-11-25,Zak Ottow,KO/TKO,100,21,0,121
Li Jingliang,2018-06-23,Daichi Abe,Decision - Unanimous,80,51,0,131
Li Jingliang,2024-08-17,Carlos Prates,KO/TKO,0,0,0,0
Li Jingliang,2018-11-24,David Zawada,KO/TKO,100,16,0,116
Li Jingliang,2018-02-10,Jake Matthews,Decision - Unanimous,0,0,0,0
Li Jingliang,2015-05-16,Dhiego Lima,KO/TKO,100,7,0,107
Tom DeBlass,2012-11-10,Riki Fukuda,Decision - Unanimous,0,0,0,0
Tom DeBlass,2012-04-14,Cyrille Diabate,Decision - Majority,0,0,0,0
Antonio Jones,2018-07-17,Edmen Shahbazyan,KO/TKO,0,0,0,0
Antonio Schembri,2003-03-16,Kazushi Sakuraba,KO/TKO,100,0,0,100
Antonio Schembri,2005-05-22,Ryo Chonan,Decision - Unanimous,0,0,0,0
Antonio Schembri,2003-06-08,Kazuhiro Hamanaka,Decision - Unanimous,0,0,0,0
Antonio Schembri,2004-06-20,Kazushi Sakuraba,Decision - Unanimous,0,0,0,0
Antonio Schembri,2001-05-27,Johil de Oliveira,Submission,90,1,0,91
Andre Gusmao,2009-05-23,Krzysztof Soszynski,KO/TKO,0,0,0,0
Andre Gusmao,2008-08-09,Jon Jones,Decision - Unanimous,0,0,0,0
Ebenezer Fontes Braga,1999-07-04,Kazushi Sakuraba,Submission,0,0,0,0
Ebenezer Fontes Braga,2000-01-30,Akira Shoji,Decision - Unanimous,0,8,0,8
Ebenezer Fontes Braga,1998-10-16,Jeremy Horn,Submission,90,6,0,96
Ebenezer Fontes Braga,2001-07-29,Daijiro Matsui,Decision - Unanimous,80,46,0,126
Ebenezer Fontes Braga,2004-05-15,Fabricio Werdum,KO/TKO,0,7,0,7
Mounir Lazzez,2021-01-20,Warlley Alves,KO/TKO,0,0,0,0
Mounir Lazzez,2023-01-21,Gabriel Bonfim,Submission,0,0,0,0
Mounir Lazzez,2022-04-16,Ange Loosa,Decision - Unanimous,80,53,0,133
Mounir Lazzez,2020-07-15,Abdul Razak Alhassan,Decision - Unanimous,80,31,0,111
Hunter Azure,2019-07-09,Christian Ocon,Decision - Unanimous,80,53,0,133
Hunter Azure,2020-09-05,Cole Smith,Decision - Unanimous,80,11,0,91
Hunter Azure,2020-05-13,Brian Kelleher,KO/TKO,0,33,0,33
Hunter Azure,2021-04-10,Jack Shore,Decision - Split,0,9,0,9
Hunter Azure,2019-09-14,Brad Katona,Decision - Unanimous,80,20,0,100
Christian Ocon,2019-07-09,Hunter Azure,Decision - Unanimous,0,0,0,0
Hatsu Hioki,2013-08-28,Darren Elkins,Decision - Unanimous,0,0,0,0
Hatsu Hioki,2014-06-28,Charles Oliveira,Submission,0,0,0,0
Hatsu Hioki,2012-06-22,Ricardo Lamas,Decision - Unanimous,0,0,0,0
Hatsu Hioki,2013-01-26,Clay Guida,Decision - Split,0,15,0,15
Hatsu Hioki,2012-02-25,Bart Palaszewski,Decision - Unanimous,80,41,0,121
Hatsu Hioki,2006-08-27,Jeff Curran,Decision - Unanimous,80,29,0,109
Hatsu Hioki,2014-03-01,Ivan Menjivar,Decision - Unanimous,80,2,0,82
Hatsu Hioki,2015-05-09,Dan Hooker,KO/TKO,0,11,0,11
Hatsu Hioki,2011-10-29,George Roop,Decision - Split,70,0,0,70
Jameel Massouh,2009-08-09,Leonard Garcia,Decision - Split,0,25,0,25
Jameel Massouh,2009-12-19,Erik Koch,Decision - Unanimous,0,0,0,0
Jameel Massouh,2009-04-05,Raphael Assuncao,Decision - Unanimous,0,0,0,0
Barb Honchak,2017-12-01,Lauren Murphy,Decision - Split,0,12,0,12
Barb Honchak,2018-07-06,Roxanne Modafferi,KO/TKO,0,0,0,0
Aleksander Emelianenko,2006-11-12,Fabricio Werdum,Submission,0,0,0,0
Aleksander Emelianenko,2004-05-23,Matt Foki,Submission,90,11,0,101
Aleksander Emelianenko,2006-05-05,Josh Barnett,Submission,0,0,0,0
Aleksander Emelianenko,2004-10-31,James Thompson,KO/TKO,100,6,0,106
Aleksander Emelianenko,2006-09-10,Sergei Kharitonov,KO/TKO,100,3,0,103
Aleksander Emelianenko,2005-12-31,Pawel Nastula,Submission,90,9,0,99
Aleksander Emelianenko,2003-10-05,Assuerio Silva,Decision - Split,70,33,0,103
Aleksander Emelianenko,2004-08-15,Mirko Filipovic,KO/TKO,0,0,0,0
Aleksander Emelianenko,2005-04-03,Ricardo Morais,KO/TKO,100,8,0,108
Aleksei Kunchenko,2018-09-15,Thiago Alves,Decision - Unanimous,80,0,0,80
Aleksei Kunchenko,2020-03-14,Elizeu Zaleski dos Santos,Decision - Unanimous,0,0,0,0
Aleksei Kunchenko,2018-12-01,Yushin Okami,Decision - Unanimous,80,62,0,142
Aleksei Kunchenko,2019-08-10,Gilbert Burns,Decision - Unanimous,0,5,0,5
Umar Nurmagomedov,2024-03-02,Bekzat Almakhan,Decision - Unanimous,80,65,0,145
Umar Nurmagomedov,2023-01-14,Raoni Barcelos,KO/TKO,100,23,0,123
Umar Nurmagomedov,2022-03-05,Brian Kelleher,Submission,90,17,0,107
Umar Nurmagomedov,2024-08-03,Cory Sandhagen,Decision - Unanimous,80,27,25,132
Umar Nurmagomedov,2022-06-25,Nate Maness,Decision - Unanimous,80,72,0,152
Umar Nurmagomedov,2021-01-20,Sergey Morozov,Submission,90,18,0,108
Bekzat Almakhan,2024-03-02,Umar Nurmagomedov,Decision - Unanimous,0,0,0,0
Makwan Amirkhani,2016-02-27,Mike Wilkinson,Decision - Unanimous,80,19,0,99
Makwan Amirkhani,2020-10-10,Edson Barboza,Decision - Unanimous,0,0,0,0
Makwan Amirkhani,2015-01-24,Andy Ogle,KO/TKO,100,6,0,106
Makwan Amirkhani,2021-06-05,Kamuela Kirk,Decision - Unanimous,0,0,0,0
Makwan Amirkhani,2017-03-18,Arnold Allen,Decision - Split,0,0,0,0
Makwan Amirkhani,2022-03-19,Mike Grundy,Submission,90,0,0,90
Makwan Amirkhani,2018-05-27,Jason Knight,Decision - Split,70,0,0,70
Makwan Amirkhani,2015-06-20,Masio Fullen,Submission,90,0,0,90
Makwan Amirkhani,2022-07-23,Jonathan Pearce,KO/TKO,0,0,0,0
Makwan Amirkhani,2019-06-01,Chris Fishgold,Submission,90,0,0,90
Makwan Amirkhani,2019-11-02,Shane Burgos,KO/TKO,0,0,0,0
Makwan Amirkhani,2020-07-11,Danny Henry,Submission,90,0,0,90
Makwan Amirkhani,2021-10-30,Lerone Murphy,KO/TKO,0,0,0,0
Makwan Amirkhani,2023-03-18,Jack Shore,Submission,0,0,0,0
Shungo Oyama,2002-06-23,Renzo Gracie,Decision - Unanimous,80,0,0,80
Shungo Oyama,2002-09-29,Ryan Gracie,Submission,0,3,0,3
Shungo Oyama,2001-05-27,Wanderlei Silva,KO/TKO,0,0,0,0
Shungo Oyama,2009-04-05,Andrews Nakahara,KO/TKO,0,0,0,0
Shungo Oyama,2003-03-16,Dan Henderson,KO/TKO,0,0,0,0
Shungo Oyama,2004-07-19,Mirko Filipovic,KO/TKO,0,0,0,0
Shungo Oyama,2001-07-29,Wallid Ismail,Submission,0,0,0,0
Shungo Oyama,2008-04-29,Dong Sik Yoon,Decision - Unanimous,0,0,0,0
Renzo Gracie,2002-06-23,Shungo Oyama,Decision - Unanimous,0,11,0,11
Renzo Gracie,2003-10-05,Carlos Newton,Decision - Split,0,0,0,0
Renzo Gracie,2007-02-10,Frank Shamrock,DQ,0,0,0,0
Renzo Gracie,2000-08-27,Kazushi Sakuraba,Submission,0,0,0,0
Renzo Gracie,1998-03-05,Sanae Kikuta,Submission,90,17,0,107
Renzo Gracie,2010-04-10,Matt Hughes,KO/TKO,0,0,0,0
Renzo Gracie,2001-11-03,Michiyoshi Ohara,Decision - Unanimous,80,64,0,144
Renzo Gracie,2005-07-09,BJ Penn,Decision - Unanimous,0,0,0,0
Renzo Gracie,2001-03-25,Dan Henderson,KO/TKO,0,0,0,0
Renzo Gracie,1999-11-21,Alexander Otsuka,Decision - Unanimous,80,3,0,83
Liana Jojua,2020-07-15,Diana Belbita,Submission,90,0,0,90
Liana Jojua,2019-09-07,Sarah Moras,KO/TKO,0,0,0,0
Liana Jojua,2021-11-13,Cortney Casey,Decision - Unanimous,0,0,0,0
Liana Jojua,2020-10-24,Miranda Maverick,TKO - Doctor's Stoppage,0,0,0,0
Diana Belbita,2020-07-15,Liana Jojua,Submission,0,3,0,3
Diana Belbita,2024-02-03,Molly McCann,Submission,0,0,0,0
Diana Belbita,2019-10-18,Molly McCann,Decision - Unanimous,0,0,0,0
Diana Belbita,2023-10-07,Karolina Kowalkiewicz,Decision - Unanimous,0,0,0,0
Diana Belbita,2021-07-24,Hannah Goldy,Decision - Unanimous,80,25,0,105
Diana Belbita,2022-02-19,Gloria de Paula,Decision - Unanimous,0,0,0,0
Diana Belbita,2023-06-10,Maria Oliveira,Decision - Unanimous,80,42,0,122
Michiyoshi Ohara,2002-09-29,Kevin Randleman,Decision - Unanimous,0,0,0,0
Michiyoshi Ohara,2001-11-03,Renzo Gracie,Decision - Unanimous,0,0,0,0
Brunno Ferreira,2024-06-08,Dustin Stoltzfus,KO/TKO,100,6,0,106
Brunno Ferreira,2024-01-13,Phil Hawes,KO/TKO,100,6,0,106
Brunno Ferreira,2024-10-26,Abus Magomedov,Submission,0,3,0,3
Brunno Ferreira,2022-09-20,Leon Aliu,KO/TKO,100,6,0,106
Brunno Ferreira,2023-01-21,Gregory Rodrigues,KO/TKO,100,1,0,101
Brunno Ferreira,2023-07-01,Nursulton Ruziboev,KO/TKO,0,0,0,0
Dustin Stoltzfus,2024-06-08,Brunno Ferreira,KO/TKO,0,0,0,0
Dustin Stoltzfus,2022-09-03,Abus Magomedov,KO/TKO,0,0,0,0
Dustin Stoltzfus,2021-12-18,Gerald Meerschaert,Submission,0,1,0,1
Dustin Stoltzfus,2022-07-16,Dwight Grant,Decision - Unanimous,80,0,0,80
Dustin Stoltzfus,2020-11-21,Kyle Daukaus,Decision - Unanimous,0,0,0,0
Dustin Stoltzfus,2020-08-11,Joe Pyfer,KO/TKO,100,4,0,104
Dustin Stoltzfus,2021-07-17,Rodolfo Vieira,Submission,0,18,0,18
Dustin Stoltzfus,2024-11-02,Marc-Andre Barriault,KO/TKO,100,6,0,106
Dustin Stoltzfus,2023-12-02,Punahele Soriano,Submission,90,33,0,123
Tsuyoshi Tamakairiki,2004-05-23,Akira Shoji,KO/TKO,0,0,0,0
Marvin Eastman,2004-10-22,Travis Lutter,KO/TKO,0,9,0,9
Marvin Eastman,2007-02-03,Quinton Jackson,KO/TKO,0,0,0,0
Marvin Eastman,2008-06-21,Drew McFedries,KO/TKO,0,0,0,0
Marvin Eastman,2008-02-02,Terry Martin,Decision - Unanimous,80,0,0,80
Marvin Eastman,2001-11-03,Rich Franklin,Submission,0,0,0,0
Marvin Eastman,2003-06-06,Vitor Belfort,KO/TKO,0,0,0,0
Robert McDaniel,2013-04-13,Gilbert Smith,Submission,90,21,0,111
Robert McDaniel,2014-03-15,Sean Strickland,Submission,0,0,0,0
Robert McDaniel,2013-08-28,Brad Tavares,Decision - Unanimous,0,0,0,0
Gilbert Smith,2013-04-13,Robert McDaniel,Submission,0,0,0,0
Marcin Prachnio,2023-02-18,William Knight,Decision - Unanimous,80,71,0,151
Marcin Prachnio,2024-02-10,Devin Clark,Decision - Unanimous,80,48,0,128
Marcin Prachnio,2021-06-26,Ike Villanueva,KO/TKO,100,25,0,125
Marcin Prachnio,2021-01-23,Khalil Rountree Jr.,Decision - Unanimous,80,53,0,133
Marcin Prachnio,2022-04-23,Philipe Lins,Decision - Unanimous,0,10,0,10
Marcin Prachnio,2023-07-08,Vitor Petrino,Submission,0,11,0,11
Marcin Prachnio,2020-08-22,Mike Rodriguez,KO/TKO,0,0,0,0
Marcin Prachnio,2018-09-15,Magomed Ankalaev,KO/TKO,0,0,0,0
Marcin Prachnio,2018-02-24,Sam Alvey,KO/TKO,0,5,0,5
Marcin Prachnio,2024-07-27,Modestas Bukauskas,Submission,0,32,0,32
William Knight,2023-02-18,Marcin Prachnio,Decision - Unanimous,0,0,0,0
William Knight,2021-04-10,Da Woon Jung,Decision - Unanimous,0,0,0,0
William Knight,2022-04-16,Devin Clark,KO/TKO,0,0,0,0
William Knight,2022-02-12,Maxim Grishin,Decision - Unanimous,0,0,0,0
William Knight,2020-09-26,Aleksa Camur,Decision - Unanimous,80,21,0,101
William Knight,2021-08-21,Fabio Cherant,KO/TKO,100,0,0,100
William Knight,2019-08-13,Herdem Alacabek,KO/TKO,100,41,0,141
William Knight,2021-12-04,Alonzo Menifield,Decision - Unanimous,80,11,0,91
William Knight,2020-09-01,Cody Brundage,KO/TKO,100,0,0,100
Blas Avena,2008-08-03,Dave Terrel,KO/TKO,100,8,0,108
Blas Avena,2007-08-05,Tiki Ghosn,Submission,90,2,0,92
Blas Avena,2008-03-26,Hiromitsu Miura,KO/TKO,0,0,0,0
Blas Avena,2007-09-05,Joe Benoit,Submission,90,0,0,90
Blas Avena,2009-01-25,Jesse Lennox,KO/TKO,0,0,0,0
Blas Avena,2007-01-20,Logan Clark,KO/TKO,0,0,0,0
Dave Terrel,2008-08-03,Blas Avena,KO/TKO,0,0,0,0
Dave Terrel,2006-10-12,Mike Moreno,Decision - Unanimous,80,0,0,80
Dave Terrel,2007-03-24,Tiki Ghosn,KO/TKO,100,7,0,107
Donavon Frelow,2017-08-08,Ricky Simon,Decision - Split,0,0,0,0
Geza Kalman,1996-07-12,Dieusel Berto,KO/TKO,100,18,0,118
Dieusel Berto,1996-07-12,Geza Kalman,KO/TKO,0,0,0,0
Gerald Meerschaert,2019-08-03,Trevin Giles,Submission,90,0,0,90
Gerald Meerschaert,2020-03-07,Deron Winn,Submission,90,33,0,123
Gerald Meerschaert,2017-02-19,Ryan Janes,Submission,90,0,0,90
Gerald Meerschaert,2021-12-18,Dustin Stoltzfus,Submission,90,0,0,90
Gerald Meerschaert,2023-08-19,Andre Petroski,Decision - Split,0,19,0,19
Gerald Meerschaert,2018-12-15,Jack Hermansson,Submission,0,0,0,0
Gerald Meerschaert,2016-12-09,Joseph Gigliotti,Submission,90,9,0,99
Gerald Meerschaert,2019-10-12,Eryk Anders,Decision - Split,0,8,0,8
Gerald Meerschaert,2019-03-30,Kevin Holland,Decision - Split,0,0,0,0
Gerald Meerschaert,2020-06-06,Ian Heinisch,KO/TKO,0,0,0,0
Gerald Meerschaert,2022-04-30,Krzysztof Jotko,Decision - Unanimous,0,0,0,0
Gerald Meerschaert,2021-04-17,Bartosz Fabinski,Submission,90,2,0,92
Gerald Meerschaert,2024-03-16,Bryan Barberena,Submission,90,0,0,90
Gerald Meerschaert,2017-12-01,Eric Spicely,KO/TKO,100,19,0,119
Gerald Meerschaert,2020-09-19,Khamzat Chimaev,KO/TKO,0,0,0,0
Gerald Meerschaert,2022-08-13,Bruno Silva,Submission,90,17,0,107
Gerald Meerschaert,2018-07-06,Oskar Piechota,Submission,90,28,0,118
Gerald Meerschaert,2017-07-08,Thiago Santos,KO/TKO,0,0,0,0
Gerald Meerschaert,2024-08-24,Edmen Shahbazyan,Submission,90,0,0,90
Gerald Meerschaert,2023-04-08,Joe Pyfer,KO/TKO,0,0,0,0
Gerald Meerschaert,2021-08-28,Makhmud Muradov,Submission,90,0,0,90
Gerald Meerschaert,2024-11-09,Reinier de Ridder,Submission,0,0,0,0
Yan Cabral,2015-11-07,Johnny Case,Decision - Unanimous,0,0,0,0
Yan Cabral,2014-05-10,Zak Cummings,Decision - Unanimous,0,0,0,0
Yan Cabral,2016-05-08,Reza Madadi,KO/TKO,0,5,0,5
Yan Cabral,2011-09-24,Kazushi Sakuraba,Submission,90,27,0,117
Yan Cabral,2014-10-25,Naoyuki Kotani,Submission,90,6,0,96
Yan Cabral,2013-10-09,David Mitchell,Decision - Unanimous,80,13,0,93
Mario Sousa,2022-09-13,Ikram Aliskerov,Submission,0,10,0,10
Mario Sousa,2020-11-10,Mariusz Ksiazkiewicz,Decision - Unanimous,80,37,0,117
Mario Sousa,2021-09-07,Chidi Njokuani,KO/TKO,0,0,0,0
Erik Koch,2014-02-22,Rafaello Oliveira,KO/TKO,100,18,0,118
Erik Koch,2019-07-27,Kyle Stewart,Decision - Unanimous,80,14,0,94
Erik Koch,2011-09-17,Jonathan Brookins,Decision - Unanimous,80,17,0,97
Erik Koch,2013-08-31,Dustin Poirier,Decision - Unanimous,0,0,0,0
Erik Koch,2010-06-20,Bendy Casimir,Submission,90,13,0,103
Erik Koch,2017-06-25,Clay Guida,Decision - Unanimous,0,0,0,0
Erik Koch,2010-11-11,Francisco Rivera,KO/TKO,100,5,0,105
Erik Koch,2016-05-29,Shane Campbell,Submission,90,0,0,90
Erik Koch,2013-01-26,Ricardo Lamas,KO/TKO,0,0,0,0
Erik Koch,2014-05-10,Daron Cruickshank,KO/TKO,0,0,0,0
Erik Koch,2009-12-19,Jameel Massouh,Decision - Unanimous,80,23,0,103
Erik Koch,2011-03-19,Raphael Assuncao,KO/TKO,100,0,0,100
Erik Koch,2010-03-06,Chad Mendes,Decision - Unanimous,0,0,0,0
Erik Koch,2018-01-27,Bobby Green,Decision - Unanimous,0,0,0,0
Chan Sung Jung,2022-04-09,Alexander Volkanovski,KO/TKO,0,0,25,25
Chan Sung Jung,2011-03-26,Leonard Garcia,Submission,90,15,0,105
Chan Sung Jung,2010-04-24,Leonard Garcia,Decision - Split,0,25,0,25
Chan Sung Jung,2019-06-22,Renato Moicano,KO/TKO,100,16,25,141
Chan Sung Jung,2012-05-15,Dustin Poirier,Submission,90,18,25,133
Chan Sung Jung,2023-08-26,Max Holloway,KO/TKO,0,0,25,25
Chan Sung Jung,2017-02-04,Dennis Bermudez,KO/TKO,100,0,25,125
Chan Sung Jung,2011-12-10,Mark Hominick,KO/TKO,100,6,0,106
Chan Sung Jung,2013-08-03,Jose Aldo,KO/TKO,0,0,25,25
Chan Sung Jung,2020-10-17,Brian Ortega,Decision - Unanimous,0,0,25,25
Chan Sung Jung,2021-06-19,Dan Ige,Decision - Unanimous,80,12,25,117
Chan Sung Jung,2018-11-10,Yair Rodriguez,KO/TKO,0,7,25,32
Chan Sung Jung,2019-12-21,Frankie Edgar,KO/TKO,100,37,25,162
Chan Sung Jung,2010-09-30,George Roop,KO/TKO,0,0,0,0
Waylon Lowe,2011-01-22,Willamy Freire,Decision - Unanimous,80,0,0,80
Waylon Lowe,2010-09-25,Steve Lopez,Decision - Split,70,3,0,73
Waylon Lowe,2010-05-29,Melvin Guillard,KO/TKO,0,0,0,0
Waylon Lowe,2011-03-26,Nik Lentz,Submission,0,0,0,0
Willamy Freire,2011-01-22,Waylon Lowe,Decision - Unanimous,0,8,0,8
Willamy Freire,2011-09-24,Satoru Kitaoka,Decision - Split,0,10,0,10
Cameron Saaiman,2023-07-08,Terrence Mitchell,KO/TKO,100,15,0,115
Cameron Saaiman,2022-08-23,Joshua Wang-Kim,KO/TKO,100,19,0,119
Cameron Saaiman,2022-12-10,Steven Koslow,KO/TKO,100,42,0,142
Cameron Saaiman,2024-03-23,Payton Talbott,KO/TKO,0,0,0,0
Cameron Saaiman,2023-03-04,Mana Martinez,Decision - Majority,75,57,0,132
Cameron Saaiman,2023-10-14,Christian Rodriguez,Decision - Unanimous,0,0,0,0
Terrence Mitchell,2023-07-08,Cameron Saaiman,KO/TKO,0,0,0,0
Terrence Mitchell,2023-09-16,Raul Rosas Jr.,KO/TKO,0,0,0,0
Yuji Nagata,2001-12-31,Mirko Filipovic,KO/TKO,0,0,0,0
Yuji Nagata,2003-12-31,Fedor Emelianenko,KO/TKO,0,0,0,0
Danny Downes,2010-12-16,Zhang Tiequan,Decision - Unanimous,80,19,0,99
Danny Downes,2010-06-20,Chris Horodecki,Submission,0,0,0,0
Danny Downes,2011-10-29,Ramsey Nijem,Decision - Unanimous,0,0,0,0
Danny Downes,2011-06-04,Jeremy Stephens,Decision - Unanimous,0,0,0,0
Zhang Tiequan,2010-12-16,Danny Downes,Decision - Unanimous,0,0,0,0
Zhang Tiequan,2011-10-08,Darren Elkins,Decision - Unanimous,0,0,0,0
Zhang Tiequan,2012-11-10,Jon Tuck,Decision - Unanimous,0,4,0,4
Zhang Tiequan,2012-02-25,Issei Tamura,KO/TKO,0,0,0,0
Zhang Tiequan,2010-09-30,Pablo Garza,Submission,90,0,0,90
Zhang Tiequan,2011-02-26,Jason Reinhardt,Submission,90,2,0,92
Luan Chagas,2018-04-21,Siyar Bahadurzada,KO/TKO,0,0,0,0
Luan Chagas,2017-06-03,Jim Wallhead,Submission,90,63,0,153
Luan Chagas,2016-09-24,Erick Silva,Submission,0,0,0,0
Tsuyoshi Kohsaka,1998-10-16,Pete Williams,Decision - Unanimous,80,1,0,81
Tsuyoshi Kohsaka,2006-02-26,Mario Sperry,KO/TKO,100,0,0,100
Tsuyoshi Kohsaka,1999-11-19,Pedro Rizzo,KO/TKO,0,0,0,0
Tsuyoshi Kohsaka,1998-03-13,Kimo Leopoldo,Decision - Unanimous,80,32,0,112
Tsuyoshi Kohsaka,2005-04-03,Fedor Emelianenko,TKO - Doctor's Stoppage,0,0,0,0
Tsuyoshi Kohsaka,1999-01-08,Bas Rutten,KO/TKO,0,0,0,0
Tsuyoshi Kohsaka,1999-07-16,Tim Lajcik,KO/TKO,100,0,0,100
Tsuyoshi Kohsaka,2006-05-05,Mark Hunt,KO/TKO,0,0,0,0
Tsuyoshi Kohsaka,2002-05-10,Ricco Rodriguez,KO/TKO,0,0,0,0
Pete Williams,1998-10-16,Tsuyoshi Kohsaka,Decision - Unanimous,0,0,0,0
Pete Williams,1998-05-15,Mark Coleman,KO/TKO,100,0,0,100
Pete Williams,1999-05-07,Travis Fulton,Submission,90,9,0,99
Pete Williams,1999-03-05,Jason Godsey,Submission,90,1,0,91
Pete Williams,2001-11-02,Ricco Rodriguez,KO/TKO,0,0,0,0
Pete Williams,2001-05-04,Semmy Schilt,KO/TKO,0,0,0,0
Pete Williams,2002-03-22,Frank Mir,Submission,0,0,0,0
Pete Williams,1999-11-19,Kevin Randleman,Decision - Unanimous,0,0,25,25
Kris Moutinho,2021-07-10,Sean O'Malley,KO/TKO,0,0,0,0
Kris Moutinho,2022-03-12,Guido Cannetti,KO/TKO,0,0,0,0
Rustam Khabilov,2013-11-06,Jorge Masvidal,Decision - Unanimous,80,0,0,80
Rustam Khabilov,2019-11-09,Sergey Khandozhko,Decision - Unanimous,80,0,0,80
Rustam Khabilov,2016-09-03,Leandro Silva,Decision - Unanimous,80,0,0,80
Rustam Khabilov,2018-09-15,Kajan Johnson,Decision - Split,70,0,0,70
Rustam Khabilov,2016-02-27,Norman Parke,Decision - Unanimous,80,16,0,96
Rustam Khabilov,2019-02-23,Diego Ferreira,Decision - Unanimous,0,0,0,0
Rustam Khabilov,2016-05-08,Chris Wade,Decision - Unanimous,80,25,0,105
Rustam Khabilov,2016-12-10,Jason Saggo,Decision - Unanimous,80,23,0,103
Rustam Khabilov,2014-06-07,Benson Henderson,Submission,0,0,25,25
Rustam Khabilov,2017-09-02,Desmond Green,Decision - Unanimous,80,0,0,80
Rustam Khabilov,2013-04-27,Yancy Medeiros,TKO - Doctor's Stoppage,0,0,0,0
Rustam Khabilov,2015-02-22,Adriano Martins,Decision - Split,0,6,0,6
Rustam Khabilov,2012-12-15,Vinc Pichel,KO/TKO,100,13,0,113
Nasrat Haqparast,2019-08-03,Joaquim Silva,KO/TKO,100,6,0,106
Nasrat Haqparast,2023-09-09,Landon Quinones,Decision - Unanimous,80,23,0,103
Nasrat Haqparast,2021-09-25,Dan Hooker,Decision - Unanimous,0,0,0,0
Nasrat Haqparast,2023-12-09,Jamie Mullarkey,KO/TKO,100,8,0,108
Nasrat Haqparast,2021-03-13,Rafa Garcia,Decision - Unanimous,80,47,0,127
Nasrat Haqparast,2022-09-03,John Makdessi,Decision - Unanimous,80,0,0,80
Nasrat Haqparast,2024-06-22,Jared Gordon,Decision - Split,70,5,0,75
Nasrat Haqparast,2020-01-18,Drew Dober,KO/TKO,0,0,0,0
Nasrat Haqparast,2017-10-21,Marcin Held,Decision - Unanimous,0,8,0,8
Nasrat Haqparast,2018-07-22,Marc Diakiese,Decision - Unanimous,80,43,0,123
Nasrat Haqparast,2018-10-27,Thibault Gouti,Decision - Unanimous,80,46,0,126
Nasrat Haqparast,2022-02-12,Bobby Green,Decision - Unanimous,0,0,0,0
Nasrat Haqparast,2020-08-08,Alexander Munoz,Decision - Unanimous,80,67,0,147
Tagir Ulanbekov,2020-10-10,Bruno Silva,Decision - Unanimous,80,0,0,80
Tagir Ulanbekov,2022-03-05,Tim Elliott,Decision - Unanimous,0,11,0,11
Tagir Ulanbekov,2021-10-30,Allan Nascimento,Decision - Split,70,0,0,70
Tagir Ulanbekov,2023-12-16,Cody Durden,Submission,90,0,0,90
Tagir Ulanbekov,2022-11-05,Nate Maness,Submission,90,0,0,90
Julie Kedzie,2013-07-27,Germaine de Randamie,Decision - Split,0,0,0,0
Julie Kedzie,2013-12-06,Bethe Correia,Decision - Split,0,0,0,0
Julie Kedzie,2007-02-10,Gina Carano,Decision - Unanimous,0,0,0,0
Julie Kedzie,2012-08-18,Miesha Tate,Submission,0,35,0,35
Nina Nunes,2014-11-08,Juliana Lima,Decision - Unanimous,0,2,0,2
Nina Nunes,2018-12-08,Claudia Gadelha,Decision - Unanimous,80,47,0,127
Nina Nunes,2018-07-28,Randa Markos,Decision - Unanimous,80,26,0,106
Nina Nunes,2022-08-13,Cynthia Calvillo,Decision - Split,70,0,0,70
Nina Nunes,2017-11-11,Angela Hill,Decision - Unanimous,80,36,0,116
Nina Nunes,2016-01-02,Justine Kish,Decision - Unanimous,0,20,0,20
Nina Nunes,2019-06-08,Tatiana Suarez,Decision - Unanimous,0,0,0,0
Nina Nunes,2017-01-15,Jocelyn Jones-Lybarger,Submission,90,27,0,117
Nina Nunes,2021-04-10,Mackenzie Dern,Submission,0,0,0,0
Amaury Bitetti,1996-05-17,Don Frye,KO/TKO,0,0,0,0
Amaury Bitetti,2000-06-09,Alex Andrade,DQ,0,0,0,0
Diego Rivas,2018-05-19,Guido Cannetti,Decision - Unanimous,0,0,0,0
Diego Rivas,2014-11-08,Rodolfo Rubio Perez,Decision - Unanimous,80,0,0,80
Diego Rivas,2016-02-06,Noad Lahat,KO/TKO,100,0,0,100
Diego Rivas,2017-08-05,Jose Quinonez,Decision - Unanimous,0,0,0,0
Danni McCormack,2024-08-23,Yan Qihui,Decision - Unanimous,80,36,0,116
Yan Qihui,2024-08-23,Danni McCormack,Decision - Unanimous,0,0,0,0
Yan Qihui,2024-05-19,Lisa Kyriacou,Decision - Split,70,0,0,70
Yan Qihui,2021-10-26,Karine Silva,Submission,0,15,0,15
Marloes Coenen,2011-07-30,Miesha Tate,Submission,0,19,25,44
Marloes Coenen,2009-11-07,Roxanne Modafferi,Submission,90,4,0,94
Marloes Coenen,2010-01-30,Cristiane Justino,KO/TKO,0,0,25,25
Marloes Coenen,2010-10-09,Sarah Kaufman,Submission,90,16,25,131
Marloes Coenen,2012-12-31,Fiona Muxlow,Submission,90,14,0,104
Marloes Coenen,2011-03-05,Liz Carmouche,Submission,90,0,25,115
Per Eklund,2008-01-19,Sam Stout,Decision - Unanimous,0,0,0,0
Per Eklund,2009-02-21,Evan Dunham,KO/TKO,0,0,0,0
Per Eklund,2008-10-18,Samy Schiavo,Submission,90,8,0,98
TJ Laramie,2020-08-11,Daniel Swain,TKO - Doctor's Stoppage,0,12,0,12
TJ Laramie,2022-04-16,Pat Sabatini,Decision - Unanimous,0,0,0,0
TJ Laramie,2020-09-19,Darrick Minner,Submission,0,0,0,0
Daniel Swain,2020-08-11,TJ Laramie,TKO - Doctor's Stoppage,0,0,0,0
Gerald Harris,2010-01-11,John Salter,KO/TKO,100,14,0,114
Gerald Harris,2010-03-31,Mario Miranda,KO/TKO,100,1,0,101
Gerald Harris,2011-09-24,Kazuhiro Nakamura,Decision - Split,70,2,0,72
Gerald Harris,2010-07-03,David Branch,KO/TKO,100,0,0,100
Gerald Harris,2010-11-20,Maiquel Falcao,Decision - Unanimous,0,0,0,0
John Salter,2010-01-11,Gerald Harris,KO/TKO,0,0,0,0
John Salter,2010-05-08,Jason MacDonald,KO/TKO,100,0,0,100
John Salter,2010-08-28,Dan Miller,Submission,0,0,0,0
Dave Beneteau,1995-04-07,Todd Medina,KO/TKO,100,8,0,108
Dave Beneteau,1995-12-16,Oleg Taktarov,Submission,0,2,0,2
Dave Beneteau,1995-04-07,Asbel Cancio,KO/TKO,100,12,0,112
Dave Beneteau,1995-04-07,Dan Severn,Submission,0,0,0,0
Dave Beneteau,1995-07-14,Oleg Taktarov,Submission,0,5,0,5
Dave Beneteau,1997-10-17,Carlos Barreto,Decision - Unanimous,80,2,0,82
Todd Medina,1995-04-07,Dave Beneteau,KO/TKO,0,0,0,0
Todd Medina,1995-04-07,Larry Cureton,Submission,90,3,0,93
Sergei Pavlovich,2023-11-11,Tom Aspinall,KO/TKO,0,0,25,25
Sergei Pavlovich,2024-06-22,Alexander Volkov,Decision - Unanimous,0,0,0,0
Sergei Pavlovich,2019-10-26,Maurice Greene,KO/TKO,100,12,0,112
Sergei Pavlovich,2022-03-19,Shamil Abdurakhimov,KO/TKO,100,4,0,104
Sergei Pavlovich,2022-12-03,Tai Tuivasa,KO/TKO,100,21,0,121
Sergei Pavlovich,2023-04-22,Curtis Blaydes,KO/TKO,100,22,25,147
Sergei Pavlovich,2022-07-30,Derrick Lewis,KO/TKO,100,11,0,111
Sergei Pavlovich,2019-04-20,Marcelo Golm,KO/TKO,100,12,0,112
Sergei Pavlovich,2018-11-24,Alistair Overeem,KO/TKO,0,0,0,0
Nick Thompson,2008-07-26,Jake Shields,Submission,0,0,25,25
Nick Thompson,2009-06-19,Tim Kennedy,KO/TKO,0,0,0,0
Nick Thompson,2005-11-19,Keith Wisniewski,Decision - Unanimous,80,34,0,114
Nick Thompson,2006-04-15,Karo Parisyan,KO/TKO,0,0,0,0
Daisuke Nakamura,2005-04-03,Marcus Aurelio,Decision - Unanimous,0,0,0,0
Daisuke Nakamura,2008-07-21,Andy Ologun,Submission,90,0,0,90
Daisuke Nakamura,2008-05-11,Bu-Kyung Jung,KO/TKO,100,6,0,106
Daisuke Nakamura,2006-08-27,Seichi Ikemoto,Submission,90,0,0,90
Daisuke Nakamura,2008-12-31,Hideo Tokoro,Submission,90,0,0,90
Daisuke Nakamura,2011-05-29,Katsunori Kikuno,Decision - Unanimous,0,0,0,0
Daisuke Nakamura,2009-03-08,Mitsuhiro Ishida,Decision - Unanimous,0,0,0,0
Danyelle Wolf,2022-09-10,Norma Dumont,Decision - Unanimous,0,0,0,0
Danyelle Wolf,2020-09-15,Taneisha Tennant,Decision - Unanimous,80,0,0,80
Mike French,2007-01-20,Antonio Banuelos,Decision - Unanimous,0,0,0,0
Mike French,2007-06-03,Jeff Bedard,Decision - Unanimous,0,0,0,0
Brian Ortega,2016-06-04,Clay Guida,KO/TKO,100,0,0,100
Brian Ortega,2022-07-16,Yair Rodriguez,KO/TKO,0,0,25,25
Brian Ortega,2016-01-02,Diego Brandao,Submission,90,0,0,90
Brian Ortega,2020-10-17,Chan Sung Jung,Decision - Unanimous,80,65,25,170
Brian Ortega,2018-12-08,Max Holloway,TKO - Doctor's Stoppage,0,0,25,25
Brian Ortega,2017-07-29,Renato Moicano,Submission,90,0,0,90
Brian Ortega,2024-02-24,Yair Rodriguez,Submission,90,0,25,115
Brian Ortega,2015-06-06,Thiago Tavares,KO/TKO,100,2,0,102
Brian Ortega,2018-03-03,Frankie Edgar,KO/TKO,100,0,0,100
Brian Ortega,2024-09-14,Diego Lopes,Decision - Unanimous,0,0,0,0
Brian Ortega,2017-12-09,Cub Swanson,Submission,90,0,25,115
Brian Ortega,2021-09-25,Alexander Volkanovski,Decision - Unanimous,0,0,25,25
Carlos Ulberg,2022-11-12,Nicolae Negumereanu,KO/TKO,100,12,0,112
Carlos Ulberg,2023-05-13,Ihor Potieria,KO/TKO,100,8,0,108
Carlos Ulberg,2021-03-06,Kennedy Nzechukwu,KO/TKO,0,64,0,64
Carlos Ulberg,2023-09-09,Da Woon Jung,Submission,90,23,0,113
Carlos Ulberg,2024-05-11,Alonzo Menifield,KO/TKO,100,6,0,106
Carlos Ulberg,2020-11-04,Bruno Oliveira,KO/TKO,100,3,0,103
Carlos Ulberg,2022-02-12,Fabio Cherant,Decision - Unanimous,80,53,0,133
Carlos Ulberg,2022-06-25,Tafon Nchukwi,KO/TKO,100,12,0,112
Carlos Ulberg,2024-11-23,Volkan Oezdemir,Decision - Unanimous,80,2,0,82
Edgar Chairez,2024-09-14,Joshua Van,Decision - Unanimous,0,0,0,0
Edgar Chairez,2023-07-08,Tatsuro Taira,Decision - Unanimous,0,0,0,0
Edgar Chairez,2022-08-09,Clayton Carpenter,Decision - Unanimous,0,0,0,0
Edgar Chairez,2024-02-24,Daniel Lacerda,Submission,90,5,0,95
Azat Maksum,2023-07-15,Tyson Nam,Decision - Split,70,0,0,70
Azat Maksum,2024-02-03,Charles Johnson,Decision - Unanimous,0,0,0,0
Jhonata Diniz,2024-04-27,Austen Lane,KO/TKO,100,3,0,103
Jhonata Diniz,2023-09-12,Eduardo Neves,KO/TKO,100,1,0,101
Jhonata Diniz,2024-11-16,Marcin Tybura,TKO - Doctor's Stoppage,0,0,0,0
Jhonata Diniz,2024-08-10,Karl Williams,Decision - Unanimous,80,30,0,110
Gabriel Bonfim,2024-07-13,Ange Loosa,Decision - Unanimous,80,49,0,129
Gabriel Bonfim,2023-01-21,Mounir Lazzez,Submission,90,0,0,90
Gabriel Bonfim,2023-07-29,Trevin Giles,Submission,90,2,0,92
Gabriel Bonfim,2023-11-04,Nicolas Dalby,KO/TKO,0,0,0,0
Gabriel Bonfim,2022-09-06,Trey Waters,Submission,90,6,0,96
Tristan Connelly,2019-09-14,Michel Pereira,Decision - Unanimous,80,32,0,112
Tristan Connelly,2022-04-30,Darren Elkins,Decision - Unanimous,0,0,0,0
Tristan Connelly,2021-04-24,Pat Sabatini,Decision - Unanimous,0,0,0,0
Magomed Mustafaev,2016-11-19,Kevin Lee,Submission,0,0,0,0
Magomed Mustafaev,2019-04-20,Rafael Fiziev,KO/TKO,100,9,0,109
Magomed Mustafaev,2020-02-22,Brad Riddell,Decision - Split,0,0,0,0
Magomed Mustafaev,2015-12-12,Joe Proctor,KO/TKO,100,9,0,109
Magomed Mustafaev,2015-06-20,Piotr Hallmann,TKO - Doctor's Stoppage,0,0,0,0
Greg Soto,2010-08-28,Nick Osipczak,Decision - Unanimous,80,41,0,121
Greg Soto,2011-01-01,Daniel Roberts,Submission,0,3,0,3
Greg Soto,2010-03-27,Matthew Riddle,DQ,0,0,0,0
Nick Osipczak,2010-08-28,Greg Soto,Decision - Unanimous,0,0,0,0
Nick Osipczak,2009-11-14,Matthew Riddle,KO/TKO,100,18,0,118
Nick Osipczak,2009-06-20,Frank Lester,Submission,90,6,0,96
Nick Osipczak,2010-11-13,Duane Ludwig,Decision - Split,0,0,0,0
Nick Osipczak,2010-04-10,Rick Story,Decision - Split,0,0,0,0
Carmelo Marrero,2007-05-26,Wilson Gouveia,Submission,0,0,0,0
Carmelo Marrero,2009-04-01,Ryan Bader,Decision - Unanimous,0,0,0,0
Carmelo Marrero,2006-10-14,Cheick Kongo,Decision - Split,70,0,0,70
Carmelo Marrero,2006-12-30,Gabriel Gonzaga,Submission,0,0,0,0
Carmelo Marrero,2008-11-05,Steve Steinbeiss,Decision - Split,70,0,0,70
Edward Faaloloto,2011-06-26,Michael Johnson,KO/TKO,0,0,0,0
Edward Faaloloto,2011-11-05,Terry Etim,Submission,0,0,0,0
Edward Faaloloto,2010-11-11,Anthony Njokuani,KO/TKO,0,0,0,0
Cyrille Diabate,2011-11-05,Anthony Perosh,Submission,0,0,0,0
Cyrille Diabate,2010-05-29,Luiz Cane,KO/TKO,100,13,0,113
Cyrille Diabate,2012-04-14,Tom DeBlass,Decision - Majority,75,47,0,122
Cyrille Diabate,2011-03-03,Steve Cantwell,Decision - Unanimous,80,118,0,198
Cyrille Diabate,2014-03-08,Ilir Latifi,Submission,0,0,0,0
Cyrille Diabate,2010-10-16,Alexander Gustafsson,Submission,0,0,0,0
Cyrille Diabate,2013-02-16,Jimi Manuwa,TKO - Doctor's Stoppage,0,0,0,0
Cyrille Diabate,2012-11-17,Chad Griggs,Submission,90,4,0,94
Cyrille Diabate,2006-09-10,Mauricio Rua,KO/TKO,0,0,0,0
Daron Cruickshank,2015-07-25,James Krause,Submission,0,0,0,0
Daron Cruickshank,2015-03-14,Beneil Dariush,Submission,0,0,0,0
Daron Cruickshank,2013-07-27,Yves Edwards,Decision - Split,70,0,0,70
Daron Cruickshank,2014-10-04,Anthony Njokuani,Decision - Unanimous,80,2,0,82
Daron Cruickshank,2012-12-08,Henry Martinez,KO/TKO,100,31,0,131
Daron Cruickshank,2016-01-17,Paul Felder,Submission,0,0,0,0
Daron Cruickshank,2014-01-25,Mike Rio,KO/TKO,100,36,0,136
Daron Cruickshank,2014-05-10,Erik Koch,KO/TKO,100,18,0,118
Daron Cruickshank,2013-11-09,Adriano Martins,Submission,0,0,0,0
Daron Cruickshank,2014-07-26,Jorge Masvidal,Decision - Unanimous,0,0,0,0
Daron Cruickshank,2013-03-16,John Makdessi,Decision - Unanimous,0,0,0,0
Daron Cruickshank,2012-06-01,Chris Tickle,Decision - Unanimous,80,1,0,81
Dwayne Cason,1997-10-17,Houston Dorr,KO/TKO,100,10,0,110
Dwayne Cason,1997-10-17,Mark Kerr,Submission,0,0,0,0
Houston Dorr,1997-10-17,Dwayne Cason,KO/TKO,0,0,0,0
Shinsho Anzai,2017-09-22,Luke Jumeau,Decision - Unanimous,80,2,0,82
Shinsho Anzai,2014-08-23,Alberto Mina,KO/TKO,0,0,0,0
Shinsho Anzai,2018-06-23,Jake Matthews,Submission,0,0,0,0
Shinsho Anzai,2015-09-26,Roger Zapata,TKO - Doctor's Stoppage,0,0,0,0
Kolton Englund,2021-10-26,Manuel Torres,KO/TKO,0,0,0,0
Rolando Bedoya,2023-08-26,Song Kenan,Decision - Unanimous,0,37,0,37
Rolando Bedoya,2024-08-03,Jai Herbert,Decision - Unanimous,0,0,0,0
Rolando Bedoya,2023-05-06,Khaos Williams,Decision - Split,0,19,0,19
Isis Verbeek,2023-08-22,Josefine Knutsson,Decision - Unanimous,0,0,0,0
Sanae Kikuta,2006-11-05,Jean Francois Lenogue,Decision - Unanimous,80,0,0,80
Sanae Kikuta,2000-04-14,Eugene Jackson,Submission,90,4,0,94
Sanae Kikuta,1998-03-05,Renzo Gracie,Submission,0,0,0,0
Sanae Kikuta,2002-04-28,Alexander Otsuka,Decision - Unanimous,80,1,0,81
Sanae Kikuta,2002-08-08,Antonio Rodrigo Nogueira,KO/TKO,0,0,0,0
Sanae Kikuta,2005-12-31,Makoto Takimoto,Decision - Unanimous,80,9,0,89
Jean Francois Lenogue,2006-11-05,Sanae Kikuta,Decision - Unanimous,0,13,0,13
Kim Couture,2008-11-21,Lina Kvokov,KO/TKO,100,17,0,117
Lina Kvokov,2008-11-21,Kim Couture,KO/TKO,0,0,0,0
Alvin Robinson,2008-01-23,Nate Diaz,Submission,0,0,0,0
Alvin Robinson,2008-11-15,Mark Bocek,Submission,0,0,0,0
Alvin Robinson,2007-10-20,Jorge Gurgel,Decision - Unanimous,80,41,0,121
Alvin Robinson,2007-07-07,Kenny Florian,KO/TKO,0,0,0,0
Valeri Ignatov,1999-09-24,Matt Hughes,Decision - Unanimous,0,0,0,0
Valeri Ignatov,1999-03-05,Evan Tanner,KO/TKO,0,0,0,0
Shane Carwin,2010-07-03,Brock Lesnar,Submission,0,32,25,57
Shane Carwin,2008-05-24,Christian Wellisch,KO/TKO,100,3,0,103
Shane Carwin,2011-06-11,Junior Dos Santos,Decision - Unanimous,0,0,0,0
Shane Carwin,2010-03-27,Frank Mir,KO/TKO,100,46,25,171
Shane Carwin,2008-10-18,Neil Wain,KO/TKO,100,9,0,109
Shane Carwin,2005-10-14,Carlton Jones,KO/TKO,100,6,0,106
Shane Carwin,2009-03-07,Gabriel Gonzaga,KO/TKO,100,0,0,100
David Heath,2008-02-02,Tim Boetsch,KO/TKO,0,0,0,0
David Heath,2007-04-21,Lyoto Machida,Decision - Unanimous,0,0,0,0
David Heath,2007-08-25,Renato Sobral,Submission,0,0,0,0
David Heath,2006-12-13,Victor Valimaki,Decision - Split,70,0,0,70
David Heath,2006-08-26,Cory Walmsley,Submission,90,1,0,91
Jason Day,2009-03-07,Kendall Grove,KO/TKO,0,0,0,0
Jason Day,2007-06-01,Patrick Cote,KO/TKO,0,0,25,25
Jason Day,2008-04-19,Alan Belcher,KO/TKO,100,26,0,126
Jason Day,2008-06-07,Michael Bisping,KO/TKO,0,0,0,0
Erick Gonzalez,2021-10-16,Jim Miller,KO/TKO,0,0,0,0
Erick Gonzalez,2022-08-06,Terrance McKinney,Submission,0,0,0,0
Erick Gonzalez,2023-02-25,Trevor Peek,KO/TKO,0,0,0,0
Tom Breese,2020-02-29,Brendan Allen,KO/TKO,0,0,0,0
Tom Breese,2021-01-20,Omari Akhmedov,Submission,0,0,0,0
Tom Breese,2018-05-27,Daniel Kelly,KO/TKO,100,17,0,117
Tom Breese,2020-10-10,KB Bhullar,KO/TKO,100,15,0,115
Tom Breese,2016-06-04,Sean Strickland,Decision - Split,0,0,0,0
Tom Breese,2015-10-24,Cathal Pendred,KO/TKO,100,18,0,118
Tom Breese,2016-02-27,Keita Nakamura,Decision - Unanimous,80,26,0,106
Tom Breese,2015-05-30,Luiz Dutra,KO/TKO,100,5,0,105
Pannie Kianzad,2018-11-30,Macy Chiasson,Submission,0,0,0,0
Pannie Kianzad,2019-11-09,Jessica-Rose Clark,Decision - Unanimous,80,33,0,113
Pannie Kianzad,2022-04-16,Lina Lansberg,Decision - Unanimous,80,39,0,119
Pannie Kianzad,2024-08-10,Karol Rosa,Decision - Unanimous,0,0,0,0
Pannie Kianzad,2023-07-22,Ketlen Vieira,Decision - Unanimous,0,7,0,7
Pannie Kianzad,2019-07-06,Julia Avila,Decision - Unanimous,0,0,0,0
Pannie Kianzad,2020-07-25,Bethe Correia,Decision - Unanimous,80,47,0,127
Pannie Kianzad,2020-12-19,Sijara Eubanks,Decision - Unanimous,80,43,0,123
Pannie Kianzad,2021-06-12,Alexis Davis,Decision - Unanimous,80,0,0,80
Pannie Kianzad,2024-03-16,Macy Chiasson,Submission,0,0,0,0
Pannie Kianzad,2021-09-18,Raquel Pennington,Decision - Unanimous,0,2,0,2
Marco Beltran,2017-10-07,Matt Schnell,Decision - Unanimous,0,0,0,0
Marco Beltran,2015-11-28,Guangyou Ning,Decision - Split,70,7,0,77
Marco Beltran,2017-06-03,Deiveson Figueiredo,KO/TKO,0,0,0,0
Marco Beltran,2016-07-07,Reginaldo Vieira,Submission,90,0,0,90
Marco Beltran,2016-11-05,Joe Soto,Submission,0,1,0,1
Marco Beltran,2014-11-15,Marlon Vera,Decision - Unanimous,80,6,0,86
Constantinos Philippou,2013-09-21,Francis Carmont,Decision - Unanimous,0,0,0,0
Constantinos Philippou,2011-12-10,Jared Hamman,KO/TKO,100,12,0,112
Constantinos Philippou,2011-03-19,Nick Catone,Decision - Unanimous,0,0,0,0
Constantinos Philippou,2012-12-29,Tim Boetsch,KO/TKO,100,3,0,103
Constantinos Philippou,2012-07-07,Riki Fukuda,Decision - Unanimous,80,0,0,80
Constantinos Philippou,2014-05-10,Lorenz Larkin,KO/TKO,100,0,0,100
Constantinos Philippou,2015-05-16,Gegard Mousasi,Decision - Unanimous,0,0,0,0
Constantinos Philippou,2014-01-15,Luke Rockhold,KO/TKO,0,0,25,25
Constantinos Philippou,2011-08-06,Jorge Rivera,Decision - Split,70,10,0,80
Constantinos Philippou,2012-03-02,Court McGee,Decision - Unanimous,80,2,0,82
Wuziazibieke Jiahefu,2023-05-27,Yizha,Submission,0,0,0,0
HyunSung Park,2022-10-23,Top Noi Kiwram,Submission,90,0,0,90
HyunSung Park,2023-02-04,SeungGuk Choi,Submission,90,18,0,108
HyunSung Park,2023-12-09,Shannon Ross,KO/TKO,100,3,0,103
HyunSung Park,2022-06-10,Jeremia Siregar,KO/TKO,100,18,0,118
Top Noi Kiwram,2022-10-23,HyunSung Park,Submission,0,18,0,18
Top Noi Kiwram,2022-06-10,Yuma Horiuchi,Decision - Unanimous,80,19,0,99
Top Noi Kiwram,2023-05-27,Nyamjargal Tumendemberel,Decision - Split,0,4,0,4
Calvin Kattar,2024-04-13,Aljamain Sterling,Decision - Unanimous,0,0,0,0
Calvin Kattar,2019-11-09,Zabit Magomedsharipov,Decision - Unanimous,0,0,0,0
Calvin Kattar,2019-06-08,Ricardo Lamas,KO/TKO,100,10,0,110
Calvin Kattar,2018-10-27,Chris Fishgold,KO/TKO,100,4,0,104
Calvin Kattar,2020-07-15,Dan Ige,Decision - Unanimous,80,21,25,126
Calvin Kattar,2022-10-29,Arnold Allen,KO/TKO,0,0,25,25
Calvin Kattar,2021-01-16,Max Holloway,Decision - Unanimous,0,0,25,25
Calvin Kattar,2022-01-15,Giga Chikadze,Decision - Unanimous,80,16,25,121
Calvin Kattar,2018-04-07,Renato Moicano,Decision - Unanimous,0,0,0,0
Calvin Kattar,2022-06-18,Josh Emmett,Decision - Split,0,23,25,48
Calvin Kattar,2018-01-20,Shane Burgos,KO/TKO,100,0,0,100
Calvin Kattar,2017-07-29,Andre Fili,Decision - Unanimous,80,2,0,82
Calvin Kattar,2020-05-09,Jeremy Stephens,KO/TKO,100,0,0,100
Billy Quarantillo,2019-12-07,Jacob Kilburn,Submission,90,71,0,161
Billy Quarantillo,2020-09-12,Kyle Nelson,KO/TKO,100,23,0,123
Billy Quarantillo,2019-07-23,Kamuela Kirk,KO/TKO,100,72,0,172
Billy Quarantillo,2021-11-06,Shane Burgos,Decision - Unanimous,0,0,0,0
Billy Quarantillo,2022-12-10,Alexander Hernandez,KO/TKO,100,39,0,139
Billy Quarantillo,2021-07-17,Gabriel Benitez,KO/TKO,100,43,0,143
Billy Quarantillo,2020-12-12,Gavin Tucker,Decision - Unanimous,0,0,0,0
Billy Quarantillo,2023-04-15,Edson Barboza,KO/TKO,0,0,0,0
Billy Quarantillo,2024-12-14,Cub Swanson,KO/TKO,0,0,0,0
Billy Quarantillo,2024-03-23,Youssef Zalal,Submission,0,0,0,0
Billy Quarantillo,2020-05-30,Spike Carlyle,Decision - Unanimous,80,12,0,92
Billy Quarantillo,2023-08-05,Damon Jackson,Decision - Unanimous,80,33,0,113
Jacob Kilburn,2019-12-07,Billy Quarantillo,Submission,0,0,0,0
Jacob Kilburn,2018-08-07,Bobby Moffett,Submission,0,0,0,0
Jacob Kilburn,2021-01-16,Austin Lingo,Decision - Unanimous,0,0,0,0
Amir Albazi,2022-12-17,Alessandro Costa,KO/TKO,100,20,0,120
Amir Albazi,2023-06-03,Kai Kara-France,Decision - Split,70,0,25,95
Amir Albazi,2020-07-18,Malcolm Gordon,Submission,90,9,0,99
Amir Albazi,2021-01-23,Zhalgas Zhumagulov,Decision - Unanimous,80,9,0,89
Amir Albazi,2024-11-02,Brandon Moreno,Decision - Unanimous,0,0,25,25
Amir Albazi,2022-08-20,Francisco Figueiredo,Submission,90,1,0,91
Jesse Taylor,2009-11-06,Luke Rockhold,Submission,0,1,0,1
Jesse Taylor,2017-07-07,Dhiego Lima,Submission,90,17,0,107
Jesse Taylor,2008-07-19,CB Dollaway,Submission,0,0,0,0
Jesse Taylor,2009-07-20,Dong Sik Yoon,Submission,90,2,0,92
Sherrard Blackledge,2020-11-17,Tucker Lutz,Decision - Unanimous,0,3,0,3
Sherrard Blackledge,2020-09-08,Cameron Church,Decision - Unanimous,80,14,0,94
Katsuyori Shibata,2007-09-17,Kazushi Sakuraba,Submission,0,0,0,0
Katsuyori Shibata,2009-12-31,Hiroshi Izumi,Decision - Unanimous,0,14,0,14
Katsuyori Shibata,2008-05-11,Jason Miller,KO/TKO,0,0,0,0
Katsuyori Shibata,2008-12-31,Hayato Sakurai,KO/TKO,0,0,0,0
Katsuyori Shibata,2009-10-25,Tokimitsu Ishizawa,KO/TKO,100,15,0,115
Katsuyori Shibata,2008-07-21,Yoshihiro Akiyama,Submission,0,2,0,2
Katsuyori Shibata,2009-04-05,Ikuhisa Minowa,Decision - Unanimous,80,16,0,96
Daniel Barez,2023-07-22,Jafel Filho,Submission,0,0,0,0
Daniel Barez,2021-10-05,Carlos Hernandez,Decision - Split,0,0,0,0
Daniel Barez,2024-09-28,Victor Altamirano,Decision - Unanimous,80,0,0,80
Frank Hamaker,1994-03-11,Thaddeus Luster,Submission,90,2,0,92
Thaddeus Luster,1994-03-11,Frank Hamaker,Submission,0,0,0,0
Razak Al-Hassan,2008-12-10,Steve Cantwell,Submission,0,0,0,0
Razak Al-Hassan,2009-10-24,Kyle Kingsbury,Decision - Split,0,6,0,6
Josh Fremd,2024-07-13,Andre Petroski,Decision - Unanimous,0,4,0,4
Josh Fremd,2023-08-12,Jamie Pickett,Decision - Unanimous,80,17,0,97
Josh Fremd,2022-04-09,Anthony Hernandez,Decision - Unanimous,0,0,0,0
Josh Fremd,2023-09-16,Roman Kopylov,KO/TKO,0,0,0,0
Josh Fremd,2022-10-29,Tresean Gore,Submission,0,14,0,14
Josh Fremd,2023-03-11,Sedriques Dumas,Submission,90,13,0,103
Victor Valimaki,2007-04-21,Alessio Sakara,KO/TKO,0,0,0,0
Victor Valimaki,2006-12-13,David Heath,Decision - Split,0,22,0,22
Chris Brennan,2003-10-05,Eiji Mitsuoka,Submission,90,5,0,95
Chris Brennan,1999-10-30,Joe Stevenson,Submission,90,1,0,91
Chris Brennan,2006-08-27,Tatsuya Kawajiri,KO/TKO,0,0,0,0
Chris Brennan,2002-01-11,Gil Castillo,Decision - Unanimous,0,0,0,0
Chris Brennan,2004-02-15,Daiju Takase,Decision - Unanimous,0,0,0,0
Chris Brennan,1998-03-13,Pat Miletich,Submission,0,0,0,0
Eiji Mitsuoka,2003-10-05,Chris Brennan,Submission,0,0,0,0
Eiji Mitsuoka,2012-08-11,Nik Lentz,KO/TKO,0,0,0,0
Eiji Mitsuoka,2012-02-25,Takanori Gomi,KO/TKO,0,0,0,0
Eiji Mitsuoka,2011-07-16,Bruno Carvalho,Decision - Unanimous,80,5,0,85
Carlos Eduardo Rocha,2010-11-13,Kris McCray,Submission,90,0,0,90
Carlos Eduardo Rocha,2011-02-05,Jake Ellenberger,Decision - Split,0,0,0,0
Carlos Eduardo Rocha,2012-06-08,Mike Pierce,Decision - Unanimous,0,0,0,0
Kris McCray,2010-11-13,Carlos Eduardo Rocha,Submission,0,1,0,1
Kris McCray,2010-06-19,Court McGee,Submission,0,0,0,0
Kris McCray,2011-03-26,John Hathaway,Decision - Split,0,5,0,5
Hiroyuki Takaya,2010-05-29,Joachim Hansen,KO/TKO,100,0,0,100
Hiroyuki Takaya,2009-03-08,Jong Won Kim,KO/TKO,100,26,0,126
Hiroyuki Takaya,2009-05-26,Yoshiro Maeda,KO/TKO,100,0,0,100
Hiroyuki Takaya,2008-02-13,Leonard Garcia,KO/TKO,0,0,0,0
Hiroyuki Takaya,2011-07-16,Kazuyuki Miyata,Decision - Split,70,0,0,70
Hiroyuki Takaya,2009-10-06,Bibiano Fernandes,Decision - Split,0,0,0,0
Hiroyuki Takaya,2009-10-06,Hideo Tokoro,KO/TKO,100,23,0,123
Hiroyuki Takaya,2011-04-09,Robert Peralta,Decision - Split,0,0,0,0
Hiroyuki Takaya,2009-12-31,Michihiro Omigawa,KO/TKO,0,0,0,0
Hiroyuki Takaya,2011-12-31,Takeshi Inoue,Decision - Unanimous,80,71,25,176
Hiroyuki Takaya,2010-12-31,Bibiano Fernandes,Decision - Unanimous,80,12,0,92
Hiroyuki Takaya,2008-12-03,Cub Swanson,Decision - Unanimous,0,0,0,0
Hiroyuki Takaya,2010-09-25,Chase Beebe,KO/TKO,100,3,0,103
Hiroyuki Takaya,2012-12-31,Georgi Karakhanyan,Decision - Split,0,0,0,0
Jessin Ayari,2020-10-03,Luigi Vendramini,KO/TKO,0,0,0,0
Jessin Ayari,2016-09-03,Jim Wallhead,Decision - Split,70,23,0,93
Jessin Ayari,2018-10-27,Stevie Ray,Decision - Unanimous,0,0,0,0
Jessin Ayari,2017-05-28,Darren Till,Decision - Unanimous,0,0,0,0
Marcelo Aguiar,2000-06-09,Matt Hughes,TKO - Doctor's Stoppage,0,0,0,0
Tra Telligman,2001-03-25,Igor Vovchanchyn,Decision - Unanimous,80,0,0,80
Tra Telligman,1997-02-07,Vitor Belfort,KO/TKO,0,0,0,0
Tra Telligman,2003-06-06,Pedro Rizzo,TKO - Doctor's Stoppage,0,0,0,0
Tra Telligman,1999-05-07,Pedro Rizzo,KO/TKO,0,7,0,7
Tra Telligman,2000-06-04,Carlos Barreto,Decision - Unanimous,0,0,0,0
Tra Telligman,2005-08-20,Tim Sylvia,KO/TKO,0,0,0,0
Tra Telligman,1997-12-21,Brad Kohler,Submission,90,0,0,90
Kengo Ura,2003-03-27,Mike Swick,KO/TKO,0,0,0,0
Katsuhiko Nagata,2008-03-15,Artur Oumakhanov,Decision - Unanimous,80,7,0,87
Katsuhiko Nagata,2009-04-05,Vitor Ribeiro,TKO - Doctor's Stoppage,0,0,0,0
Katsuhiko Nagata,2008-06-15,Shinya Aoki,Submission,0,0,0,0
Katsuhiko Nagata,2006-05-03,Yoshihiro Akiyama,KO/TKO,0,0,0,0
Artur Oumakhanov,2008-03-15,Katsuhiko Nagata,Decision - Unanimous,0,0,0,0
Junior Albini,2017-07-22,Timothy Johnson,KO/TKO,100,2,0,102
Junior Albini,2019-06-29,Maurice Greene,KO/TKO,0,0,0,0
Junior Albini,2017-11-11,Andrei Arlovski,Decision - Unanimous,0,0,0,0
Junior Albini,2019-02-02,Jairzinho Rozenstruik,KO/TKO,0,0,0,0
Junior Albini,2018-05-12,Aleksei Oleinik,Submission,0,0,0,0
Kevin Gray,2017-08-08,Alex Perez,Submission,0,0,0,0
Daniel Acacio,2005-07-17,Kazuo Misaki,Decision - Unanimous,80,8,0,88
Daniel Acacio,2007-12-06,Rousimar Palhares,Submission,0,0,0,0
Daniel Acacio,2005-09-25,Akihiro Gono,Decision - Unanimous,0,0,0,0
Daniel Acacio,2005-04-03,Daiju Takase,KO/TKO,100,36,0,136
Nick Maximov,2021-09-25,Cody Brundage,Decision - Unanimous,80,0,0,80
Nick Maximov,2022-05-14,Andre Petroski,Submission,0,3,0,3
Nick Maximov,2022-02-05,Punahele Soriano,Decision - Split,70,0,0,70
Nick Maximov,2022-10-15,Jacob Malkoun,Decision - Unanimous,0,0,0,0
Nick Maximov,2020-11-17,Oscar Cota,Decision - Unanimous,80,32,0,112
Matt Frevola,2024-09-28,Fares Ziam,KO/TKO,0,0,0,0
Matt Frevola,2021-06-12,Terrance McKinney,KO/TKO,0,0,0,0
Matt Frevola,2019-10-12,Luis Pena,Decision - Split,70,0,0,70
Matt Frevola,2017-08-29,Luke Flores,Submission,90,2,0,92
Matt Frevola,2023-11-11,Benoit Saint Denis,KO/TKO,0,0,0,0
Matt Frevola,2021-01-23,Arman Tsarukyan,Decision - Unanimous,0,0,0,0
Matt Frevola,2022-01-22,Genaro Valdez,KO/TKO,100,50,0,150
Matt Frevola,2018-01-14,Marco Polo Reyes,KO/TKO,0,0,0,0
Matt Frevola,2022-11-12,Ottman Azaitar,KO/TKO,100,1,0,101
Matt Frevola,2023-05-06,Drew Dober,KO/TKO,100,15,0,115
Matt Frevola,2019-04-13,Jalin Turner,Decision - Unanimous,80,0,0,80
Viviane Pereira,2018-06-23,Yan Xiaonan,Decision - Unanimous,0,0,0,0
Viviane Pereira,2016-12-10,Valerie Letourneau,Decision - Split,70,0,0,70
Viviane Pereira,2017-11-11,Tatiana Suarez,Decision - Unanimous,0,0,0,0
Viviane Pereira,2017-06-03,Jamie Moyle,Decision - Unanimous,80,0,0,80
Junior Assuncao,2011-09-24,Eddie Yagin,Decision - Unanimous,80,53,0,133
Junior Assuncao,2007-09-19,Nate Diaz,Submission,0,0,0,0
Junior Assuncao,2006-10-14,Kurt Pellegrino,Submission,0,0,0,0
Junior Assuncao,2007-04-21,David Lee,Submission,90,17,0,107
Junior Assuncao,2011-12-30,Ross Pearson,Decision - Unanimous,0,0,0,0
Mike Easton,2011-10-01,Byron Bloodworth,KO/TKO,100,14,0,114
Mike Easton,2012-12-08,Raphael Assuncao,Decision - Unanimous,0,0,0,0
Mike Easton,2012-01-20,Jared Papazian,Decision - Majority,75,17,0,92
Mike Easton,2014-06-14,Yves Jabouin,Decision - Unanimous,0,0,0,0
Mike Easton,2014-01-15,TJ Dillashaw,Decision - Unanimous,0,0,0,0
Mike Easton,2013-04-06,Brad Pickett,Decision - Split,0,3,0,3
Mike Easton,2012-07-07,Ivan Menjivar,Decision - Unanimous,80,6,0,86
Julio Arce,2019-11-02,Hakeem Dawodu,Decision - Split,0,0,0,0
Julio Arce,2021-07-24,Andre Ewell,KO/TKO,100,11,0,111
Julio Arce,2022-11-12,Montel Jackson,Decision - Unanimous,0,0,0,0
Julio Arce,2018-06-01,Daniel Teymur,Submission,90,26,0,116
Julio Arce,2024-03-30,Herbert Burns,KO/TKO,100,14,0,114
Julio Arce,2021-11-13,Song Yadong,KO/TKO,0,0,0,0
Julio Arce,2018-01-20,Dan Ige,Decision - Unanimous,80,37,0,117
Julio Arce,2018-11-03,Sheymon Moraes,Decision - Split,0,0,0,0
Julio Arce,2022-04-09,Daniel Santos,Decision - Unanimous,80,78,0,158
Julio Arce,2019-05-18,Julian Erosa,KO/TKO,100,31,0,131
Julio Arce,2017-08-08,Peter Petties,KO/TKO,100,43,0,143
Donnie Liles,2008-10-03,Pete Spratt,Submission,90,6,0,96
Jake Matthews,2022-06-11,Andre Fialho,KO/TKO,100,29,0,129
Jake Matthews,2024-06-01,Phil Rowe,Decision - Unanimous,80,32,0,112
Jake Matthews,2016-07-08,Kevin Lee,KO/TKO,0,0,0,0
Jake Matthews,2018-06-23,Shinsho Anzai,Submission,90,11,0,101
Jake Matthews,2021-03-06,Sean Brady,Submission,0,0,0,0
Jake Matthews,2023-07-29,Darrius Flowers,Submission,90,24,0,114
Jake Matthews,2016-03-19,Johnny Case,Submission,90,1,0,91
Jake Matthews,2023-11-18,Michael Morales,Decision - Unanimous,0,0,0,0
Jake Matthews,2020-09-26,Diego Sanchez,Decision - Unanimous,80,47,0,127
Jake Matthews,2014-06-28,Dashon Johnson,Submission,90,49,0,139
Jake Matthews,2018-12-01,Anthony Rocco Martin,Submission,0,0,0,0
Jake Matthews,2022-12-17,Matthew Semelsberger,Decision - Unanimous,0,0,0,0
Jake Matthews,2015-05-09,James Vick,Submission,0,0,0,0
Jake Matthews,2020-02-22,Emil Meek,Decision - Unanimous,80,0,0,80
Jake Matthews,2017-11-18,Bojan Velickovic,Decision - Split,70,0,0,70
Jake Matthews,2014-11-07,Vagner Rocha,Submission,90,12,0,102
Jake Matthews,2019-10-05,Rostem Akman,Decision - Unanimous,80,44,0,124
Jake Matthews,2015-11-14,Akbarh Arreola,TKO - Doctor's Stoppage,0,41,0,41
Jake Matthews,2018-02-10,Li Jingliang,Decision - Unanimous,80,14,0,94
Jake Matthews,2016-11-26,Andrew Holbrook,Decision - Split,0,0,0,0
Andre Fialho,2022-06-11,Jake Matthews,KO/TKO,0,0,0,0
Andre Fialho,2022-11-19,Muslim Salikhov,KO/TKO,0,0,0,0
Andre Fialho,2023-09-23,Tim Means,KO/TKO,0,0,0,0
Andre Fialho,2022-04-16,Miguel Baeza,KO/TKO,100,8,0,108
Andre Fialho,2023-05-20,Joaquin Buckley,KO/TKO,0,0,0,0
Andre Fialho,2022-01-22,Michel Pereira,Decision - Unanimous,0,0,0,0
Andre Fialho,2022-05-07,Cameron VanCamp,KO/TKO,100,0,0,100
Tyler Hill,2018-06-19,Dwight Grant,KO/TKO,0,0,0,0
Irene Aldana,2016-12-17,Leslie Smith,Decision - Unanimous,0,0,0,0
Irene Aldana,2019-12-14,Ketlen Vieira,KO/TKO,100,6,0,106
Irene Aldana,2019-09-21,Vanessa Melo,Decision - Unanimous,80,57,0,137
Irene Aldana,2018-09-08,Lucie Pudilova,Decision - Split,70,14,0,84
Irene Aldana,2022-09-10,Macy Chiasson,KO/TKO,100,0,0,100
Irene Aldana,2019-05-11,Bethe Correia,Submission,90,2,0,92
Irene Aldana,2018-01-14,Talita Bernardo,Decision - Unanimous,80,24,0,104
Irene Aldana,2023-06-10,Amanda Nunes,Decision - Unanimous,0,0,25,25
Irene Aldana,2023-12-16,Karol Rosa,Decision - Unanimous,80,0,0,80
Irene Aldana,2021-07-10,Yana Santos,KO/TKO,100,13,0,113
Irene Aldana,2017-04-08,Katlyn Cerminara,Decision - Split,0,0,0,0
Irene Aldana,2024-09-14,Norma Dumont,Decision - Unanimous,0,0,0,0
Irene Aldana,2019-07-20,Raquel Pennington,Decision - Split,0,5,0,5
Irene Aldana,2020-10-03,Holly Holm,Decision - Unanimous,0,0,25,25
Renato Moicano,2017-04-15,Jeremy Stephens,Decision - Split,70,14,0,84
Renato Moicano,2020-12-12,Rafael Fiziev,KO/TKO,0,0,0,0
Renato Moicano,2014-12-20,Tom Niinimaki,Submission,90,15,0,105
Renato Moicano,2020-03-14,Damir Hadzovic,Submission,90,0,0,90
Renato Moicano,2019-06-22,Chan Sung Jung,KO/TKO,0,0,25,25
Renato Moicano,2018-04-07,Calvin Kattar,Decision - Unanimous,80,75,0,155
Renato Moicano,2016-05-14,Zubaira Tukhugov,Decision - Split,70,15,0,85
Renato Moicano,2022-03-05,Rafael Dos Anjos,Decision - Unanimous,0,0,25,25
Renato Moicano,2024-09-28,Benoit Saint Denis,TKO - Doctor's Stoppage,0,25,25,50
Renato Moicano,2024-02-03,Drew Dober,Decision - Unanimous,80,0,0,80
Renato Moicano,2018-08-04,Cub Swanson,Submission,90,0,0,90
Renato Moicano,2017-07-29,Brian Ortega,Submission,0,44,0,44
Renato Moicano,2021-06-26,Jai Herbert,Submission,90,19,0,109
Renato Moicano,2019-02-02,Jose Aldo,KO/TKO,0,0,0,0
Renato Moicano,2022-02-12,Alexander Hernandez,Submission,90,0,0,90
Renato Moicano,2022-11-12,Brad Riddell,Submission,90,0,0,90
Renato Moicano,2024-04-13,Jalin Turner,KO/TKO,100,20,0,120
Maurice Greene,2020-10-31,Greg Hardy,KO/TKO,0,0,0,0
Maurice Greene,2019-10-26,Sergei Pavlovich,KO/TKO,0,0,0,0
Maurice Greene,2019-03-09,Jeff Hughes,Decision - Split,70,4,0,74
Maurice Greene,2020-06-27,Gian Villante,Submission,90,0,0,90
Maurice Greene,2019-06-29,Junior Albini,KO/TKO,100,18,0,118
Maurice Greene,2018-11-30,Michel Batista,Submission,90,9,0,99
Maurice Greene,2020-01-18,Aleksei Oleinik,Submission,0,6,0,6
Maurice Greene,2021-05-08,Marcos Rogerio de Lima,Decision - Unanimous,0,0,0,0
Sirwan Kakai,2015-08-08,Frankie Saenz,Decision - Split,0,0,0,0
Sirwan Kakai,2015-06-27,Danny Martinez,Decision - Unanimous,80,0,0,80
Tatsuya Mizuno,2010-09-25,Gegard Mousasi,Submission,0,0,0,0
Tatsuya Mizuno,2007-02-28,Thiago Silva,KO/TKO,0,0,0,0
Tatsuya Mizuno,2011-07-16,Trevor Prangley,KO/TKO,100,5,0,105
Tatsuya Mizuno,2008-03-15,Mirko Filipovic,KO/TKO,0,0,0,0
Tatsuya Mizuno,2010-12-31,Sergei Kharitonov,KO/TKO,0,0,0,0
Tatsuya Mizuno,2010-07-10,Melvin Manhoef,Submission,90,1,0,91
Vince Morales,2018-11-24,Song Yadong,Decision - Unanimous,0,0,0,0
Vince Morales,2024-09-28,Taylor Lapilus,Decision - Unanimous,0,0,0,0
Vince Morales,2019-05-04,Aiemann Zahabi,Decision - Unanimous,80,31,0,111
Vince Morales,2018-07-17,Domingo Pilarte,Submission,0,20,0,20
Vince Morales,2022-11-19,Miles Johns,Decision - Unanimous,0,1,0,1
Vince Morales,2021-08-07,Drako Rodriguez,Decision - Unanimous,80,21,0,101
Vince Morales,2019-07-13,Benito Lopez,Decision - Unanimous,0,10,0,10
Vince Morales,2022-05-21,Jonathan Martinez,Decision - Unanimous,0,0,0,0
Vince Morales,2020-05-30,Chris Gutierrez,KO/TKO,0,0,0,0
Vince Morales,2021-12-04,Louis Smolka,KO/TKO,100,4,0,104
TJ Brown,2021-05-01,Kai Kamaka,Decision - Split,70,21,0,91
TJ Brown,2023-04-15,Bill Algeo,Submission,0,0,0,0
TJ Brown,2020-02-29,Jordan Griffin,Submission,0,17,0,17
TJ Brown,2020-08-15,Danny Chavez,Decision - Unanimous,0,0,0,0
TJ Brown,2022-01-15,Charles Rosa,Decision - Unanimous,80,12,0,92
TJ Brown,2023-10-14,Darren Elkins,Submission,0,4,0,4
TJ Brown,2022-12-10,Erik Silva,Submission,90,3,0,93
TJ Brown,2022-06-25,Shayilan Nuerdanbieke,Decision - Unanimous,0,0,0,0
TJ Brown,2019-08-27,Dylan Lockard,Submission,90,26,0,116
Kai Kamaka,2021-05-01,TJ Brown,Decision - Split,0,0,0,0
Kai Kamaka,2020-08-15,Tony Kelley,Decision - Unanimous,80,0,0,80
Kai Kamaka,2020-11-28,Jonathan Pearce,KO/TKO,0,0,0,0
Jodie Esquibel,2017-10-21,Karolina Kowalkiewicz,Decision - Unanimous,0,0,0,0
Jodie Esquibel,2019-04-27,Angela Hill,Decision - Unanimous,0,0,0,0
Jodie Esquibel,2019-08-17,Hannah Cifers,Decision - Unanimous,0,0,0,0
Jodie Esquibel,2018-07-14,Jessica Aguilar,Decision - Unanimous,0,0,0,0
Ignacio Bahamondes,2023-04-08,Trey Ogden,Decision - Unanimous,80,57,0,137
Ignacio Bahamondes,2021-08-21,Roosevelt Roberts,KO/TKO,100,50,0,150
Ignacio Bahamondes,2021-04-10,John Makdessi,Decision - Split,0,0,0,0
Ignacio Bahamondes,2024-04-06,Christos Giagos,KO/TKO,100,23,0,123
Ignacio Bahamondes,2022-02-26,Rongzhu,Submission,90,78,0,168
Ignacio Bahamondes,2023-08-05,Ludovit Klein,Decision - Unanimous,0,0,0,0
Ignacio Bahamondes,2024-09-14,Manuel Torres,KO/TKO,100,11,0,111
Ignacio Bahamondes,2020-11-04,Edson Gomez,KO/TKO,100,46,0,146
Victor Martinez,2021-09-21,Jacob Rosales,Decision - Unanimous,80,31,0,111
Victor Martinez,2024-05-18,Tom Nolan,KO/TKO,0,0,0,0
Victor Martinez,2023-02-25,Jordan Leavitt,KO/TKO,0,0,0,0
JJ Okanovich,2019-07-23,Christian Lohsen,Decision - Unanimous,80,25,0,105
Christian Lohsen,2019-07-23,JJ Okanovich,Decision - Unanimous,0,0,0,0
Justin Gaethje,2018-08-25,James Vick,KO/TKO,100,0,25,125
Justin Gaethje,2020-05-09,Tony Ferguson,KO/TKO,100,7,25,132
Justin Gaethje,2024-04-13,Max Holloway,KO/TKO,0,0,25,25
Justin Gaethje,2023-07-29,Dustin Poirier,KO/TKO,100,14,25,139
Justin Gaethje,2018-04-14,Dustin Poirier,KO/TKO,0,0,25,25
Justin Gaethje,2019-03-30,Edson Barboza,KO/TKO,100,7,25,132
Justin Gaethje,2021-11-06,Michael Chandler,Decision - Unanimous,80,13,0,93
Justin Gaethje,2023-03-18,Rafael Fiziev,Decision - Majority,75,6,0,81
Justin Gaethje,2022-05-07,Charles Oliveira,Submission,0,0,25,25
Justin Gaethje,2020-10-24,Khabib Nurmagomedov,Submission,0,3,25,28
Justin Gaethje,2019-09-14,Donald Cerrone,KO/TKO,100,23,25,148
Justin Gaethje,2017-12-02,Eddie Alvarez,KO/TKO,0,0,0,0
Justin Gaethje,2017-07-07,Michael Johnson,KO/TKO,100,13,25,138
Ryan Jensen,2009-09-16,Steve Steinbeiss,Submission,90,2,0,92
Ryan Jensen,2008-03-29,Joey Villasenor,KO/TKO,0,1,0,1
Ryan Jensen,2011-04-30,Jason MacDonald,Submission,0,0,0,0
Ryan Jensen,2007-10-20,Demian Maia,Submission,0,0,0,0
Ryan Jensen,2010-05-29,Jesse Forbes,Submission,90,0,0,90
Ryan Jensen,2007-08-25,Thales Leites,Submission,0,1,0,1
Ryan Jensen,2010-10-23,Court McGee,Submission,0,0,0,0
Ryan Jensen,2008-09-17,Wilson Gouveia,Submission,0,22,0,22
Ryan Jensen,2010-01-02,Mark Munoz,KO/TKO,0,0,0,0
Steve Steinbeiss,2009-09-16,Ryan Jensen,Submission,0,0,0,0
Steve Steinbeiss,2010-08-01,Rob Kimmons,Decision - Unanimous,0,47,0,47
Steve Steinbeiss,2008-11-05,Carmelo Marrero,Decision - Split,0,25,0,25
Anthony Lapsley,2014-05-10,Albert Tumenov,KO/TKO,0,0,0,0
Anthony Lapsley,2013-11-16,Jason High,Decision - Unanimous,0,3,0,3
Dustin Hazelett,2007-02-03,Diego Saraiva,Decision - Unanimous,80,30,0,110
Dustin Hazelett,2010-01-02,Paul Daley,KO/TKO,0,0,0,0
Dustin Hazelett,2008-11-15,Tamdan McCrory,Submission,90,0,0,90
Dustin Hazelett,2010-12-11,Mark Bocek,Submission,0,0,0,0
Dustin Hazelett,2007-09-19,Jonathan Goulet,Submission,90,3,0,93
Dustin Hazelett,2008-03-01,Josh Koscheck,KO/TKO,0,0,0,0
Dustin Hazelett,2008-06-21,Joshua Burkman,Submission,90,0,0,90
Dustin Hazelett,2007-06-16,Stevie Lynch,Submission,90,13,0,103
Dustin Hazelett,2010-08-07,Rick Story,KO/TKO,0,0,0,0
Dustin Hazelett,2006-10-10,Tony DeSouza,Submission,0,0,0,0
Diego Saraiva,2007-02-03,Dustin Hazelett,Decision - Unanimous,0,0,0,0
Diego Saraiva,2007-07-07,Jorge Gurgel,Decision - Unanimous,0,0,0,0
Diego Saraiva,2007-09-22,Jeremy Stephens,Decision - Unanimous,0,0,0,0
Jake Hecht,2011-12-10,Rich Attonito,KO/TKO,100,16,0,116
Jake Hecht,2012-06-08,Sean Pierson,Decision - Unanimous,0,0,0,0
Jake Hecht,2012-03-02,TJ Waldburger,Submission,0,0,0,0
JunYong Park,2022-10-29,Joseph Holmes,Submission,90,0,0,90
JunYong Park,2019-12-21,Marc-Andre Barriault,Decision - Unanimous,80,26,0,106
JunYong Park,2023-02-04,Denis Tiuliulin,Submission,90,17,0,107
JunYong Park,2021-05-08,Tafon Nchukwi,Decision - Majority,75,13,0,88
JunYong Park,2021-10-23,Gregory Rodrigues,KO/TKO,0,0,0,0
JunYong Park,2019-08-31,Anthony Hernandez,Submission,0,22,0,22
JunYong Park,2024-10-12,Brad Tavares,Decision - Split,70,34,0,104
JunYong Park,2023-07-15,Albert Duraev,Submission,90,19,0,109
JunYong Park,2020-10-17,John Phillips,Decision - Unanimous,80,5,0,85
JunYong Park,2022-05-21,Eryk Anders,Decision - Split,70,40,0,110
JunYong Park,2023-12-09,Andre Muniz,Decision - Split,0,13,0,13
Brad Scott,2012-12-14,Robert Whittaker,Decision - Unanimous,0,0,0,0
Brad Scott,2017-08-05,Jack Hermansson,KO/TKO,0,0,0,0
Brad Scott,2015-05-09,Dylan Andrews,Submission,90,17,0,107
Brad Scott,2017-03-18,Scott Askham,Decision - Split,70,0,0,70
Brad Scott,2014-03-08,Claudio Silva,Decision - Unanimous,0,5,0,5
Brad Scott,2013-10-26,Michael Kuiper,Submission,90,7,0,97
Brad Scott,2018-05-27,Carlo Pedersoli Jr.,Decision - Split,0,0,0,0
Brad Scott,2016-02-27,Krzysztof Jotko,Decision - Unanimous,0,0,0,0
Lara Procopio,2021-06-19,Casey O'Neill,Submission,0,0,0,0
Lara Procopio,2021-02-06,Molly McCann,Decision - Unanimous,80,0,0,80
Lara Procopio,2019-08-31,Karol Rosa,Decision - Split,0,0,0,0
Tor Troeng,2013-09-04,Rafael Natal,Decision - Unanimous,0,0,0,0
Tor Troeng,2014-07-19,Trevor Smith,Decision - Unanimous,0,0,0,0
Tor Troeng,2013-04-06,Adam Cella,Submission,90,4,0,94
Tor Troeng,2014-10-04,Krzysztof Jotko,Decision - Unanimous,0,0,0,0
Carl Malenko,1999-09-12,Wanderlei Silva,Decision - Unanimous,0,0,0,0
Carl Malenko,1999-07-04,Egan Inoue,Decision - Unanimous,80,1,0,81
Carl Malenko,1999-11-21,Allan Goes,Submission,0,0,0,0
Valmir Lazaro,2015-11-21,Michel Prazeres,Decision - Split,0,21,0,21
Valmir Lazaro,2015-02-28,James Krause,Decision - Split,70,0,0,70
Valmir Lazaro,2014-08-23,James Vick,Decision - Unanimous,0,14,0,14
Jim Wallhead,2016-09-03,Jessin Ayari,Decision - Split,0,0,0,0
Jim Wallhead,2017-06-03,Luan Chagas,Submission,0,0,0,0
Emily Kagan,2014-12-12,Angela Hill,Decision - Unanimous,0,0,0,0
Emily Kagan,2015-12-10,Kailin Curran,Submission,0,1,0,1
Beneil Dariush,2015-03-14,Daron Cruickshank,Submission,90,10,0,100
Beneil Dariush,2015-08-08,Michael Johnson,Decision - Split,70,0,0,70
Beneil Dariush,2021-05-15,Tony Ferguson,Decision - Unanimous,80,8,0,88
Beneil Dariush,2020-08-08,Scott Holtzman,KO/TKO,100,27,0,127
Beneil Dariush,2014-04-11,Ramsey Nijem,KO/TKO,0,0,0,0
Beneil Dariush,2021-02-06,Diego Ferreira,Decision - Split,70,8,0,78
Beneil Dariush,2017-03-11,Edson Barboza,KO/TKO,0,21,0,21
Beneil Dariush,2019-10-26,Frank Camacho,Submission,90,10,0,100
Beneil Dariush,2023-12-02,Arman Tsarukyan,KO/TKO,0,0,25,25
Beneil Dariush,2018-03-03,Alexander Hernandez,KO/TKO,0,0,0,0
Beneil Dariush,2019-03-09,Drew Dober,Submission,90,6,0,96
Beneil Dariush,2020-03-07,Drakkar Klose,KO/TKO,100,0,0,100
Beneil Dariush,2014-10-25,Diego Ferreira,Decision - Unanimous,80,11,0,91
Beneil Dariush,2014-01-15,Charlie Brenneman,Submission,90,4,0,94
Beneil Dariush,2022-10-22,Mateusz Gamrot,Decision - Unanimous,80,26,0,106
Beneil Dariush,2016-04-16,Michael Chiesa,Submission,0,16,0,16
Beneil Dariush,2014-08-23,Anthony Rocco Martin,Submission,90,0,0,90
Beneil Dariush,2023-06-10,Charles Oliveira,KO/TKO,0,0,0,0
Beneil Dariush,2016-06-04,James Vick,KO/TKO,100,37,0,137
Beneil Dariush,2015-04-18,Jim Miller,Decision - Unanimous,80,16,0,96
Beneil Dariush,2018-11-10,Thiago Moises,Decision - Unanimous,80,36,0,116
Beneil Dariush,2016-11-05,Rashid Magomedov,Decision - Unanimous,80,19,0,99
Andy Ogle,2013-02-16,Josh Grispi,Decision - Unanimous,80,12,0,92
Andy Ogle,2012-09-29,Akira Corassani,Decision - Split,0,7,0,7
Andy Ogle,2014-02-15,Charles Oliveira,Submission,0,0,0,0
Andy Ogle,2015-01-24,Makwan Amirkhani,KO/TKO,0,0,0,0
Andy Ogle,2014-05-31,Maximo Blanco,Decision - Unanimous,0,0,0,0
Andy Ogle,2013-10-26,Cole Miller,Decision - Unanimous,0,6,0,6
Josh Grispi,2013-02-16,Andy Ogle,Decision - Unanimous,0,0,0,0
Josh Grispi,2011-01-01,Dustin Poirier,Decision - Unanimous,0,0,0,0
Josh Grispi,2012-08-04,Rani Yahya,Submission,0,3,0,3
Josh Grispi,2010-06-20,LC Davis,Submission,90,8,0,98
Josh Grispi,2008-08-03,Micah Miller,KO/TKO,100,11,0,111
Josh Grispi,2009-06-07,Jens Pulver,Submission,90,1,0,91
Josh Grispi,2011-06-04,George Roop,KO/TKO,0,0,0,0
Josh Grispi,2008-02-13,Mark Hominick,Submission,90,9,0,99
Makhmud Muradov,2019-09-28,Alessio Di Chirico,Decision - Unanimous,80,18,0,98
Makhmud Muradov,2023-07-22,Bryan Barberena,Decision - Unanimous,80,26,0,106
Makhmud Muradov,2019-12-07,Trevor Smith,KO/TKO,100,52,0,152
Makhmud Muradov,2021-01-23,Andrew Sanchez,KO/TKO,100,31,0,131
Makhmud Muradov,2022-10-22,Caio Borralho,Decision - Unanimous,0,0,0,0
Makhmud Muradov,2021-08-28,Gerald Meerschaert,Submission,0,8,0,8
Yuya Shirai,2009-04-05,Jason High,Submission,0,0,0,0
Reuben Duran,2011-03-03,Takeya Mizugaki,Decision - Split,0,24,0,24
Reuben Duran,2013-03-16,George Roop,Decision - Unanimous,0,0,0,0
Reuben Duran,2012-12-15,Hugo Viana,KO/TKO,0,0,0,0
Reuben Duran,2011-06-04,Francisco Rivera,Submission,90,20,0,110
Mario Sperry,2002-04-28,Murilo Rua,Decision - Unanimous,0,0,0,0
Mario Sperry,2006-02-26,Tsuyoshi Kohsaka,KO/TKO,0,4,0,4
Mario Sperry,2004-02-15,Mike Bencic,KO/TKO,100,4,0,104
Mario Sperry,2001-11-03,Igor Vovchanchyn,Submission,90,0,0,90
Mario Sperry,2003-12-31,Yuki Kondo,TKO - Doctor's Stoppage,0,0,0,0
Mario Sperry,2005-02-20,Hirotaka Yokoi,KO/TKO,100,52,0,152
Mario Sperry,2002-09-29,Andrei Kopylov,TKO - Doctor's Stoppage,0,24,0,24
Sheldon Westcott,2016-01-02,Edgar Garcia,KO/TKO,100,32,0,132
Sheldon Westcott,2015-04-11,Pawel Pawlak,Decision - Unanimous,0,0,0,0
Sheldon Westcott,2014-04-16,Elias Theodorou,KO/TKO,0,0,0,0
Edgar Garcia,2016-01-02,Sheldon Westcott,KO/TKO,0,0,0,0
Edgar Garcia,2009-01-25,Hiromitsu Miura,KO/TKO,100,15,0,115
Edgar Garcia,2009-12-12,DaMarques Johnson,Submission,0,7,0,7
Edgar Garcia,2014-11-15,Hector Urbina,Submission,0,8,0,8
Edgar Garcia,2009-06-20,Brad Blackburn,Decision - Split,0,0,0,0
Dean Lister,2005-04-03,Akira Shoji,Submission,90,4,0,94
Dean Lister,2006-08-17,Yuki Sasaki,Decision - Unanimous,80,0,0,80
Dean Lister,2007-12-29,Jordan Radev,Decision - Unanimous,80,11,0,91
Dean Lister,2007-01-25,Nate Marquardt,Decision - Unanimous,0,0,0,0
Dean Lister,2005-04-23,Ricardo Arona,Decision - Unanimous,0,0,0,0
Dean Lister,2008-06-21,Jeremy Horn,Submission,90,4,0,94
Dean Lister,2004-07-19,Amar Suloev,Decision - Split,0,0,0,0
Dean Lister,2008-12-27,Yushin Okami,Decision - Unanimous,0,0,0,0
Dean Lister,2006-05-27,Alessio Sakara,Submission,90,0,0,90
Zach Makovsky,2016-12-10,Dustin Ortiz,Decision - Split,0,0,0,0
Zach Makovsky,2014-08-16,Jussier Formiga,Decision - Unanimous,0,14,0,14
Zach Makovsky,2016-02-06,Joseph Benavidez,Decision - Unanimous,0,0,0,0
Zach Makovsky,2015-02-14,Tim Elliott,Decision - Unanimous,80,0,0,80
Zach Makovsky,2015-05-23,John Dodson,Decision - Unanimous,0,6,0,6
Zach Makovsky,2013-12-14,Scott Jorgensen,Decision - Unanimous,80,0,0,80
Zach Makovsky,2014-02-22,Josh Sampo,Decision - Unanimous,80,15,0,95
AJ Dobson,2024-03-23,Edmen Shahbazyan,KO/TKO,0,0,0,0
AJ Dobson,2022-02-12,Jacob Malkoun,Decision - Unanimous,0,0,0,0
AJ Dobson,2021-09-21,Hashem Arkhagha,Submission,90,31,0,121
AJ Dobson,2023-08-12,Tafon Nchukwi,Decision - Unanimous,80,14,0,94
AJ Dobson,2022-10-22,Armen Petrosyan,Decision - Unanimous,0,0,0,0
Alexa Grasso,2017-08-05,Randa Markos,Decision - Split,70,19,0,89
Alexa Grasso,2019-09-21,Carla Esparza,Decision - Majority,0,1,0,1
Alexa Grasso,2023-03-04,Valentina Shevchenko,Submission,90,0,25,115
Alexa Grasso,2019-06-08,Karolina Kowalkiewicz,Decision - Unanimous,80,58,0,138
Alexa Grasso,2022-10-15,Viviane Araujo,Decision - Unanimous,80,27,25,132
Alexa Grasso,2024-09-14,Valentina Shevchenko,Decision - Unanimous,0,0,25,25
Alexa Grasso,2016-11-05,Heather Clark,Decision - Unanimous,80,25,0,105
Alexa Grasso,2017-02-04,Felice Herrig,Decision - Unanimous,0,20,0,20
Alexa Grasso,2021-02-13,Maycee Barber,Decision - Unanimous,80,0,0,80
Alexa Grasso,2018-05-19,Tatiana Suarez,Submission,0,4,0,4
Alexa Grasso,2022-03-26,Joanne Wood,Submission,90,0,0,90
Alexa Grasso,2020-08-29,Ji Yeon Kim,Decision - Unanimous,80,20,0,100
Jonny Parsons,2023-07-22,Danny Roberts,KO/TKO,100,19,0,119
Jonny Parsons,2021-10-19,Solomon Renfro,Decision - Split,70,0,0,70
Ray Steinbeiss,2007-02-18,Jake Shields,Submission,0,0,0,0
Dustin Jacoby,2022-03-05,Michal Oleksiejczuk,Decision - Unanimous,80,20,0,100
Dustin Jacoby,2021-02-27,Maxim Grishin,Decision - Unanimous,80,0,0,80
Dustin Jacoby,2022-07-16,Da Woon Jung,KO/TKO,100,0,0,100
Dustin Jacoby,2022-10-29,Khalil Rountree Jr.,Decision - Split,0,35,0,35
Dustin Jacoby,2021-11-06,John Allan,Decision - Unanimous,80,76,0,156
Dustin Jacoby,2024-12-14,Vitor Petrino,KO/TKO,100,5,0,105
Dustin Jacoby,2012-01-28,Chris Camozzi,Submission,0,0,0,0
Dustin Jacoby,2023-04-15,Azamat Murzakanov,Decision - Unanimous,0,0,0,0
Dustin Jacoby,2020-10-31,Justin Ledet,KO/TKO,100,12,0,112
Dustin Jacoby,2023-12-16,Alonzo Menifield,Decision - Unanimous,0,25,0,25
Dustin Jacoby,2020-08-04,Ty Flores,Decision - Unanimous,80,87,0,167
Dustin Jacoby,2024-06-08,Dominick Reyes,KO/TKO,0,0,0,0
Dustin Jacoby,2023-08-05,Kennedy Nzechukwu,KO/TKO,100,6,0,106
Dustin Jacoby,2011-10-29,Clifford Starks,Decision - Unanimous,0,0,0,0
Dustin Jacoby,2021-08-28,Darren Stewart,KO/TKO,100,19,0,119
Eddie Sanchez,2007-06-16,Colin Robinson,KO/TKO,100,5,0,105
Eddie Sanchez,2007-02-03,Mirko Filipovic,KO/TKO,0,0,0,0
Eddie Sanchez,2006-09-23,Mario Neto,KO/TKO,100,0,0,100
Eddie Sanchez,2008-06-07,Antoni Hardonk,KO/TKO,0,0,0,0
Eddie Sanchez,2007-12-29,Soa Palelei,KO/TKO,100,31,0,131
Eddie Sanchez,2008-12-10,Justin McCully,Decision - Unanimous,0,2,0,2
Colin Robinson,2007-06-16,Eddie Sanchez,KO/TKO,0,0,0,0
Colin Robinson,2008-01-19,Antoni Hardonk,KO/TKO,0,0,0,0
Steve Montgomery,2015-11-14,Daniel Kelly,Decision - Unanimous,0,14,0,14
Steve Montgomery,2015-06-27,Tony Sims,KO/TKO,0,0,0,0
John Lineker,2017-10-28,Marlon Vera,Decision - Unanimous,80,28,0,108
John Lineker,2015-01-31,Ian McCall,Decision - Unanimous,80,0,0,80
John Lineker,2019-04-27,Cory Sandhagen,Decision - Split,0,0,0,0
John Lineker,2012-11-10,Yasuhiro Urushitani,Decision - Unanimous,80,15,0,95
John Lineker,2018-05-12,Brian Kelleher,KO/TKO,100,52,0,152
John Lineker,2014-02-01,Ali Bagautinov,Decision - Unanimous,0,0,0,0
John Lineker,2013-05-18,Azamat Gashimov,KO/TKO,100,29,0,129
John Lineker,2016-10-01,John Dodson,Decision - Split,70,0,25,95
John Lineker,2016-12-30,TJ Dillashaw,Decision - Unanimous,0,0,0,0
John Lineker,2013-08-03,Jose Maria,KO/TKO,100,3,0,103
John Lineker,2012-05-05,Louis Gaudinot,Submission,0,31,0,31
John Lineker,2015-09-05,Francisco Rivera,Submission,90,12,0,102
John Lineker,2013-10-26,Phil Harris,KO/TKO,100,17,0,117
John Lineker,2014-07-16,Alptekin Ozkilic,KO/TKO,100,45,0,145
John Lineker,2016-07-13,Michael McDonald,KO/TKO,100,12,25,137
John Lineker,2016-05-14,Rob Font,Decision - Unanimous,80,40,0,120
Marlon Vera,2017-10-28,John Lineker,Decision - Unanimous,0,0,0,0
Marlon Vera,2016-02-27,Davey Grant,Decision - Unanimous,0,0,0,0
Marlon Vera,2021-11-06,Frankie Edgar,KO/TKO,100,0,0,100
Marlon Vera,2024-08-03,Deiveson Figueiredo,Decision - Unanimous,0,7,0,7
Marlon Vera,2018-11-17,Guido Cannetti,Submission,90,0,0,90
Marlon Vera,2021-06-19,Davey Grant,Decision - Unanimous,80,22,0,102
Marlon Vera,2018-02-03,Douglas Silva de Andrade,Decision - Unanimous,0,0,0,0
Marlon Vera,2019-03-23,Frankie Saenz,KO/TKO,100,8,0,108
Marlon Vera,2018-08-04,Wulijiburen,KO/TKO,100,14,0,114
Marlon Vera,2024-03-09,Sean O'Malley,Decision - Unanimous,0,0,25,25
Marlon Vera,2020-05-16,Song Yadong,Decision - Unanimous,0,0,0,0
Marlon Vera,2019-07-06,Nohelin Hernandez,Submission,90,0,0,90
Marlon Vera,2020-08-15,Sean O'Malley,KO/TKO,100,8,0,108
Marlon Vera,2019-10-12,Andre Ewell,KO/TKO,100,30,0,130
Marlon Vera,2023-08-19,Pedro Munhoz,Decision - Unanimous,80,28,0,108
Marlon Vera,2022-04-30,Rob Font,Decision - Unanimous,80,0,25,105
Marlon Vera,2017-07-22,Brian Kelleher,Submission,90,0,0,90
Marlon Vera,2015-08-08,Roman Salazar,Submission,90,11,0,101
Marlon Vera,2023-03-25,Cory Sandhagen,Decision - Split,0,0,25,25
Marlon Vera,2016-11-26,Guangyou Ning,Decision - Unanimous,80,0,0,80
Marlon Vera,2014-11-15,Marco Beltran,Decision - Unanimous,0,0,0,0
Marlon Vera,2017-03-18,Brad Pickett,KO/TKO,100,16,0,116
Marlon Vera,2022-08-13,Dominick Cruz,KO/TKO,100,0,25,125
Marlon Vera,2020-12-19,Jose Aldo,Decision - Unanimous,0,2,0,2
Joe Duffy,2015-03-14,Jake Lindsey,KO/TKO,100,9,0,109
Joe Duffy,2016-07-07,Mitch Clarke,Submission,90,2,0,92
Joe Duffy,2015-07-18,Ivan Jorge,Submission,90,1,0,91
Joe Duffy,2020-07-18,Joel Alvarez,Submission,0,0,0,0
Joe Duffy,2017-03-18,Reza Madadi,Decision - Unanimous,80,23,0,103
Joe Duffy,2016-01-02,Dustin Poirier,Decision - Unanimous,0,0,0,0
Joe Duffy,2019-03-16,Marc Diakiese,Decision - Unanimous,0,0,0,0
Joe Duffy,2017-11-04,James Vick,KO/TKO,0,0,0,0
Jake Lindsey,2015-03-14,Joe Duffy,KO/TKO,0,0,0,0
Jake Lindsey,2014-06-07,Jon Tuck,KO/TKO,0,3,0,3
Jake Lindsey,2014-10-04,Olivier Aubin-Mercier,Submission,0,0,0,0
Rony Sefo,2003-12-31,Kiyoshi Tamura,Submission,0,0,0,0
Marcio Alexandre Junior,2015-12-12,Court McGee,Decision - Unanimous,0,0,0,0
Marcio Alexandre Junior,2014-05-31,Warlley Alves,Submission,0,0,0,0
Marcio Alexandre Junior,2014-12-20,Tim Means,Decision - Split,0,0,0,0
Marcio Alexandre Junior,2018-08-11,Leonardo Silva de Oliveira,Submission,90,0,0,90
Wagner da Conceicao Martins,2006-05-05,Antonio Rodrigo Nogueira,Submission,0,0,0,0
Wagner da Conceicao Martins,2007-04-08,Eric Esch,Submission,0,0,0,0
Wagner da Conceicao Martins,2005-10-23,Henry Miller,KO/TKO,100,5,0,105
Wagner da Conceicao Martins,2005-12-31,Fedor Emelianenko,KO/TKO,0,0,0,0
Drew McFedries,2008-01-23,Patrick Cote,KO/TKO,0,0,0,0
Drew McFedries,2006-11-18,Alessio Sakara,KO/TKO,100,0,0,100
Drew McFedries,2009-09-19,Tomasz Drwal,Submission,0,0,0,0
Drew McFedries,2008-06-21,Marvin Eastman,KO/TKO,100,16,0,116
Drew McFedries,2009-05-23,Xavier Foupa-Pokam,KO/TKO,100,8,0,108
Drew McFedries,2008-10-25,Thales Leites,Submission,0,1,0,1
Drew McFedries,2007-06-12,Jordan Radev,KO/TKO,100,5,0,105
Drew McFedries,2008-09-17,Mike Massenzio,Submission,0,3,0,3
Drew McFedries,2007-03-03,Martin Kampmann,Submission,0,1,0,1
Ed Ratcliff,2009-12-19,Donald Cerrone,Submission,0,0,0,0
Ed Ratcliff,2008-03-26,Marcus Hicks,Submission,0,0,0,0
Ed Ratcliff,2010-09-30,Chris Horodecki,Decision - Split,0,0,0,0
Ed Ratcliff,2009-08-09,Phil Cardella,Decision - Unanimous,80,0,0,80
Ed Ratcliff,2007-12-12,Alex Karalexis,KO/TKO,100,26,0,126
Ed Ratcliff,2007-05-12,Johnny Sampaio,KO/TKO,100,2,0,102
Tony Johnson,2019-06-25,Alton Cunningham,Decision - Unanimous,80,5,0,85
Alton Cunningham,2019-06-25,Tony Johnson,Decision - Unanimous,0,0,0,0
Alton Cunningham,2018-07-10,Bevon Lewis,KO/TKO,0,0,0,0
Juancamilo Ronderos,2021-05-22,David Dvorak,Submission,0,2,0,2
Juancamilo Ronderos,2023-02-18,Clayton Carpenter,Submission,0,0,0,0
Mason Jones,2021-10-23,David Onama,Decision - Unanimous,80,0,0,80
Mason Jones,2022-07-23,Ludovit Klein,Decision - Unanimous,0,0,0,0
Mason Jones,2021-01-20,Mike Davis,Decision - Unanimous,0,9,0,9
Charles Jourdain,2022-07-16,Shane Burgos,Decision - Majority,0,71,0,71
Charles Jourdain,2020-06-13,Andre Fili,Decision - Split,0,18,0,18
Charles Jourdain,2021-03-13,Marcelo Rojo,KO/TKO,100,32,0,132
Charles Jourdain,2021-12-18,Andre Ewell,Decision - Unanimous,80,81,0,161
Charles Jourdain,2022-09-03,Nathaniel Wood,Decision - Unanimous,0,0,0,0
Charles Jourdain,2019-12-21,Dooho Choi,KO/TKO,100,22,0,122
Charles Jourdain,2023-09-23,Ricardo Ramos,Submission,90,8,0,98
Charles Jourdain,2021-09-04,Julian Erosa,Submission,0,0,0,0
Charles Jourdain,2024-01-20,Sean Woodson,Decision - Split,0,0,0,0
Charles Jourdain,2024-06-29,Jean Silva,KO/TKO,0,0,0,0
Charles Jourdain,2024-11-02,Victor Henry,Submission,90,15,0,105
Charles Jourdain,2022-04-23,Lando Vannata,Submission,90,0,0,90
Charles Jourdain,2023-05-06,Kron Gracie,Decision - Unanimous,80,48,0,128
Charles Jourdain,2019-05-18,Desmond Green,Decision - Unanimous,0,0,0,0
Daniel Teymur,2019-12-14,Chase Hooper,KO/TKO,0,0,0,0
Daniel Teymur,2019-02-23,Chris Fishgold,Submission,0,3,0,3
Daniel Teymur,2019-06-01,Sung Bin Jo,Decision - Unanimous,80,19,0,99
Daniel Teymur,2017-07-16,Danny Henry,Decision - Unanimous,0,0,0,0
Daniel Teymur,2018-06-01,Julio Arce,Submission,0,0,0,0
Danny Sabatello,2020-11-10,Taylor Moore,Decision - Unanimous,80,28,0,108
Taylor Moore,2020-11-10,Danny Sabatello,Decision - Unanimous,0,0,0,0
Wang Cong,2024-08-24,Victoria Leonardo,KO/TKO,100,9,0,109
Wang Cong,2024-11-23,Gabriella Fernandes,Submission,0,28,0,28
Khalid Murtazaliev,2018-09-15,CB Dollaway,KO/TKO,100,44,0,144
Mateusz Rebecki,2022-08-30,Rodrigo Lidio,Submission,90,0,0,90
Mateusz Rebecki,2024-10-26,Myktybek Orolbai,Decision - Split,70,10,0,80
Mateusz Rebecki,2023-06-24,Loik Radzhabov,KO/TKO,100,35,0,135
Mateusz Rebecki,2023-01-14,Nick Fiore,Decision - Unanimous,80,55,0,135
Mateusz Rebecki,2024-05-11,Diego Ferreira,KO/TKO,0,0,0,0
Mateusz Rebecki,2023-11-11,Roosevelt Roberts,Submission,90,8,0,98
Rodrigo Lidio,2022-08-30,Mateusz Rebecki,Submission,0,3,0,3
John Kolosci,2007-12-08,Matt Arroyo,Submission,0,0,0,0
Miles Johns,2020-02-08,Mario Bautista,KO/TKO,0,0,0,0
Miles Johns,2024-12-14,Felipe Lima,Decision - Unanimous,0,0,0,0
Miles Johns,2022-02-05,John Castaneda,Submission,0,0,0,0
Miles Johns,2019-06-25,Richie Santiago,Decision - Unanimous,80,15,0,95
Miles Johns,2019-09-14,Cole Smith,Decision - Split,70,20,0,90
Miles Johns,2021-08-07,Anderson Dos Santos,KO/TKO,100,48,0,148
Miles Johns,2020-10-31,Kevin Natividad,KO/TKO,100,15,0,115
Miles Johns,2024-06-15,Douglas Silva de Andrade,Decision - Unanimous,80,14,0,94
Miles Johns,2022-11-19,Vince Morales,Decision - Unanimous,80,0,0,80
Miles Johns,2024-03-23,Cody Gibson,Decision - Unanimous,80,7,0,87
Jimmy Lawson,2022-09-06,Karl Williams,Decision - Unanimous,0,0,0,0
SeungWoo Choi,2021-06-19,Julian Erosa,KO/TKO,100,3,0,103
SeungWoo Choi,2022-06-11,Josh Culibao,Decision - Split,0,0,0,0
SeungWoo Choi,2023-08-26,Jarno Errens,Decision - Unanimous,80,26,0,106
SeungWoo Choi,2021-10-23,Alex Caceres,Submission,0,0,0,0
SeungWoo Choi,2021-02-06,Youssef Zalal,Decision - Unanimous,80,18,0,98
SeungWoo Choi,2022-11-12,Michael Trizano,KO/TKO,0,0,0,0
SeungWoo Choi,2019-12-21,Suman Mokhtarian,Decision - Unanimous,80,62,0,142
SeungWoo Choi,2019-07-27,Gavin Tucker,Submission,0,0,0,0
SeungWoo Choi,2019-04-20,Movsar Evloev,Decision - Unanimous,0,0,0,0
SeungWoo Choi,2024-07-20,Steve Garcia,KO/TKO,0,0,0,0
Hirotaka Yokoi,2005-10-23,Quinton Jackson,KO/TKO,0,0,0,0
Hirotaka Yokoi,2004-04-25,Antonio Rodrigo Nogueira,Submission,0,0,0,0
Hirotaka Yokoi,2004-10-31,Heath Herring,KO/TKO,0,0,0,0
Hirotaka Yokoi,2002-11-24,Jerrel Venetiaan,Submission,90,38,0,128
Hirotaka Yokoi,2005-02-20,Mario Sperry,KO/TKO,0,0,0,0
Estevan Payan,2012-01-07,Alonzo Martinez,Decision - Unanimous,80,64,0,144
Estevan Payan,2014-04-19,Alex White,KO/TKO,0,0,0,0
Estevan Payan,2013-12-28,Robert Peralta,KO/TKO,0,0,0,0
Estevan Payan,2013-05-25,Jeremy Stephens,Decision - Unanimous,0,0,0,0
Alonzo Martinez,2012-01-07,Estevan Payan,Decision - Unanimous,0,0,0,0
Leonardo Guimaraes,2016-02-21,Anthony Smith,Decision - Unanimous,0,7,0,7
Leonardo Guimaraes,2016-09-17,Antonio Carlos Junior,Submission,0,0,0,0
ChangHo Lee,2023-08-27,Daermisi Zhawupasi,KO/TKO,100,22,0,122
ChangHo Lee,2024-06-22,Xiao Long,Decision - Split,70,16,0,86
ChangHo Lee,2023-05-28,Rana Rudra Pratap Singh,KO/TKO,100,35,0,135
Jason Brilz,2009-09-19,Eliot Marshall,Decision - Split,0,0,0,0
Jason Brilz,2008-09-17,Brad Morris,KO/TKO,100,30,0,130
Jason Brilz,2010-03-21,Eric Schafer,Decision - Unanimous,80,43,0,123
Jason Brilz,2011-04-30,Vladimir Matyushenko,KO/TKO,0,0,0,0
Jason Brilz,2009-03-07,Tim Boetsch,Decision - Unanimous,80,7,0,87
Jason Brilz,2011-11-19,Ryan Bader,KO/TKO,0,0,0,0
Jason Brilz,2010-05-29,Rogerio Nogueira,Decision - Split,0,0,0,0
Dylan Potter,2021-09-14,Lukasz Brzeski,Submission,0,0,0,0
Max Rohskopf,2020-06-20,Austin Hubbard,TKO - Doctor's Stoppage,0,0,0,0
Hidetaka Monma,2008-03-15,Hayato Sakurai,KO/TKO,0,0,0,0
Pascal Krauss,2010-11-13,Mark Scanlon,Decision - Unanimous,80,17,0,97
Pascal Krauss,2012-05-05,John Hathaway,Decision - Unanimous,0,0,0,0
Pascal Krauss,2013-01-26,Mike Stumpf,Decision - Unanimous,80,100,0,180
Pascal Krauss,2013-08-31,Hyun Gyu Lim,KO/TKO,0,0,0,0
Mark Scanlon,2010-11-13,Pascal Krauss,Decision - Unanimous,0,0,0,0
Zachary Reese,2024-08-24,Jose Daniel Medina,Decision - Unanimous,80,43,0,123
Zachary Reese,2023-08-22,Eli Aronov,Submission,90,0,0,90
Zachary Reese,2024-06-08,Julian Marquez,KO/TKO,100,5,0,105
Zachary Reese,2023-12-02,Cody Brundage,KO/TKO,0,0,0,0
Jose Daniel Medina,2024-08-24,Zachary Reese,Decision - Unanimous,0,0,0,0
Jose Daniel Medina,2023-10-03,Magomed Gadzhiyasulov,Decision - Unanimous,0,0,0,0
Yair Rodriguez,2019-10-18,Jeremy Stephens,Decision - Unanimous,80,46,0,126
Yair Rodriguez,2014-11-15,Leonardo Morales,Decision - Unanimous,80,1,0,81
Yair Rodriguez,2015-10-03,Dan Hooker,Decision - Unanimous,80,33,0,113
Yair Rodriguez,2022-07-16,Brian Ortega,KO/TKO,100,1,25,126
Yair Rodriguez,2017-01-15,BJ Penn,KO/TKO,100,51,25,176
Yair Rodriguez,2016-08-06,Alex Caceres,Decision - Split,70,58,25,153
Yair Rodriguez,2023-07-08,Alexander Volkanovski,KO/TKO,0,0,25,25
Yair Rodriguez,2016-04-23,Andre Fili,KO/TKO,100,14,0,114
Yair Rodriguez,2024-02-24,Brian Ortega,Submission,0,27,25,52
Yair Rodriguez,2017-05-13,Frankie Edgar,TKO - Doctor's Stoppage,0,0,0,0
Yair Rodriguez,2015-06-13,Charles Rosa,Decision - Split,70,17,0,87
Yair Rodriguez,2023-02-11,Josh Emmett,Submission,90,40,25,155
Yair Rodriguez,2021-11-13,Max Holloway,Decision - Unanimous,0,0,25,25
Yair Rodriguez,2018-11-10,Chan Sung Jung,KO/TKO,100,0,25,125
Hiromitsu Miura,2007-08-05,Fernando Gonzalez,KO/TKO,100,7,0,107
Hiromitsu Miura,2007-05-12,Jason Miller,Decision - Unanimous,0,0,0,0
Hiromitsu Miura,2008-03-26,Blas Avena,KO/TKO,100,8,0,108
Hiromitsu Miura,2008-08-03,Carlos Condit,KO/TKO,0,8,25,33
Hiromitsu Miura,2009-01-25,Edgar Garcia,KO/TKO,0,0,0,0
Fernando Gonzalez,2007-08-05,Hiromitsu Miura,KO/TKO,0,0,0,0
Fernando Gonzalez,2007-01-20,Brendan Seguin,Decision - Unanimous,0,0,0,0
Fernando Gonzalez,2006-08-17,Alex Stiebling,TKO - Doctor's Stoppage,0,25,0,25
Keita Nakamura,2018-04-21,Anthony Rocco Martin,Decision - Unanimous,0,0,0,0
Keita Nakamura,2008-02-02,Rob Emerson,Decision - Split,0,0,0,0
Keita Nakamura,2016-07-13,Kyle Noke,Submission,90,0,0,90
Keita Nakamura,2006-12-13,Brock Larson,Decision - Unanimous,0,0,0,0
Keita Nakamura,2016-10-01,Elizeu Zaleski dos Santos,Decision - Unanimous,0,0,0,0
Keita Nakamura,2018-12-01,Salim Touahri,Decision - Split,70,7,0,77
Keita Nakamura,2015-09-26,Li Jingliang,Submission,90,0,0,90
Keita Nakamura,2007-04-05,Drew Fickett,Decision - Unanimous,0,0,0,0
Keita Nakamura,2017-09-22,Alex Morono,Decision - Split,70,0,0,70
Keita Nakamura,2019-04-20,Sultan Aliev,Decision - Unanimous,0,4,0,4
Keita Nakamura,2016-02-27,Tom Breese,Decision - Unanimous,0,0,0,0
Keita Nakamura,2008-09-23,Adriano Martins,Decision - Split,70,20,0,90
Koya Kanda,2023-05-27,Yibugele,Decision - Unanimous,80,16,0,96
Koya Kanda,2023-08-27,Kaiwen,Decision - Unanimous,0,6,0,6
Yibugele,2023-05-27,Koya Kanda,Decision - Unanimous,0,0,0,0
Yibugele,2024-05-18,Xie Bin,Decision - Unanimous,0,0,0,0
Greg Velasco,2023-09-19,Shamil Gaziev,Submission,0,0,0,0
Douglas Silva de Andrade,2021-01-20,Lerone Murphy,Decision - Unanimous,0,0,0,0
Douglas Silva de Andrade,2022-07-09,Said Nurmagomedov,Decision - Unanimous,0,0,0,0
Douglas Silva de Andrade,2017-07-08,Rob Font,Submission,0,0,0,0
Douglas Silva de Andrade,2018-02-03,Marlon Vera,Decision - Unanimous,80,25,0,105
Douglas Silva de Andrade,2022-02-12,Sergey Morozov,Submission,90,5,0,95
Douglas Silva de Andrade,2014-02-15,Zubaira Tukhugov,Decision - Unanimous,0,0,0,0
Douglas Silva de Andrade,2019-11-16,Renan Barao,Decision - Unanimous,80,16,0,96
Douglas Silva de Andrade,2024-06-15,Miles Johns,Decision - Unanimous,0,0,0,0
Douglas Silva de Andrade,2021-10-02,Gaetano Pirrello,KO/TKO,100,5,0,105
Douglas Silva de Andrade,2018-12-29,Petr Yan,KO/TKO,0,0,0,0
Douglas Silva de Andrade,2016-11-05,Henry Briones,KO/TKO,100,5,0,105
Douglas Silva de Andrade,2023-05-13,Cody Stamann,Decision - Unanimous,80,7,0,87
Douglas Silva de Andrade,2015-02-22,Cody Gibson,Decision - Unanimous,80,9,0,89
Brian Gassaway,2005-08-20,Diego Sanchez,KO/TKO,0,0,0,0
Brian Gassaway,2007-01-20,John Alessio,Submission,0,0,0,0
Tim Gorman,2014-04-16,Mitch Gagnon,Decision - Unanimous,0,0,0,0
Tim Gorman,2014-11-08,Thomas Almeida,Decision - Unanimous,0,0,0,0
Rogerio Bontorin,2018-08-10,Gustavo Gabriel,Submission,90,2,0,92
Rogerio Bontorin,2019-08-10,Raulian Paiva,TKO - Doctor's Stoppage,0,5,0,5
Rogerio Bontorin,2020-02-15,Ray Borg,Decision - Unanimous,0,0,0,0
Rogerio Bontorin,2019-02-02,Bibulatov Magomed,Decision - Split,70,0,0,70
Rogerio Bontorin,2022-01-15,Brandon Royval,Decision - Split,0,0,0,0
Rogerio Bontorin,2021-03-06,Kai Kara-France,KO/TKO,0,0,0,0
Gustavo Gabriel,2018-08-10,Rogerio Bontorin,Submission,0,0,0,0
Viscardi Andrade,2016-03-19,Richard Walsh,Decision - Unanimous,80,0,0,80
Viscardi Andrade,2014-02-15,Nicholas Musoke,Decision - Unanimous,0,0,0,0
Viscardi Andrade,2015-11-07,Gasan Umalatov,Decision - Unanimous,80,40,0,120
Viscardi Andrade,2013-08-03,Bristol Marunde,KO/TKO,100,12,0,112
James Moontasri,2015-11-14,Anton Zafir,KO/TKO,100,0,0,100
James Moontasri,2015-07-15,Kevin Lee,Submission,0,0,0,0
James Moontasri,2014-06-28,Joe Ellenberger,Decision - Split,0,13,0,13
James Moontasri,2016-07-23,Alex Oliveira,Decision - Unanimous,0,0,0,0
James Moontasri,2015-02-14,Cody Pfister,Submission,90,20,0,110
James Moontasri,2016-12-17,Alex Morono,Decision - Unanimous,0,0,0,0
Anton Zafir,2015-11-14,James Moontasri,KO/TKO,0,6,0,6
Anton Zafir,2016-07-08,Li Jingliang,KO/TKO,0,0,0,0
Lloyd Van Dams,2002-08-28,Gary Goodridge,KO/TKO,0,0,0,0
Virgil Zwicker,2012-05-19,Guto Inocente,Decision - Unanimous,0,0,0,0
Virgil Zwicker,2010-10-22,Lavar Johnson,KO/TKO,0,0,0,0
Mitsuhiro Ishida,2009-08-15,Gilbert Melendez,KO/TKO,0,0,25,25
Mitsuhiro Ishida,2006-08-27,Cristiano Marcello,Decision - Unanimous,80,31,0,111
Mitsuhiro Ishida,2007-12-31,Gilbert Melendez,Decision - Unanimous,80,0,0,80
Mitsuhiro Ishida,2006-11-05,David Bielkheden,Decision - Unanimous,80,6,0,86
Mitsuhiro Ishida,2008-09-20,Justin Wilcox,Submission,90,1,0,91
Mitsuhiro Ishida,2011-05-29,Joachim Hansen,Decision - Split,0,18,0,18
Mitsuhiro Ishida,2006-04-02,Paul Rodriguez,Submission,90,4,0,94
Mitsuhiro Ishida,2008-05-11,Caol Uno,Submission,0,0,0,0
Mitsuhiro Ishida,2008-03-15,Bu-Kyung Jung,Decision - Unanimous,80,23,0,103
Mitsuhiro Ishida,2006-12-31,Takanori Gomi,KO/TKO,0,0,0,0
Mitsuhiro Ishida,2006-06-04,Marcus Aurelio,Decision - Unanimous,80,22,0,102
Mitsuhiro Ishida,2010-07-10,Daiki Hata,Decision - Unanimous,80,19,0,99
Mitsuhiro Ishida,2010-09-25,Akiyo Nishiura,Decision - Split,70,0,0,70
Mitsuhiro Ishida,2009-03-08,Daisuke Nakamura,Decision - Unanimous,80,12,0,92
Billy Miles,2007-12-08,George Sotiropoulos,Submission,0,0,0,0
Jake Ellenberger,2011-02-05,Carlos Eduardo Rocha,Decision - Split,70,4,0,74
Jake Ellenberger,2014-05-24,Robbie Lawler,KO/TKO,0,0,0,0
Jake Ellenberger,2010-08-01,John Howard,TKO - Doctor's Stoppage,0,21,0,21
Jake Ellenberger,2018-06-01,Ben Saunders,KO/TKO,0,0,0,0
Jake Ellenberger,2009-09-16,Carlos Condit,Decision - Split,0,1,0,1
Jake Ellenberger,2018-08-25,Bryan Barberena,KO/TKO,0,0,0,0
Jake Ellenberger,2012-10-05,Jay Hieron,Decision - Unanimous,80,0,0,80
Jake Ellenberger,2012-06-01,Martin Kampmann,KO/TKO,0,6,25,31
Jake Ellenberger,2016-07-30,Matt Brown,KO/TKO,100,14,0,114
Jake Ellenberger,2011-04-30,Sean Pierson,KO/TKO,100,6,0,106
Jake Ellenberger,2015-02-28,Josh Koscheck,Submission,90,8,0,98
Jake Ellenberger,2013-03-16,Nate Marquardt,KO/TKO,100,0,0,100
Jake Ellenberger,2015-07-12,Stephen Thompson,KO/TKO,0,0,25,25
Jake Ellenberger,2016-01-30,Tarec Saffiedine,Decision - Unanimous,0,0,0,0
Jake Ellenberger,2013-07-27,Rory MacDonald,Decision - Unanimous,0,0,0,0
Jake Ellenberger,2012-02-15,Diego Sanchez,Decision - Unanimous,80,33,0,113
Jake Ellenberger,2017-04-22,Mike Perry,KO/TKO,0,0,0,0
Jake Ellenberger,2016-12-03,Jorge Masvidal,KO/TKO,0,0,0,0
Jake Ellenberger,2010-01-02,Mike Pyle,KO/TKO,100,10,0,110
Jake Ellenberger,2011-09-17,Jake Shields,KO/TKO,100,8,0,108
Jake Ellenberger,2014-11-15,Kelvin Gastelum,Submission,0,0,0,0
Kotetsu Boku,2008-03-15,Joachim Hansen,Decision - Unanimous,0,0,0,0
Alex Chambers,2015-05-09,Kailin Curran,Submission,90,0,0,90
Alex Chambers,2014-12-12,Aisling Daly,Submission,0,0,0,0
Alex Chambers,2018-09-22,Livinha Souza,Submission,0,0,0,0
Alex Chambers,2017-11-18,Nadia Kassem,Decision - Unanimous,0,0,0,0
Alex Chambers,2015-09-05,Paige VanZant,Submission,0,0,0,0
Henry Martinez,2012-06-08,Bernardo Magalhaes,Decision - Split,70,0,0,70
Henry Martinez,2012-02-04,Matthew Riddle,Decision - Split,0,0,0,0
Henry Martinez,2012-12-08,Daron Cruickshank,KO/TKO,0,0,0,0
Bernardo Magalhaes,2012-06-08,Henry Martinez,Decision - Split,0,8,0,8
Bernardo Magalhaes,2012-02-15,Tim Means,Decision - Unanimous,0,0,0,0
Enrique Marin,2016-07-09,Sage Northcutt,Decision - Unanimous,0,0,0,0
Enrique Marin,2015-11-21,Erick Montano,Decision - Split,0,0,0,0
Lauren Mueller,2018-11-24,Wu Yanan,Submission,0,0,0,0
Lauren Mueller,2018-04-14,Shana Dobson,Decision - Unanimous,80,0,0,80
Lauren Mueller,2019-04-13,Poliana Botelho,Decision - Unanimous,0,0,0,0
Lauren Mueller,2019-10-12,JJ Aldrich,Decision - Unanimous,0,0,0,0
Lauren Mueller,2017-08-29,Kelly Velasco,Decision - Unanimous,80,51,0,131
Daniel Gracie,2003-10-05,Kazuhiro Nakamura,Decision - Unanimous,0,0,0,0
Daniel Gracie,2002-06-23,Takashi Sugiura,Decision - Split,70,28,0,98
Daniel Gracie,2003-12-31,Wataru Sakata,Submission,90,7,0,97
Alberto Mina,2016-07-07,Mike Pyle,KO/TKO,100,14,0,114
Alberto Mina,2014-08-23,Shinsho Anzai,KO/TKO,100,3,0,103
Alberto Mina,2015-11-28,Yoshihiro Akiyama,Decision - Split,70,0,0,70
Alberto Mina,2018-05-12,Ramazan Emeev,Decision - Unanimous,0,0,0,0
Matt Horwich,2006-03-10,Brian Ebersole,Decision - Unanimous,0,0,0,0
Matt Horwich,2009-04-01,Ricardo Almeida,Decision - Unanimous,0,0,0,0
Matt Horwich,2008-10-25,Dan Miller,Decision - Unanimous,0,0,0,0
Travis Galbraith,2002-10-11,Georges St-Pierre,KO/TKO,0,0,0,0
Travis Galbraith,2006-10-21,Kazuhiro Nakamura,KO/TKO,0,0,0,0
Travis Galbraith,2008-07-26,Rafael Cavalcante,KO/TKO,0,0,0,0
Baergeng Jieleyisi,2024-08-23,Tokitaka Nakanishi,Decision - Unanimous,80,4,0,84
Baergeng Jieleyisi,2024-05-19,Li Yunfeng,Submission,90,19,0,109
Baergeng Jieleyisi,2023-05-28,Shuya Kamikubo,Decision - Split,0,0,0,0
Baergeng Jieleyisi,2024-11-23,SuYoung You,Decision - Unanimous,0,0,0,0
Tokitaka Nakanishi,2024-08-23,Baergeng Jieleyisi,Decision - Unanimous,0,0,0,0
Tokitaka Nakanishi,2024-05-19,KyuSung Kim,Decision - Unanimous,80,0,0,80
Alexander Poppeck,2019-07-23,Jamahal Hill,KO/TKO,0,0,0,0
Yuki Sasaki,2006-08-17,Dean Lister,Decision - Unanimous,0,2,0,2
Yuki Sasaki,2002-12-23,Rodrigo Gracie,Decision - Unanimous,0,0,0,0
Yoshiaki Yatsu,2000-10-31,Gary Goodridge,KO/TKO,0,0,0,0
Yoshiaki Yatsu,2001-09-24,Gary Goodridge,KO/TKO,0,0,0,0
Chris Avila,2016-08-20,Artem Lobov,Decision - Unanimous,0,0,0,0
Chris Avila,2016-11-05,Enrique Barzola,Decision - Unanimous,0,0,0,0
Jason Von Flue,2006-01-16,Alex Karalexis,Submission,90,10,0,100
Jason Von Flue,2007-06-22,Luke Stewart,KO/TKO,0,0,0,0
Jason Von Flue,2006-08-17,Joe Riggs,Submission,0,0,0,0
Jason Von Flue,2006-04-06,Luke Cummo,Decision - Unanimous,0,0,0,0
Jason Von Flue,2006-10-07,Eric Wray,Submission,90,10,0,100
Jason Von Flue,2006-12-08,Cung Le,TKO - Doctor's Stoppage,0,0,0,0
Alex Karalexis,2006-01-16,Jason Von Flue,Submission,0,0,0,0
Alex Karalexis,2005-08-06,Kenny Florian,TKO - Doctor's Stoppage,0,0,0,0
Alex Karalexis,2007-06-03,Josh Smith,Decision - Majority,75,10,0,85
Alex Karalexis,2006-08-17,Thomas Denny,Decision - Unanimous,80,14,0,94
Alex Karalexis,2007-12-12,Ed Ratcliff,KO/TKO,0,0,0,0
Alex Karalexis,2008-12-03,Bart Palaszewski,KO/TKO,0,0,0,0
Alex Karalexis,2009-03-01,Greg McIntyre,KO/TKO,100,9,0,109
Alex Karalexis,2010-04-24,Anthony Pettis,Submission,0,0,0,0
Alex Karalexis,2007-01-20,Olaf Alfonso,TKO - Doctor's Stoppage,0,43,0,43
Alex Karalexis,2005-04-09,Josh Rafferty,KO/TKO,100,5,0,105
Matthew Semelsberger,2021-03-13,Jason Witt,KO/TKO,100,0,0,100
Matthew Semelsberger,2020-08-22,Carlton Minus,Decision - Unanimous,80,41,0,121
Matthew Semelsberger,2021-06-19,Khaos Williams,Decision - Unanimous,0,0,0,0
Matthew Semelsberger,2021-09-25,Martin Sano,KO/TKO,100,2,0,102
Matthew Semelsberger,2024-11-09,Charles Radtke,KO/TKO,0,0,0,0
Matthew Semelsberger,2024-01-13,Preston Parsons,Decision - Unanimous,0,0,0,0
Matthew Semelsberger,2022-12-17,Jake Matthews,Decision - Unanimous,80,13,0,93
Matthew Semelsberger,2022-07-30,Alex Morono,Decision - Unanimous,0,0,0,0
Matthew Semelsberger,2023-07-29,Uros Medic,KO/TKO,0,0,0,0
Matthew Semelsberger,2022-03-12,AJ Fletcher,Decision - Unanimous,80,6,0,86
Matthew Semelsberger,2023-04-22,Jeremiah Wells,Decision - Split,0,0,0,0
Jason Witt,2021-03-13,Matthew Semelsberger,KO/TKO,0,1,0,1
Jason Witt,2021-07-31,Bryan Barberena,Decision - Majority,75,0,0,75
Jason Witt,2022-08-13,Josh Quinlan,KO/TKO,0,0,0,0
Jason Witt,2020-10-31,Cole Williams,Submission,90,19,0,109
Jason Witt,2020-06-27,Takashi Sato,KO/TKO,0,0,0,0
Jason Witt,2022-02-05,Phil Rowe,KO/TKO,0,0,0,0
Dan Hardy,2010-03-27,Georges St-Pierre,Decision - Unanimous,0,0,25,25
Dan Hardy,2009-11-14,Mike Swick,Decision - Unanimous,80,17,0,97
Dan Hardy,2011-08-14,Chris Lytle,Submission,0,0,0,0
Dan Hardy,2010-10-16,Carlos Condit,KO/TKO,0,0,0,0
Dan Hardy,2009-02-21,Rory Markham,KO/TKO,100,3,0,103
Dan Hardy,2012-05-26,Duane Ludwig,KO/TKO,100,1,0,101
Dan Hardy,2011-03-26,Anthony Johnson,Decision - Unanimous,0,0,0,0
Dan Hardy,2012-09-29,Amir Sadollah,Decision - Unanimous,80,4,0,84
Dan Hardy,2009-06-13,Marcus Davis,Decision - Split,70,9,0,79
Dan Hardy,2008-10-18,Akihiro Gono,Decision - Split,70,1,0,71
Manny Tapia,2007-05-12,Brandon Foxworth,KO/TKO,100,27,0,127
Manny Tapia,2008-02-13,Antonio Banuelos,Decision - Split,70,14,0,84
Manny Tapia,2009-10-10,Eddie Wineland,Decision - Unanimous,0,0,0,0
Manny Tapia,2009-04-05,Akitoshi Tamura,Decision - Unanimous,0,0,0,0
Manny Tapia,2008-12-03,Miguel Torres,KO/TKO,0,0,25,25
Brandon Foxworth,2007-05-12,Manny Tapia,KO/TKO,0,0,0,0
Edson Berto,2007-06-22,Victor Valenzuela,Submission,90,1,0,91
Edson Berto,2007-07-27,KJ Noons,KO/TKO,0,0,0,0
Edson Berto,2008-02-16,Yves Edwards,KO/TKO,0,0,0,0
Victor Valenzuela,2007-06-22,Edson Berto,Submission,0,0,0,0
Alex Gilpin,2018-08-07,JR Coughran,Submission,90,0,0,90
JR Coughran,2018-08-07,Alex Gilpin,Submission,0,38,0,38
Jong Won Kim,2009-03-08,Hiroyuki Takaya,KO/TKO,0,0,0,0
Tim Williams,2018-02-18,Oskar Piechota,KO/TKO,0,0,0,0
Tim Williams,2018-08-25,Eryk Anders,KO/TKO,0,1,0,1
Mike Cook,2006-10-07,Carlton Jones,KO/TKO,100,0,0,100
Mike Cook,2006-12-08,Daniel Puder,Submission,0,0,0,0
Carlton Jones,2006-10-07,Mike Cook,KO/TKO,0,5,0,5
Carlton Jones,2005-10-14,Shane Carwin,KO/TKO,0,0,0,0
Carlton Jones,2006-05-05,Glover Teixeira,KO/TKO,0,0,0,0
Mike Rodriguez,2021-09-18,Tafon Nchukwi,Decision - Unanimous,0,0,0,0
Mike Rodriguez,2021-02-06,Danilo Marques,Submission,0,0,0,0
Mike Rodriguez,2020-08-22,Marcin Prachnio,KO/TKO,100,7,0,107
Mike Rodriguez,2019-12-21,Da Woon Jung,KO/TKO,0,0,0,0
Mike Rodriguez,2020-09-12,Ed Herman,Submission,0,49,0,49
Mike Rodriguez,2018-04-07,Devin Clark,Decision - Unanimous,0,0,0,0
Mike Rodriguez,2017-08-08,Jamelle Jones,KO/TKO,100,3,0,103
Mike Rodriguez,2018-12-15,Adam Milstead,KO/TKO,100,25,0,125
Drakkar Klose,2023-12-02,Joe Solecki,KO/TKO,100,1,0,101
Drakkar Klose,2017-01-15,Devin Powell,Decision - Unanimous,80,46,0,126
Drakkar Klose,2018-12-15,Bobby Green,Decision - Unanimous,80,0,0,80
Drakkar Klose,2024-12-14,Joel Alvarez,KO/TKO,0,0,0,0
Drakkar Klose,2020-03-07,Beneil Dariush,KO/TKO,0,3,0,3
Drakkar Klose,2022-04-16,Brandon Jenkins,KO/TKO,100,58,0,158
Drakkar Klose,2017-07-07,Marc Diakiese,Decision - Split,70,5,0,75
Drakkar Klose,2017-12-02,David Teymur,Decision - Unanimous,0,0,0,0
Drakkar Klose,2024-05-04,Joaquim Silva,Decision - Unanimous,80,11,0,91
Drakkar Klose,2018-07-07,Lando Vannata,Decision - Unanimous,80,5,0,85
Drakkar Klose,2019-08-17,Christos Giagos,Decision - Unanimous,80,12,0,92
Drakkar Klose,2022-07-30,Rafa Garcia,Decision - Unanimous,80,27,0,107
Jai Herbert,2024-08-03,Rolando Bedoya,Decision - Unanimous,80,15,0,95
Jai Herbert,2023-07-22,Fares Ziam,Decision - Unanimous,0,0,0,0
Jai Herbert,2022-03-19,Ilia Topuria,KO/TKO,0,2,0,2
Jai Herbert,2022-07-23,Kyle Nelson,Decision - Unanimous,80,0,0,80
Jai Herbert,2021-10-23,Khama Worthy,KO/TKO,100,13,0,113
Jai Herbert,2021-06-26,Renato Moicano,Submission,0,0,0,0
Jai Herbert,2020-07-25,Francisco Trinaldo,KO/TKO,0,0,0,0
John Halverson,2008-03-01,Jorge Gurgel,Decision - Unanimous,0,0,0,0
John Halverson,2007-02-03,Roger Huerta,KO/TKO,0,0,0,0
Felipe Arantes,2013-06-08,Godofredo Pepey,KO/TKO,100,23,0,123
Felipe Arantes,2018-06-23,Song Yadong,KO/TKO,0,0,0,0
Felipe Arantes,2017-10-21,Josh Emmett,Decision - Unanimous,0,0,0,0
Felipe Arantes,2014-02-15,Maximo Blanco,Decision - Unanimous,80,0,0,80
Felipe Arantes,2012-01-14,Antonio Carvalho,Decision - Unanimous,80,16,0,96
Felipe Arantes,2011-08-27,Iuri Alcantara,Decision - Unanimous,0,7,0,7
Felipe Arantes,2013-09-04,Edimilson Souza,Decision - Split,0,0,0,0
Felipe Arantes,2016-11-05,Erik Perez,Decision - Split,0,0,0,0
Felipe Arantes,2016-07-07,Jerrod Sanders,Submission,90,0,0,90
Felipe Arantes,2014-10-25,Andre Fili,Decision - Unanimous,0,0,0,0
Felipe Arantes,2015-08-23,Yves Jabouin,Submission,90,0,0,90
Godofredo Pepey,2013-06-08,Felipe Arantes,KO/TKO,0,0,0,0
Godofredo Pepey,2016-09-24,Mike de la Torre,Submission,90,18,0,108
Godofredo Pepey,2018-01-27,Mirsad Bektic,KO/TKO,0,0,0,0
Godofredo Pepey,2017-07-22,Shane Burgos,Decision - Unanimous,0,0,0,0
Godofredo Pepey,2015-03-21,Andre Fili,Submission,90,0,0,90
Godofredo Pepey,2013-01-19,Milton Vieira,Decision - Split,70,19,0,89
Godofredo Pepey,2014-03-23,Noad Lahat,KO/TKO,100,0,0,100
Godofredo Pepey,2014-09-13,Dashon Johnson,Submission,90,1,0,91
Godofredo Pepey,2012-06-23,Rony Jason,Decision - Unanimous,0,0,0,0
Godofredo Pepey,2016-07-23,Darren Elkins,Decision - Unanimous,0,0,0,0
Godofredo Pepey,2013-11-09,Sam Sicilia,KO/TKO,0,0,0,0
Edwin Figueroa,2012-02-04,Alex Caceres,Decision - Split,70,0,0,70
Edwin Figueroa,2011-03-26,Michael McDonald,Decision - Unanimous,0,0,0,0
Edwin Figueroa,2013-11-16,Erik Perez,Decision - Unanimous,0,0,0,0
Edwin Figueroa,2013-06-15,Roland Delorme,Decision - Unanimous,0,20,0,20
Edwin Figueroa,2013-02-02,Francisco Rivera,KO/TKO,0,0,0,0
Edwin Figueroa,2011-08-14,Jason Reinhardt,KO/TKO,100,22,0,122
Yoshihisa Yamamoto,2004-02-01,Mark Kerr,KO/TKO,100,4,0,104
Yoshihisa Yamamoto,2002-12-23,Alexander Otsuka,KO/TKO,100,0,0,100
Yoshihisa Yamamoto,2001-09-24,Assuerio Silva,KO/TKO,0,0,0,0
Yoshihisa Yamamoto,2002-09-29,Guy Mezger,Decision - Unanimous,0,0,0,0
Yoshihisa Yamamoto,2004-02-15,Mirko Filipovic,KO/TKO,0,0,0,0
Yoshihisa Yamamoto,2004-05-23,Mu Bae Choi,Decision - Unanimous,0,32,0,32
Yoshihisa Yamamoto,2002-04-28,Bob Sapp,KO/TKO,0,0,0,0
Yoshihisa Yamamoto,2001-12-23,Jan Nortje,Submission,90,1,0,91
Yoshihisa Yamamoto,2003-11-09,Heath Herring,Submission,0,0,0,0
Mike Budnik,2009-03-01,John Franchi,Decision - Split,0,0,0,0
Mike Budnik,2008-12-03,Shane Roller,Submission,0,2,0,2
Mike Budnik,2009-04-05,Rafael Dias,Decision - Unanimous,0,0,0,0
Mike Budnik,2008-08-03,Greg McIntyre,Submission,90,1,0,91
Bo Nickal,2024-11-16,Paul Craig,Decision - Unanimous,80,7,0,87
Bo Nickal,2022-08-09,Zachary Borrego,Submission,90,2,0,92
Bo Nickal,2023-03-04,Jamie Pickett,Submission,90,0,0,90
Bo Nickal,2023-07-08,Val Woodburn,KO/TKO,100,5,0,105
Bo Nickal,2022-09-27,Donovan Beard,Submission,90,5,0,95
Bo Nickal,2024-04-13,Cody Brundage,Submission,90,4,0,94
Paul Craig,2024-11-16,Bo Nickal,Decision - Unanimous,0,0,0,0
Paul Craig,2019-06-29,Alonzo Menifield,KO/TKO,0,0,0,0
Paul Craig,2019-09-21,Vinicius Moreira,Submission,90,17,0,107
Paul Craig,2023-07-22,Andre Muniz,KO/TKO,100,16,0,116
Paul Craig,2023-11-18,Brendan Allen,Submission,0,0,25,25
Paul Craig,2022-03-19,Nikita Krylov,Submission,90,0,0,90
Paul Craig,2020-07-25,Gadzhimurad Antigulov,Submission,90,0,0,90
Paul Craig,2018-03-17,Magomed Ankalaev,Submission,90,0,0,90
Paul Craig,2017-03-04,Tyson Pedro,KO/TKO,0,0,0,0
Paul Craig,2022-07-23,Volkan Oezdemir,Decision - Unanimous,0,0,0,0
Paul Craig,2021-06-12,Jamahal Hill,KO/TKO,100,22,0,122
Paul Craig,2024-05-04,Caio Borralho,KO/TKO,0,0,0,0
Paul Craig,2023-01-21,Johnny Walker,KO/TKO,0,0,0,0
Paul Craig,2018-12-01,Jimmy Crute,Submission,0,0,0,0
Paul Craig,2019-03-30,Kennedy Nzechukwu,Submission,90,0,0,90
Paul Craig,2020-11-21,Mauricio Rua,KO/TKO,100,19,0,119
Paul Craig,2017-07-16,Khalil Rountree Jr.,KO/TKO,0,2,0,2
Paul Craig,2016-12-17,Henrique da Silva,Submission,90,15,0,105
Jake Hadley,2022-11-05,Carlos Candelario,Submission,90,21,0,111
Jake Hadley,2022-05-14,Allan Nascimento,Decision - Unanimous,0,0,0,0
Jake Hadley,2024-10-19,Cameron Smotherman,Decision - Unanimous,0,0,0,0
Jake Hadley,2024-07-27,Caolan Loughran,Decision - Unanimous,80,15,0,95
Jake Hadley,2023-03-18,Malcolm Gordon,KO/TKO,100,7,0,107
Jake Hadley,2024-05-11,Charles Johnson,Decision - Unanimous,0,0,0,0
Jake Hadley,2023-08-05,Cody Durden,Decision - Unanimous,0,0,0,0
Jake Hadley,2021-10-12,Mitch Raposo,Submission,90,5,0,95
Carlos Candelario,2022-11-05,Jake Hadley,Submission,0,0,0,0
Carlos Candelario,2021-08-31,Victor Altamirano,Decision - Split,0,0,0,0
Carlos Candelario,2017-08-01,Ronaldo Candido,Decision - Unanimous,80,33,0,113
Carlos Candelario,2022-05-14,Tatsuro Taira,Decision - Unanimous,0,0,0,0
Pete Sell,2008-10-25,Joshua Burkman,Decision - Unanimous,80,15,0,95
Pete Sell,2005-08-06,Nate Quarry,KO/TKO,0,0,0,0
Pete Sell,2007-09-19,Nate Quarry,KO/TKO,0,0,0,0
Pete Sell,2005-02-05,Phil Baroni,Submission,90,0,0,90
Pete Sell,2007-04-07,Thales Leites,Decision - Unanimous,0,0,0,0
Pete Sell,2006-11-11,Scott Smith,KO/TKO,0,6,0,6
Pete Sell,2009-03-07,Matt Brown,KO/TKO,0,0,0,0
Masakatsu Funaki,2008-09-23,Ikuhisa Minowa,Submission,90,1,0,91
Masakatsu Funaki,2007-12-31,Kazushi Sakuraba,Submission,0,0,0,0
Masakatsu Funaki,2008-04-29,Kiyoshi Tamura,KO/TKO,0,0,0,0
Spencer Fisher,2009-06-13,Caol Uno,Decision - Unanimous,80,38,0,118
Spencer Fisher,2010-06-19,Dennis Siver,Decision - Unanimous,0,0,0,0
Spencer Fisher,2006-10-14,Dan Lauzon,KO/TKO,100,5,0,105
Spencer Fisher,2005-10-03,Thiago Alves,Submission,90,0,0,90
Spencer Fisher,2006-05-27,Matt Wiman,KO/TKO,100,17,0,117
Spencer Fisher,2008-10-25,Shannon Gugerty,Submission,90,2,0,92
Spencer Fisher,2008-06-21,Jeremy Stephens,Decision - Unanimous,80,33,0,113
Spencer Fisher,2006-03-04,Sam Stout,Decision - Split,0,0,0,0
Spencer Fisher,2012-06-22,Sam Stout,Decision - Unanimous,0,1,0,1
Spencer Fisher,2011-02-26,Ross Pearson,Decision - Unanimous,0,0,0,0
Spencer Fisher,2010-10-16,Curt Warburton,Decision - Unanimous,80,23,0,103
Spencer Fisher,2011-08-27,Thiago Tavares,KO/TKO,0,0,0,0
Spencer Fisher,2006-01-16,Aaron Riley,TKO - Doctor's Stoppage,0,16,0,16
Spencer Fisher,2007-01-25,Hermes Franca,KO/TKO,0,0,0,0
Spencer Fisher,2009-10-24,Joe Stevenson,KO/TKO,0,0,0,0
Spencer Fisher,2007-11-17,Frankie Edgar,Decision - Unanimous,0,0,0,0
Spencer Fisher,2007-06-12,Sam Stout,Decision - Unanimous,80,12,0,92
Laverne Clark,2000-04-14,Koji Oishi,Decision - Majority,75,12,0,87
Laverne Clark,1999-05-07,Fabiano Iha,TKO - Doctor's Stoppage,0,6,0,6
Laverne Clark,1999-01-08,Frank Caracci,KO/TKO,100,15,0,115
Laverne Clark,2000-09-22,Fabiano Iha,Submission,0,0,0,0
Koji Oishi,2000-04-14,Laverne Clark,Decision - Majority,0,0,0,0
Koji Oishi,2005-06-04,Nick Diaz,KO/TKO,0,0,0,0
David Velasquez,2000-03-10,Jens Pulver,KO/TKO,0,0,0,0
Felipe Lima,2024-12-14,Miles Johns,Decision - Unanimous,80,24,0,104
Felipe Lima,2024-06-22,Muhammad Naimov,Submission,90,7,0,97
Marlon Moraes,2019-06-08,Henry Cejudo,KO/TKO,0,0,25,25
Marlon Moraes,2021-09-25,Merab Dvalishvili,KO/TKO,0,0,0,0
Marlon Moraes,2019-12-14,Jose Aldo,Decision - Split,70,1,0,71
Marlon Moraes,2022-03-12,Song Yadong,KO/TKO,0,0,0,0
Marlon Moraes,2020-12-19,Rob Font,KO/TKO,0,0,0,0
Marlon Moraes,2020-10-10,Cory Sandhagen,KO/TKO,0,0,25,25
Marlon Moraes,2018-06-01,Jimmie Rivera,KO/TKO,100,7,25,132
Marlon Moraes,2017-11-11,John Dodson,Decision - Split,70,2,0,72
Marlon Moraes,2019-02-02,Raphael Assuncao,Submission,90,8,25,123
Marlon Moraes,2017-06-03,Raphael Assuncao,Decision - Split,0,1,0,1
Marlon Moraes,2017-12-09,Aljamain Sterling,KO/TKO,100,4,0,104
Chris Wade,2015-01-18,Zhang Lipeng,Decision - Unanimous,80,19,0,99
Chris Wade,2017-07-22,Frankie Perez,Decision - Unanimous,80,1,0,81
Chris Wade,2015-06-06,Christos Giagos,Decision - Unanimous,80,4,0,84
Chris Wade,2016-05-08,Rustam Khabilov,Decision - Unanimous,0,0,0,0
Chris Wade,2014-08-30,Cain Carrizosa,Submission,90,0,0,90
Chris Wade,2016-01-17,Mehdi Baghdad,Submission,90,4,0,94
Chris Wade,2016-09-17,Islam Makhachev,Decision - Unanimous,0,0,0,0
Zhang Lipeng,2015-01-18,Chris Wade,Decision - Unanimous,0,0,0,0
Zhang Lipeng,2015-05-16,Kajan Johnson,Decision - Unanimous,0,0,0,0
Zhang Lipeng,2014-03-01,Sai Wang,Decision - Split,70,0,0,70
Zhang Lipeng,2014-08-23,Brendan O'Reilly,Decision - Unanimous,80,4,0,84
Robert Whiteford,2015-10-24,Darren Elkins,Decision - Unanimous,0,0,0,0
Robert Whiteford,2013-10-26,Jimy Hettes,Submission,0,10,0,10
Robert Whiteford,2014-03-15,Daniel Pineda,Decision - Unanimous,80,2,0,82
Robert Whiteford,2016-04-10,Lucas Martins,Decision - Split,0,15,0,15
Robert Whiteford,2015-07-18,Paul Redmond,KO/TKO,100,9,0,109
Michael McBride,2017-04-22,Scott Holtzman,Decision - Unanimous,0,0,0,0
Michael McBride,2016-09-10,Nik Lentz,KO/TKO,0,0,0,0
Steve Bosse,2016-03-19,James Te Huna,KO/TKO,100,4,0,104
Steve Bosse,2016-06-18,Sean O'Connell,Decision - Unanimous,80,9,0,89
Steve Bosse,2015-06-27,Thiago Santos,KO/TKO,0,0,0,0
Julia Avila,2020-09-12,Sijara Eubanks,Decision - Unanimous,0,0,0,0
Julia Avila,2020-06-13,Gina Mazany,KO/TKO,100,9,0,109
Julia Avila,2019-07-06,Pannie Kianzad,Decision - Unanimous,80,16,0,96
Julia Avila,2023-12-02,Miesha Tate,Submission,0,0,0,0
Julia Avila,2021-06-26,Julija Stoliarenko,Submission,90,8,0,98
Jesus Pinedo,2019-03-23,John Makdessi,Decision - Unanimous,0,0,0,0
Jesus Pinedo,2018-11-17,Devin Powell,Decision - Unanimous,80,2,0,82
Art Jimmerson,1993-11-12,Royce Gracie,Submission,0,0,0,0
Harris Sarmiento,2006-03-10,Gilbert Melendez,KO/TKO,0,0,0,0
Harris Sarmiento,2006-06-09,Josh Thomson,Submission,0,0,0,0
Frank Gomez,2010-06-20,Wagnney Fabiano,Decision - Unanimous,0,0,0,0
Frank Gomez,2009-06-07,Noah Thomas,Submission,90,30,0,120
Frank Gomez,2009-01-25,Scott Jorgensen,Submission,0,0,0,0
Frank Gomez,2009-11-18,Seth Dikun,Decision - Unanimous,80,6,0,86
Abubakar Nurmagomedov,2022-10-22,Gadzhi Omargadzhiev,Decision - Unanimous,80,2,0,82
Abubakar Nurmagomedov,2023-06-03,Elizeu Zaleski dos Santos,Decision - Split,0,0,0,0
Abubakar Nurmagomedov,2021-03-27,Jared Gooden,Decision - Unanimous,80,17,0,97
Abubakar Nurmagomedov,2019-11-09,David Zawada,Submission,0,2,0,2
Ismael Bonfim,2022-09-06,Nariman Abbasov,Decision - Unanimous,80,40,0,120
Ismael Bonfim,2023-07-01,Benoit Saint Denis,Submission,0,1,0,1
Ismael Bonfim,2023-01-21,Terrance McKinney,KO/TKO,100,20,0,120
Ismael Bonfim,2024-05-04,Vinc Pichel,Decision - Unanimous,80,50,0,130
Nariman Abbasov,2022-09-06,Ismael Bonfim,Decision - Unanimous,0,0,0,0
Matt Foki,2004-05-23,Aleksander Emelianenko,Submission,0,0,0,0
Tom Nolan,2024-08-17,Alex Reyes,Decision - Unanimous,80,15,0,95
Tom Nolan,2024-05-18,Victor Martinez,KO/TKO,100,15,0,115
Tom Nolan,2023-08-08,Bogdan Grad,KO/TKO,100,11,0,111
Tom Nolan,2024-01-13,Nikolas Motta,KO/TKO,0,0,0,0
Alex Reyes,2024-08-17,Tom Nolan,Decision - Unanimous,0,0,0,0
Alex Reyes,2023-09-16,Charlie Campbell,KO/TKO,0,0,0,0
Alex Reyes,2017-09-16,Mike Perry,KO/TKO,0,0,0,0
Juan Adams,2018-07-31,Shawn Teed,KO/TKO,100,51,0,151
Juan Adams,2018-12-15,Chris de la Rocha,KO/TKO,100,45,0,145
Juan Adams,2019-07-20,Greg Hardy,KO/TKO,0,0,0,0
Juan Adams,2020-02-08,Justin Tafa,KO/TKO,0,0,0,0
Juan Adams,2019-05-04,Arjan Bhullar,Decision - Unanimous,0,40,0,40
Shawn Teed,2018-07-31,Juan Adams,KO/TKO,0,0,0,0
Kim In Seok,2005-05-22,Tatsuya Kawajiri,KO/TKO,0,0,0,0
Miguel Torres,2011-02-05,Antonio Banuelos,Decision - Unanimous,80,63,0,143
Miguel Torres,2011-05-28,Demetrious Johnson,Decision - Unanimous,0,0,0,0
Miguel Torres,2008-02-13,Chase Beebe,Submission,90,3,25,118
Miguel Torres,2010-09-30,Charlie Valencia,Submission,90,16,0,106
Miguel Torres,2009-08-09,Brian Bowles,KO/TKO,0,0,25,25
Miguel Torres,2007-09-05,Jeff Bedard,Submission,90,0,0,90
Miguel Torres,2010-03-06,Joseph Benavidez,Submission,0,2,0,2
Miguel Torres,2009-04-05,Takeya Mizugaki,Decision - Unanimous,80,75,25,180
Miguel Torres,2012-04-21,Michael McDonald,KO/TKO,0,0,0,0
Miguel Torres,2008-06-01,Yoshiro Maeda,TKO - Doctor's Stoppage,0,47,25,72
Miguel Torres,2011-11-19,Nick Pace,Decision - Unanimous,80,33,0,113
Miguel Torres,2008-12-03,Manny Tapia,KO/TKO,100,38,25,163
Rex Richards,2007-06-22,Ray Seraille,KO/TKO,100,7,0,107
Ray Seraille,2007-06-22,Rex Richards,KO/TKO,0,0,0,0
Ailin Perez,2022-09-03,Stephanie Egger,Submission,0,1,0,1
Ailin Perez,2023-07-15,Ashlee Evans-Smith,Decision - Unanimous,80,48,0,128
Ailin Perez,2024-09-28,Daria Zhelezniakova,Submission,90,2,0,92
Ailin Perez,2023-11-18,Lucie Pudilova,Decision - Unanimous,80,22,0,102
Ailin Perez,2024-06-01,Joselyne Edwards,Decision - Unanimous,80,15,0,95
Takeshi Yamazaki,2008-05-11,Shoji Maruyama,Decision - Unanimous,80,0,0,80
Takeshi Yamazaki,2008-07-21,Hideo Tokoro,Decision - Unanimous,0,0,0,0
Shoji Maruyama,2008-05-11,Takeshi Yamazaki,Decision - Unanimous,0,17,0,17
Vinc Pichel,2018-01-27,Joaquim Silva,Decision - Unanimous,80,15,0,95
Vinc Pichel,2018-06-01,Gregor Gillespie,Submission,0,0,0,0
Vinc Pichel,2024-05-04,Ismael Bonfim,Decision - Unanimous,0,0,0,0
Vinc Pichel,2021-08-21,Austin Hubbard,Decision - Unanimous,80,15,0,95
Vinc Pichel,2019-06-29,Roosevelt Roberts,Decision - Unanimous,80,29,0,109
Vinc Pichel,2017-06-10,Damien Brown,KO/TKO,100,0,0,100
Vinc Pichel,2022-04-09,Mark Madsen,Decision - Unanimous,0,29,0,29
Vinc Pichel,2012-12-15,Rustam Khabilov,KO/TKO,0,0,0,0
Vinc Pichel,2014-05-24,Anthony Njokuani,Decision - Unanimous,80,33,0,113
Vinc Pichel,2014-01-15,Garett Whiteley,Decision - Unanimous,80,0,0,80
Vinc Pichel,2020-08-15,Jim Miller,Decision - Unanimous,80,27,0,107
Melsik Baghdasaryan,2020-09-01,Dennis Buzukja,Decision - Unanimous,80,45,0,125
Melsik Baghdasaryan,2023-02-11,Josh Culibao,Submission,0,10,0,10
Melsik Baghdasaryan,2023-07-15,Tucker Lutz,Decision - Unanimous,80,28,0,108
Melsik Baghdasaryan,2021-11-06,Bruno Souza,Decision - Unanimous,80,29,0,109
Melsik Baghdasaryan,2021-07-31,Collin Anglin,KO/TKO,100,19,0,119
Jacob Malkoun,2024-03-30,Andre Petroski,KO/TKO,100,7,0,107
Jacob Malkoun,2022-02-12,AJ Dobson,Decision - Unanimous,80,28,0,108
Jacob Malkoun,2021-04-17,Abdul Razak Alhassan,Decision - Unanimous,80,6,0,86
Jacob Malkoun,2020-10-24,Phil Hawes,KO/TKO,0,0,0,0
Jacob Malkoun,2022-10-15,Nick Maximov,Decision - Unanimous,80,49,0,129
Jacob Malkoun,2022-06-11,Brendan Allen,Decision - Unanimous,0,0,0,0
Jacob Malkoun,2023-09-23,Cody Brundage,DQ,0,26,0,26
Dennis Bermudez,2013-11-06,Steven Siler,Decision - Unanimous,80,21,0,101
Dennis Bermudez,2017-02-04,Chan Sung Jung,KO/TKO,0,3,25,28
Dennis Bermudez,2013-02-23,Matt Grice,Decision - Split,70,38,0,108
Dennis Bermudez,2017-07-22,Darren Elkins,Decision - Split,0,0,0,0
Dennis Bermudez,2018-07-14,Ricky Glenn,Decision - Split,0,0,0,0
Dennis Bermudez,2014-11-15,Ricardo Lamas,Submission,0,0,0,0
Dennis Bermudez,2011-12-03,Diego Brandao,Submission,0,6,0,6
Dennis Bermudez,2014-03-15,Jimy Hettes,KO/TKO,100,21,0,121
Dennis Bermudez,2015-07-11,Jeremy Stephens,KO/TKO,0,0,0,0
Dennis Bermudez,2016-02-21,Tatsuya Kawajiri,Decision - Unanimous,80,49,0,129
Dennis Bermudez,2019-01-19,Te Edwards,Decision - Unanimous,80,40,0,120
Dennis Bermudez,2018-01-27,Andre Fili,Decision - Split,0,23,0,23
Dennis Bermudez,2013-05-25,Max Holloway,Decision - Split,70,0,0,70
Dennis Bermudez,2014-07-26,Clay Guida,Submission,90,19,0,109
Dennis Bermudez,2012-08-11,Tommy Hayden,Submission,90,6,0,96
Dennis Bermudez,2012-05-05,Pablo Garza,Decision - Unanimous,80,18,0,98
Dennis Bermudez,2016-08-06,Rony Jason,Decision - Unanimous,80,39,0,119
Anthony Morrison,2010-04-24,Chad Mendes,Submission,0,3,0,3
Anthony Morrison,2010-01-10,Mike Brown,Submission,0,2,0,2
Bret Bergmark,2005-10-14,Mike Pyle,Submission,0,0,0,0
Pawel Nastula,2005-06-26,Antonio Rodrigo Nogueira,KO/TKO,0,0,0,0
Pawel Nastula,2006-10-21,Josh Barnett,Submission,0,0,0,0
Pawel Nastula,2005-12-31,Aleksander Emelianenko,Submission,0,0,0,0
Pawel Nastula,2006-07-01,Edson Drago,Submission,90,10,0,100
Benardo Sopaj,2024-03-02,Vinicius Oliveira,KO/TKO,0,0,0,0
Brandon Moreno,2022-01-22,Deiveson Figueiredo,Decision - Unanimous,0,19,25,44
Brandon Moreno,2016-10-01,Louis Smolka,Submission,90,1,0,91
Brandon Moreno,2020-03-14,Jussier Formiga,Decision - Unanimous,80,18,0,98
Brandon Moreno,2020-11-21,Brandon Royval,KO/TKO,100,0,0,100
Brandon Moreno,2024-11-02,Amir Albazi,Decision - Unanimous,80,69,25,174
Brandon Moreno,2024-02-24,Brandon Royval,Decision - Split,0,0,25,25
Brandon Moreno,2022-07-30,Kai Kara-France,KO/TKO,100,5,25,130
Brandon Moreno,2018-05-19,Alexandre Pantoja,Decision - Unanimous,0,0,0,0
Brandon Moreno,2016-12-03,Ryan Benoit,Decision - Split,70,31,0,101
Brandon Moreno,2017-04-22,Dustin Ortiz,Submission,90,8,0,98
Brandon Moreno,2017-08-05,Sergio Pettis,Decision - Unanimous,0,0,25,25
Brandon Moreno,2019-12-14,Kai Kara-France,Decision - Unanimous,80,9,0,89
Brandon Moreno,2021-06-12,Deiveson Figueiredo,Submission,90,23,25,138
Brandon Moreno,2023-07-08,Alexandre Pantoja,Decision - Split,0,18,25,43
Brandon Moreno,2023-01-21,Deiveson Figueiredo,TKO - Doctor's Stoppage,0,29,25,54
Ricardo Prasel,2019-07-16,Don'Tale Mayes,KO/TKO,0,0,0,0
Omar Morales,2023-03-18,Chris Duncan,Decision - Split,0,0,0,0
Omar Morales,2020-05-13,Gabriel Benitez,Decision - Unanimous,80,13,0,93
Omar Morales,2019-12-21,Dong Hyun Ma,Decision - Unanimous,80,17,0,97
Omar Morales,2020-10-10,Giga Chikadze,Decision - Unanimous,0,0,0,0
Omar Morales,2021-09-25,Jonathan Pearce,Submission,0,0,0,0
Omar Morales,2022-05-21,Uros Medic,KO/TKO,0,0,0,0
Omar Morales,2019-08-06,Harvey Park,KO/TKO,100,21,0,121
Omar Morales,2021-03-27,Shane Young,Decision - Unanimous,80,23,0,103
Brendan Seguin,2007-01-20,Fernando Gonzalez,Decision - Unanimous,80,30,0,110
Jarno Errens,2024-08-10,Youssef Zalal,Submission,0,0,0,0
Jarno Errens,2023-08-26,SeungWoo Choi,Decision - Unanimous,0,0,0,0
Jarno Errens,2022-09-03,William Gomis,Decision - Unanimous,0,0,0,0
Jarno Errens,2024-03-23,Steven Nguyen,Decision - Unanimous,80,42,0,122
Darko Stosic,2019-08-03,Kennedy Nzechukwu,Decision - Unanimous,0,10,0,10
Darko Stosic,2019-06-01,Devin Clark,Decision - Unanimous,0,0,0,0
Darko Stosic,2018-07-22,Jeremy Kimball,KO/TKO,100,5,0,105
Darko Stosic,2020-01-25,Jamahal Hill,Decision - Unanimous,0,0,0,0
Jared Vanderaa,2022-07-09,Chase Sherman,KO/TKO,0,0,0,0
Jared Vanderaa,2021-02-20,Serghei Spivac,KO/TKO,0,0,0,0
Jared Vanderaa,2020-11-04,Harry Hunsucker,KO/TKO,100,6,0,106
Jared Vanderaa,2022-02-12,Andrei Arlovski,Decision - Split,0,6,0,6
Jared Vanderaa,2021-10-09,Alexandr Romanov,KO/TKO,0,0,0,0
Jared Vanderaa,2022-10-29,Waldo Cortes-Acosta,Decision - Unanimous,0,0,0,0
Jared Vanderaa,2021-05-22,Justin Tafa,Decision - Unanimous,80,47,0,127
Jared Vanderaa,2022-04-09,Aleksei Oleinik,Submission,0,7,0,7
Da Woon Jung,2021-04-10,William Knight,Decision - Unanimous,80,11,0,91
Da Woon Jung,2022-07-16,Dustin Jacoby,KO/TKO,0,0,0,0
Da Woon Jung,2023-09-09,Carlos Ulberg,Submission,0,0,0,0
Da Woon Jung,2021-11-13,Kennedy Nzechukwu,KO/TKO,100,10,0,110
Da Woon Jung,2023-02-04,Devin Clark,Decision - Unanimous,0,0,0,0
Da Woon Jung,2019-08-31,Khadis Ibragimov,Submission,90,0,0,90
Da Woon Jung,2019-12-21,Mike Rodriguez,KO/TKO,100,1,0,101
Da Woon Jung,2024-09-28,Oumar Sy,Decision - Unanimous,0,0,0,0
Rolando Delgado,2009-06-13,Paul Kelly,Decision - Unanimous,0,0,0,0
Rolando Delgado,2008-12-13,John Polakowski,Submission,90,14,0,104
Rolando Delgado,2009-11-14,Andre Winner,KO/TKO,0,0,0,0
Steve Mensing,2008-03-02,Gegard Mousasi,KO/TKO,0,0,0,0
Kali Robbins,2019-06-18,Hannah Goldy,Decision - Unanimous,0,0,0,0
Jose Quinonez,2020-03-07,Sean O'Malley,KO/TKO,0,0,0,0
Jose Quinonez,2019-09-21,Carlos Huachin,Decision - Unanimous,80,28,0,108
Jose Quinonez,2014-11-15,Alejandro Perez,Decision - Unanimous,0,0,0,0
Jose Quinonez,2020-12-05,Louis Smolka,KO/TKO,0,0,0,0
Jose Quinonez,2015-06-06,Leonardo Morales,Submission,90,0,0,90
Jose Quinonez,2018-02-10,Teruto Ishihara,Decision - Unanimous,80,16,0,96
Jose Quinonez,2019-03-16,Nathaniel Wood,Submission,0,4,0,4
Jose Quinonez,2016-09-17,Joey Gomez,Decision - Unanimous,80,12,0,92
Jose Quinonez,2017-08-05,Diego Rivas,Decision - Unanimous,80,32,0,112
Shane del Rosario,2012-05-26,Stipe Miocic,KO/TKO,0,0,0,0
Shane del Rosario,2012-12-15,Pat Barry,KO/TKO,0,3,0,3
Shane del Rosario,2010-07-23,Lolohea Mahe,KO/TKO,100,21,0,121
Shane del Rosario,2009-11-06,Brandon Cash,Submission,90,0,0,90
Shane del Rosario,2011-02-12,Lavar Johnson,Submission,90,14,0,104
Andre Amado,2009-07-20,Katsunori Kikuno,KO/TKO,0,0,0,0
Andre Amado,2008-03-15,Eddie Alvarez,KO/TKO,0,0,0,0
Andre Amado,2010-03-22,KJ Noons,Decision - Unanimous,0,0,0,0
Eldari Kurtanidze,2006-12-31,Kazuyuki Fujita,KO/TKO,0,0,0,0
Johnny Rhodes,1994-03-11,David Levicki,KO/TKO,100,7,0,107
Johnny Rhodes,1994-03-11,Fred Ettish,Submission,90,9,0,99
Johnny Rhodes,1994-03-11,Patrick Smith,Submission,0,0,0,0
David Levicki,1994-03-11,Johnny Rhodes,KO/TKO,0,0,0,0
Adriano Martins,2017-09-09,Kajan Johnson,KO/TKO,0,0,0,0
Adriano Martins,2014-01-25,Donald Cerrone,KO/TKO,0,0,0,0
Adriano Martins,2016-10-08,Leonardo Santos,Decision - Split,0,11,0,11
Adriano Martins,2015-10-03,Islam Makhachev,KO/TKO,100,0,0,100
Adriano Martins,2015-02-22,Rustam Khabilov,Decision - Split,70,0,0,70
Adriano Martins,2014-07-06,Juan Manuel Puig,KO/TKO,100,0,0,100
Adriano Martins,2013-11-09,Daron Cruickshank,Submission,90,8,0,98
Adriano Martins,2008-09-23,Keita Nakamura,Decision - Split,0,0,0,0
Jason Ireland,2007-02-24,Joachim Hansen,Submission,0,0,0,0
Aliev Makhmud,2005-02-20,Kiyoshi Tamura,KO/TKO,0,0,0,0
Keith Hackney,1994-12-16,Joe Son,Submission,90,8,0,98
Keith Hackney,1994-12-16,Royce Gracie,Submission,0,0,0,0
Keith Hackney,1994-09-09,Emmanuel Yarborough,KO/TKO,100,33,0,133
Keith Hackney,1995-12-16,Marco Ruas,Submission,0,0,0,0
Joe Son,1994-12-16,Keith Hackney,Submission,0,0,0,0
Sergey Morozov,2022-12-17,Journey Newson,Decision - Unanimous,80,4,0,84
Sergey Morozov,2022-06-25,Raulian Paiva,Decision - Unanimous,80,5,0,85
Sergey Morozov,2021-07-17,Khalid Taha,Decision - Unanimous,80,17,0,97
Sergey Morozov,2022-02-12,Douglas Silva de Andrade,Submission,0,0,0,0
Sergey Morozov,2021-01-20,Umar Nurmagomedov,Submission,0,0,0,0
Journey Newson,2022-12-17,Sergey Morozov,Decision - Unanimous,0,0,0,0
Journey Newson,2019-06-29,Ricardo Ramos,Decision - Unanimous,0,0,0,0
Journey Newson,2023-04-29,Marcus McGhee,Submission,0,0,0,0
Journey Newson,2022-05-07,Fernie Garcia,Decision - Unanimous,80,20,0,100
Journey Newson,2020-09-19,Randy Costa,KO/TKO,0,0,0,0
Carlston Harris,2023-03-11,Jared Gooden,Decision - Unanimous,80,12,0,92
Carlston Harris,2023-08-05,Jeremiah Wells,Submission,90,0,0,90
Carlston Harris,2024-05-18,Khaos Williams,KO/TKO,0,2,0,2
Carlston Harris,2022-02-05,Shavkat Rakhmonov,KO/TKO,0,0,0,0
Carlston Harris,2021-05-08,Christian Aguilera,Submission,90,4,0,94
Carlston Harris,2021-09-18,Impa Kasanganay,KO/TKO,100,18,0,118
Payton Talbott,2023-08-08,Reyes Cortez Jr.,Decision - Unanimous,80,69,0,149
Payton Talbott,2024-06-29,Yanis Ghemmouri,KO/TKO,100,12,0,112
Payton Talbott,2023-11-18,Nick Aguirre,Submission,90,23,0,113
Payton Talbott,2024-03-23,Cameron Saaiman,KO/TKO,100,48,0,148
Reyes Cortez Jr.,2023-08-08,Payton Talbott,Decision - Unanimous,0,0,0,0
Reyes Cortez Jr.,2021-10-12,Christian Rodriguez,Decision - Unanimous,0,0,0,0
Milana Dudieva,2015-04-04,Julianna Pena,KO/TKO,0,0,0,0
Milana Dudieva,2016-11-19,Marion Reneau,KO/TKO,0,0,0,0
Milana Dudieva,2014-08-23,Elizabeth Phillips,Decision - Split,70,0,0,70
Justin Frazier,2018-11-30,Juan Espino,Submission,0,0,0,0
Mike Ricci,2013-03-16,Colin Fletcher,Decision - Unanimous,80,10,0,90
Mike Ricci,2013-09-21,Myles Jury,Decision - Split,0,3,0,3
Mike Ricci,2012-12-15,Colton Smith,Decision - Unanimous,0,0,0,0
Kelly Faszholz,2016-02-21,Lauren Murphy,KO/TKO,0,0,0,0
Kelly Faszholz,2016-10-01,Ketlen Vieira,Decision - Split,0,31,0,31
James Irvin,2007-05-26,Thiago Silva,KO/TKO,0,2,0,2
James Irvin,2006-01-16,Stephan Bonnar,Submission,0,3,0,3
James Irvin,2006-11-18,Hector Ramirez,KO/TKO,100,0,0,100
James Irvin,2008-07-19,Anderson Silva,KO/TKO,0,0,0,0
James Irvin,2005-02-05,Mike Kyle,KO/TKO,0,0,0,0
James Irvin,2005-08-20,Terry Martin,KO/TKO,100,0,0,100
James Irvin,2007-12-29,Luiz Cane,DQ,0,0,0,0
James Irvin,2010-03-21,Alessio Sakara,KO/TKO,0,0,0,0
James Irvin,2010-08-01,Igor Pokrajac,Submission,0,0,0,0
James Irvin,2008-04-02,Houston Alexander,KO/TKO,100,3,0,103
Leonardo Mafra,2012-06-23,Thiago Perpetuo,KO/TKO,0,0,0,0
Leonardo Mafra,2014-07-16,Rick Story,Submission,0,0,0,0
Leonardo Mafra,2015-07-18,Stevie Ray,KO/TKO,0,4,0,4
Leonardo Mafra,2015-03-21,Cain Carrizosa,Decision - Unanimous,80,50,0,130
Cody Pfister,2015-12-10,Sage Northcutt,Submission,0,0,0,0
Cody Pfister,2015-07-11,Yosdenis Cedeno,Decision - Unanimous,80,0,0,80
Cody Pfister,2016-07-13,Scott Holtzman,Decision - Unanimous,0,0,0,0
Cody Pfister,2015-02-14,James Moontasri,Submission,0,0,0,0
Tony DeSouza,2006-12-30,Thiago Alves,KO/TKO,0,0,0,0
Tony DeSouza,2007-12-29,Roan Carneiro,KO/TKO,0,0,0,0
Tony DeSouza,2001-05-04,Steve Berger,Decision - Unanimous,80,26,0,106
Tony DeSouza,2006-10-10,Dustin Hazelett,Submission,90,4,0,94
Tony DeSouza,2001-09-28,Jutaro Nakao,KO/TKO,0,0,0,0
Tony DeSouza,2001-06-29,Paul Rodriguez,Submission,90,0,0,90
Colton Smith,2014-06-28,Diego Ferreira,Submission,0,0,0,0
Colton Smith,2012-12-15,Mike Ricci,Decision - Unanimous,80,6,0,86
Colton Smith,2013-05-25,Robert Whittaker,KO/TKO,0,0,0,0
Colton Smith,2013-11-06,Michael Chiesa,Submission,0,0,0,0
Takayo Hashi,2010-02-26,Sarah Kaufman,Decision - Unanimous,0,0,25,25
David Teymur,2016-08-06,Jason Novelli,KO/TKO,100,18,0,118
David Teymur,2018-06-01,Nik Lentz,Decision - Unanimous,80,6,0,86
David Teymur,2019-02-02,Charles Oliveira,Submission,0,0,0,0
David Teymur,2017-03-04,Lando Vannata,Decision - Unanimous,80,14,0,94
David Teymur,2017-12-02,Drakkar Klose,Decision - Unanimous,80,13,0,93
David Teymur,2016-02-27,Martin Svensson,KO/TKO,100,25,0,125
Jason Novelli,2016-08-06,David Teymur,KO/TKO,0,0,0,0
Jason Novelli,2016-11-05,Marco Polo Reyes,Decision - Split,0,0,0,0
Bobby Moffett,2018-08-07,Jacob Kilburn,Submission,90,22,0,112
Bobby Moffett,2019-03-23,Bryce Mitchell,Decision - Unanimous,0,0,0,0
Bobby Moffett,2019-08-10,Enrique Barzola,Decision - Split,0,7,0,7
Gustavo Lopez,2020-11-07,Anthony Birchak,Submission,90,9,0,99
Gustavo Lopez,2021-03-20,Adrian Yanez,KO/TKO,0,0,0,0
Gustavo Lopez,2020-06-13,Merab Dvalishvili,Decision - Unanimous,0,0,0,0
Anthony Birchak,2020-11-07,Gustavo Lopez,Submission,0,0,0,0
Anthony Birchak,2015-06-06,Joe Soto,KO/TKO,100,15,0,115
Anthony Birchak,2016-07-07,Dileno Lopes,Decision - Split,70,16,0,86
Anthony Birchak,2015-11-07,Thomas Almeida,KO/TKO,0,3,0,3
Anthony Birchak,2021-04-17,Tony Gravely,KO/TKO,0,0,0,0
Anthony Birchak,2014-12-13,Ian Entwistle,Submission,0,4,0,4
Andrea Lee,2020-02-08,Lauren Murphy,Decision - Split,0,24,0,24
Andrea Lee,2021-11-13,Cynthia Calvillo,KO/TKO,100,37,0,137
Andrea Lee,2019-02-17,Ashlee Evans-Smith,Decision - Unanimous,80,45,0,125
Andrea Lee,2024-02-17,Miranda Maverick,Decision - Unanimous,0,0,0,0
Andrea Lee,2024-06-08,Montana De La Rosa,Decision - Split,0,5,0,5
Andrea Lee,2023-03-25,Maycee Barber,Decision - Split,0,0,0,0
Andrea Lee,2023-08-19,Natalia Silva,Decision - Unanimous,0,0,0,0
Andrea Lee,2022-05-14,Viviane Araujo,Decision - Unanimous,0,8,0,8
Andrea Lee,2019-09-07,Joanne Wood,Decision - Split,0,0,0,0
Andrea Lee,2020-09-12,Roxanne Modafferi,Decision - Unanimous,0,37,0,37
Andrea Lee,2018-05-19,Veronica Hardy,Decision - Unanimous,80,32,0,112
Andrea Lee,2021-05-15,Antonina Shevchenko,Submission,90,22,0,112
Andrea Lee,2019-06-22,Montana De La Rosa,Decision - Unanimous,80,59,0,139
Raulian Paiva,2019-08-10,Rogerio Bontorin,TKO - Doctor's Stoppage,0,0,0,0
Raulian Paiva,2022-06-25,Sergey Morozov,Decision - Unanimous,0,0,0,0
Raulian Paiva,2021-12-11,Sean O'Malley,KO/TKO,0,0,0,0
Raulian Paiva,2020-02-15,Mark De La Rosa,KO/TKO,100,9,0,109
Raulian Paiva,2019-02-09,Kai Kara-France,Decision - Split,0,9,0,9
Raulian Paiva,2021-07-24,Kyler Phillips,Decision - Majority,75,0,0,75
Raulian Paiva,2018-08-12,Allan Nascimento,Decision - Split,70,0,0,70
Raulian Paiva,2020-07-11,Zhalgas Zhumagulov,Decision - Unanimous,80,0,0,80
Valentina Shevchenko,2017-09-09,Amanda Nunes,Decision - Split,0,0,25,25
Valentina Shevchenko,2020-11-21,Jennifer Maia,Decision - Unanimous,80,26,25,131
Valentina Shevchenko,2016-03-05,Amanda Nunes,Decision - Unanimous,0,0,0,0
Valentina Shevchenko,2015-12-19,Sarah Kaufman,Decision - Split,70,5,0,75
Valentina Shevchenko,2017-01-28,Julianna Pena,Submission,90,0,25,115
Valentina Shevchenko,2023-03-04,Alexa Grasso,Submission,0,28,25,53
Valentina Shevchenko,2016-07-23,Holly Holm,Decision - Unanimous,80,33,25,138
Valentina Shevchenko,2019-08-10,Liz Carmouche,Decision - Unanimous,80,24,25,129
Valentina Shevchenko,2021-09-25,Lauren Murphy,KO/TKO,100,87,25,212
Valentina Shevchenko,2024-09-14,Alexa Grasso,Decision - Unanimous,80,27,25,132
Valentina Shevchenko,2018-12-08,Joanna Jedrzejczyk,Decision - Unanimous,80,11,25,116
Valentina Shevchenko,2019-06-08,Jessica Eye,KO/TKO,100,6,25,131
Valentina Shevchenko,2021-04-24,Jessica Andrade,KO/TKO,100,22,25,147
Valentina Shevchenko,2018-02-03,Priscila Cachoeira,Submission,90,93,0,183
Valentina Shevchenko,2020-02-08,Katlyn Cerminara,KO/TKO,100,23,25,148
Valentina Shevchenko,2022-06-11,Taila Santos,Decision - Split,70,22,25,117
Ashlee Evans-Smith,2023-07-15,Ailin Perez,Decision - Unanimous,0,0,0,0
Ashlee Evans-Smith,2019-02-17,Andrea Lee,Decision - Unanimous,0,0,0,0
Ashlee Evans-Smith,2016-09-03,Veronica Hardy,KO/TKO,100,50,0,150
Ashlee Evans-Smith,2017-09-09,Sarah Moras,Submission,0,0,0,0
Ashlee Evans-Smith,2017-04-15,Ketlen Vieira,Decision - Unanimous,0,0,0,0
Ashlee Evans-Smith,2014-12-06,Raquel Pennington,Submission,0,6,0,6
Ashlee Evans-Smith,2016-02-21,Marion Reneau,Decision - Split,70,2,0,72
Ashlee Evans-Smith,2020-11-28,Norma Dumont,Decision - Unanimous,0,0,0,0
Ashlee Evans-Smith,2018-04-07,Bec Rawlings,Decision - Unanimous,80,28,0,108
Yusup Saadulaev,2011-12-31,Hideo Tokoro,KO/TKO,100,5,0,105
Yusup Saadulaev,2011-09-24,Rodolfo Marques Diniz,Decision - Unanimous,0,0,0,0
James Zikic,2007-09-22,Vitor Belfort,Decision - Unanimous,0,0,0,0
James Zikic,2002-07-13,Phillip Miller,Decision - Unanimous,0,0,0,0
Khalid Taha,2022-09-03,Cristian Quinonez,KO/TKO,0,0,0,0
Khalid Taha,2018-07-22,Nad Narimani,Decision - Unanimous,0,0,0,0
Khalid Taha,2021-07-17,Sergey Morozov,Decision - Unanimous,0,0,0,0
Khalid Taha,2020-11-07,Raoni Barcelos,Decision - Unanimous,0,0,0,0
Khalid Taha,2019-04-13,Boston Salmon,KO/TKO,100,5,0,105
Roland Payne,1994-09-09,Harold Howard,KO/TKO,0,0,0,0
Joey Gomez,2018-07-10,Kevin Aguilar,Decision - Split,0,6,0,6
Joey Gomez,2016-01-17,Rob Font,KO/TKO,0,0,0,0
Joey Gomez,2016-09-17,Jose Quinonez,Decision - Unanimous,0,0,0,0
Charles Johnson,2024-02-03,Azat Maksum,Decision - Unanimous,80,38,0,118
Charles Johnson,2023-04-29,Cody Durden,Decision - Unanimous,0,0,0,0
Charles Johnson,2023-01-14,Jimmy Flick,KO/TKO,100,27,0,127
Charles Johnson,2022-11-19,Zhalgas Zhumagulov,Decision - Split,70,0,0,70
Charles Johnson,2023-11-18,Rafael Estevam,Decision - Unanimous,0,54,0,54
Charles Johnson,2024-07-13,Joshua Van,KO/TKO,100,21,0,121
Charles Johnson,2023-02-25,Ode Osbourne,Decision - Split,0,12,0,12
Charles Johnson,2024-10-19,Sumudaerji,Decision - Unanimous,80,0,0,80
Charles Johnson,2024-05-11,Jake Hadley,Decision - Unanimous,80,22,0,102
Charles Johnson,2022-07-23,Muhammad Mokaev,Decision - Unanimous,0,0,0,0
Kazuhiro Hamanaka,2003-10-05,Ryan Gracie,KO/TKO,0,0,0,0
Kazuhiro Hamanaka,2003-06-08,Antonio Schembri,Decision - Unanimous,80,30,0,110
Tommy Lee,2007-03-24,Cub Swanson,Submission,0,0,0,0
Mark Schultz,1996-05-17,Gary Goodridge,TKO - Doctor's Stoppage,0,7,0,7
Tyler Diamond,2018-07-06,Bryce Mitchell,Decision - Majority,0,13,0,13
Shonie Carter,2005-06-04,Nate Quarry,KO/TKO,0,0,0,0
Shonie Carter,2001-06-29,Pat Miletich,KO/TKO,0,4,0,4
Shonie Carter,2006-12-13,Marcus Davis,Decision - Unanimous,0,0,0,0
Shonie Carter,2000-06-09,Adrian Serrano,Decision - Unanimous,80,20,0,100
Shonie Carter,2000-03-10,Brad Gumm,Decision - Unanimous,80,10,0,90
Shonie Carter,2001-05-04,Matt Serra,KO/TKO,100,8,0,108
Modestas Bukauskas,2023-02-11,Tyson Pedro,Decision - Unanimous,80,0,0,80
Modestas Bukauskas,2021-09-04,Khalil Rountree Jr.,KO/TKO,0,0,0,0
Modestas Bukauskas,2020-10-17,Jimmy Crute,KO/TKO,0,0,0,0
Modestas Bukauskas,2023-06-17,Zac Pauga,Decision - Unanimous,80,0,0,80
Modestas Bukauskas,2023-11-04,Vitor Petrino,KO/TKO,0,1,0,1
Modestas Bukauskas,2021-03-27,Michal Oleksiejczuk,Decision - Split,0,2,0,2
Modestas Bukauskas,2020-07-15,Andreas Michailidis,KO/TKO,100,0,0,100
Modestas Bukauskas,2024-07-27,Marcin Prachnio,Submission,90,0,0,90
Ryan Benoit,2013-11-30,Josh Sampo,Submission,0,0,0,0
Ryan Benoit,2016-07-30,Fredy Serrano,Decision - Split,70,9,0,79
Ryan Benoit,2017-11-18,Ashkan Mokhtarian,KO/TKO,100,3,0,103
Ryan Benoit,2015-03-14,Sergio Pettis,KO/TKO,100,0,0,100
Ryan Benoit,2020-07-15,Tim Elliott,Decision - Unanimous,0,0,0,0
Ryan Benoit,2016-12-03,Brandon Moreno,Decision - Split,0,0,0,0
Ryan Benoit,2021-07-31,Zarrukh Adashev,Decision - Unanimous,0,0,0,0
Ryan Benoit,2015-11-14,Ben Nguyen,Submission,0,0,0,0
Ryan Benoit,2019-12-21,Alatengheili,Decision - Split,0,21,0,21
Zachary Scroggin,2024-11-09,Elizeu Zaleski dos Santos,KO/TKO,0,0,0,0
Luana Pinheiro,2021-05-01,Randa Markos,DQ,0,11,0,11
Luana Pinheiro,2024-11-09,Gillian Robertson,Decision - Unanimous,0,0,0,0
Luana Pinheiro,2023-11-18,Amanda Ribas,KO/TKO,0,0,0,0
Luana Pinheiro,2023-04-08,Michelle Waterson-Gomez,Decision - Split,70,0,0,70
Luana Pinheiro,2021-11-20,Sam Hughes,Decision - Unanimous,80,7,0,87
Luana Pinheiro,2020-11-10,Stephanie Frausto,KO/TKO,100,6,0,106
Luana Pinheiro,2024-05-18,Angela Hill,Submission,0,0,0,0
Rodrigo Gripp de Sousa,2005-12-03,Thiago Silva,TKO - Doctor's Stoppage,0,0,0,0
Harry Moskowitz,1997-10-17,Alex Hunter,Decision - Split,0,1,0,1
Alejandro Garcia,2004-10-21,Nate Diaz,Submission,0,1,0,1
Rich Clementi,2009-02-07,Gleison Tibau,Submission,0,0,0,0
Rich Clementi,2006-11-11,Din Thomas,Submission,0,0,0,0
Rich Clementi,2011-05-29,Shinya Aoki,Submission,0,0,0,0
Rich Clementi,2007-09-22,Anthony Johnson,Submission,90,0,0,90
Rich Clementi,2007-04-05,Roan Carneiro,Decision - Unanimous,0,0,0,0
Rich Clementi,2008-10-25,Gray Maynard,Decision - Unanimous,0,0,0,0
Rich Clementi,2008-04-19,Sam Stout,Decision - Split,70,0,0,70
Rich Clementi,2007-12-29,Melvin Guillard,Submission,90,1,0,91
Rich Clementi,2007-01-25,Ross Pointon,Submission,90,0,0,90
Rich Clementi,2003-02-28,Yves Edwards,Submission,0,0,0,0
Rich Clementi,2008-05-24,Terry Etim,Decision - Unanimous,80,0,0,80
Gina Carano,2008-10-04,Kelly Kobold,Decision - Unanimous,80,16,0,96
Gina Carano,2006-12-08,Elaina Maxwell,Decision - Unanimous,80,8,0,88
Gina Carano,2008-05-31,Kaitlin Young,TKO - Doctor's Stoppage,0,21,0,21
Gina Carano,2009-08-15,Cristiane Justino,KO/TKO,0,0,25,25
Gina Carano,2007-09-15,Tonya Evinger,Submission,90,1,0,91
Gina Carano,2006-06-10,Leiticia Pestova,KO/TKO,100,16,0,116
Gina Carano,2007-02-10,Julie Kedzie,Decision - Unanimous,80,17,0,97
Gina Carano,2006-09-15,Rosi Sexton,KO/TKO,100,36,0,136
Kelly Kobold,2008-10-04,Gina Carano,Decision - Unanimous,0,0,0,0
Cory McKenna,2022-12-17,Cheyanne Vlismas,Decision - Unanimous,80,0,0,80
Cory McKenna,2022-08-06,Miranda Granger,Submission,90,0,0,90
Cory McKenna,2020-08-11,Vanessa Demopoulos,Decision - Unanimous,80,23,0,103
Cory McKenna,2020-11-14,Kay Hansen,Decision - Unanimous,80,0,0,80
Cory McKenna,2024-03-16,Jaqueline Amorim,Submission,0,1,0,1
Cory McKenna,2022-03-19,Elise Reed,Decision - Split,0,0,0,0
Cory McKenna,2024-10-12,Julia Polastri,Decision - Split,0,0,0,0
Kiril Sidelnikov,2009-01-24,Paul Buentello,TKO - Doctor's Stoppage,0,0,0,0
Li Yunfeng,2024-05-19,Baergeng Jieleyisi,Submission,0,0,0,0
John Polakowski,2006-10-12,Olaf Alfonso,Decision - Split,70,9,0,79
John Polakowski,2008-12-13,Rolando Delgado,Submission,0,0,0,0
Olaf Alfonso,2006-10-12,John Polakowski,Decision - Split,0,0,0,0
Olaf Alfonso,2006-06-04,Hayato Sakurai,KO/TKO,0,0,0,0
Olaf Alfonso,2004-05-21,Gilbert Melendez,KO/TKO,0,0,0,0
Olaf Alfonso,2007-01-20,Alex Karalexis,TKO - Doctor's Stoppage,0,0,0,0
Josh Culibao,2022-06-11,SeungWoo Choi,Decision - Split,70,5,0,75
Josh Culibao,2021-05-22,Shayilan Nuerdanbieke,Decision - Unanimous,80,36,0,116
Josh Culibao,2024-03-16,Danny Silva,Decision - Split,0,42,0,42
Josh Culibao,2023-02-11,Melsik Baghdasaryan,Submission,90,0,0,90
Josh Culibao,2024-08-17,Ricardo Ramos,Decision - Split,0,43,0,43
Josh Culibao,2023-07-22,Lerone Murphy,Decision - Unanimous,0,0,0,0
Josh Culibao,2020-02-22,Jalin Turner,KO/TKO,0,0,0,0
SuYoung You,2024-08-23,Daermisi Zhawupasi,Decision - Split,70,0,0,70
SuYoung You,2024-05-19,Shohei Nose,Decision - Unanimous,80,1,0,81
SuYoung You,2024-11-23,Baergeng Jieleyisi,Decision - Unanimous,80,33,0,113
Jamie Moyle,2018-07-07,Emily Whitmire,Decision - Unanimous,0,0,0,0
Jamie Moyle,2016-12-03,Kailin Curran,Decision - Unanimous,80,26,0,106
Jamie Moyle,2017-06-03,Viviane Pereira,Decision - Unanimous,0,0,0,0
Chris Wilson,2008-08-09,Steve Bruno,Decision - Unanimous,80,42,0,122
Chris Wilson,2009-09-16,Mike Pyle,Submission,0,7,0,7
Chris Wilson,2009-01-31,John Howard,Decision - Split,0,24,0,24
Chris Wilson,2008-03-01,Jon Fitch,Decision - Unanimous,0,0,0,0
Tony Fryklund,1997-07-27,Kevin Jackson,Submission,0,0,0,0
Tony Fryklund,2006-04-22,Anderson Silva,KO/TKO,0,0,0,0
Tony Fryklund,2007-06-22,Cung Le,KO/TKO,0,0,0,0
Tony Fryklund,1997-07-27,Donnie Chappell,Submission,90,5,0,95
Tony Fryklund,2002-06-22,Rodrigo Ruas,KO/TKO,100,49,0,149
Tony Fryklund,2004-10-22,Ivan Salaverry,Submission,0,0,0,0
Tony Fryklund,2006-12-08,Duane Ludwig,KO/TKO,0,0,0,0
Justin Eilers,2005-02-05,Paul Buentello,KO/TKO,0,0,0,0
Justin Eilers,2004-08-21,Mike Kyle,KO/TKO,100,0,0,100
Justin Eilers,2005-06-04,Andrei Arlovski,KO/TKO,0,0,25,25
Justin Eilers,2006-10-12,Josh Diekmann,KO/TKO,100,24,0,124
Justin Eilers,2006-02-04,Brandon Vera,KO/TKO,0,0,0,0
Justin Eilers,2008-07-26,Antonio Silva,KO/TKO,0,0,25,25
Allan Nascimento,2023-01-14,Carlos Hernandez,Submission,90,3,0,93
Allan Nascimento,2022-05-14,Jake Hadley,Decision - Unanimous,80,11,0,91
Allan Nascimento,2021-10-30,Tagir Ulanbekov,Decision - Split,0,7,0,7
Allan Nascimento,2018-08-12,Raulian Paiva,Decision - Split,0,24,0,24
Carlos Hernandez,2023-01-14,Allan Nascimento,Submission,0,0,0,0
Carlos Hernandez,2021-10-05,Daniel Barez,Decision - Split,70,25,0,95
Carlos Hernandez,2023-06-17,Denys Bondar,Decision - Unanimous,80,26,0,106
Carlos Hernandez,2023-12-09,Tatsuro Taira,KO/TKO,0,0,0,0
Carlos Hernandez,2024-06-29,Rei Tsuruya,Decision - Unanimous,0,0,0,0
Carlos Hernandez,2024-11-23,Nyamjargal Tumendemberel,Decision - Split,70,18,0,88
Carlos Hernandez,2022-02-26,Victor Altamirano,Decision - Split,70,5,0,75
Fredy Serrano,2016-07-30,Ryan Benoit,Decision - Split,0,0,0,0
Fredy Serrano,2015-03-21,Bentley Syler,KO/TKO,100,5,0,105
Fredy Serrano,2016-12-17,Hector Sandoval,Decision - Unanimous,0,0,0,0
Fredy Serrano,2015-11-28,Yao Zhikui,KO/TKO,100,2,0,102
Jerrod Sanders,2015-07-12,Russell Doane,Decision - Unanimous,80,2,0,82
Jerrod Sanders,2014-07-16,Yosdenis Cedeno,TKO - Doctor's Stoppage,0,0,0,0
Jerrod Sanders,2016-07-07,Felipe Arantes,Submission,0,3,0,3
Sergey Khandozhko,2019-11-09,Rustam Khabilov,Decision - Unanimous,0,13,0,13
Sergey Khandozhko,2022-04-23,Dwight Grant,KO/TKO,100,7,0,107
Sergey Khandozhko,2019-06-01,Rostem Akman,Decision - Unanimous,80,21,0,101
Matt Lee,2007-09-29,Jorge Masvidal,KO/TKO,0,0,0,0
Kron Gracie,2019-02-17,Alex Caceres,Submission,90,0,0,90
Kron Gracie,2019-10-12,Cub Swanson,Decision - Unanimous,0,0,0,0
Kron Gracie,2023-05-06,Charles Jourdain,Decision - Unanimous,0,0,0,0
Kron Gracie,2024-12-07,Bryce Mitchell,KO/TKO,0,0,0,0
Brett Johns,2018-08-04,Pedro Munhoz,Decision - Unanimous,0,0,0,0
Brett Johns,2020-07-18,Montel Jackson,Decision - Unanimous,80,0,0,80
Brett Johns,2016-11-19,Kwan Ho Kwak,Decision - Unanimous,80,0,0,80
Brett Johns,2020-01-25,Tony Gravely,Submission,90,10,0,100
Brett Johns,2018-04-21,Aljamain Sterling,Decision - Unanimous,0,0,0,0
Brett Johns,2017-12-01,Joe Soto,Submission,90,1,0,91
Brett Johns,2017-07-16,Albert Morales,Decision - Unanimous,80,28,0,108
Clifford Starks,2013-04-20,Yoel Romero,KO/TKO,0,0,0,0
Clifford Starks,2012-02-04,Ed Herman,Submission,0,0,0,0
Clifford Starks,2011-10-29,Dustin Jacoby,Decision - Unanimous,80,8,0,88
John Lober,1998-10-16,Frank Shamrock,Submission,0,0,0,0
Tony Petarra,1999-05-07,Wanderlei Silva,KO/TKO,0,0,0,0
Jordan Mein,2012-07-14,Tyler Stinson,Decision - Unanimous,80,36,0,116
Jordan Mein,2014-08-23,Mike Pyle,KO/TKO,100,8,0,108
Jordan Mein,2013-03-16,Dan Miller,KO/TKO,100,18,0,118
Jordan Mein,2017-12-16,Erick Silva,Decision - Unanimous,80,38,0,118
Jordan Mein,2017-07-08,Belal Muhammad,Decision - Unanimous,0,0,0,0
Jordan Mein,2018-07-28,Alex Morono,Decision - Unanimous,80,0,0,80
Jordan Mein,2016-12-10,Emil Meek,Decision - Unanimous,0,0,0,0
Jordan Mein,2014-04-19,Hernani Perpetuo,Decision - Split,70,25,0,95
Jordan Mein,2011-09-10,Evangelista Santos,KO/TKO,100,25,0,125
Jordan Mein,2015-01-31,Thiago Alves,KO/TKO,0,14,0,14
Jordan Mein,2012-01-07,Tyron Woodley,Decision - Split,0,0,0,0
Jordan Mein,2013-04-20,Matt Brown,KO/TKO,0,0,0,0
Tyler Stinson,2012-07-14,Jordan Mein,Decision - Unanimous,0,0,0,0
Tyler Stinson,2012-01-07,Tarec Saffiedine,Decision - Split,0,0,0,0
Rafael Carino,1996-05-17,Matt Andersen,KO/TKO,100,8,0,108
Matt Andersen,1996-05-17,Rafael Carino,KO/TKO,0,0,0,0
Joe Warren,2009-10-06,Bibiano Fernandes,Submission,0,0,0,0
Joe Warren,2009-05-26,Norifumi Yamamoto,Decision - Split,70,0,0,70
Joe Warren,2009-03-08,Chase Beebe,TKO - Doctor's Stoppage,0,0,0,0
Bharat Kandare,2017-11-25,Song Yadong,Submission,0,0,0,0
Alan Patrick,2018-10-06,Scott Holtzman,KO/TKO,0,0,0,0
Alan Patrick,2014-02-01,John Makdessi,Decision - Unanimous,80,0,0,80
Alan Patrick,2016-03-19,Damien Brown,Decision - Unanimous,80,10,0,90
Alan Patrick,2022-05-14,Michael Johnson,KO/TKO,0,0,0,0
Alan Patrick,2013-10-09,Garett Whiteley,KO/TKO,100,9,0,109
Alan Patrick,2018-02-03,Damir Hadzovic,Decision - Unanimous,80,8,0,88
Alan Patrick,2016-09-24,Stevie Ray,Decision - Unanimous,80,5,0,85
Alan Patrick,2015-06-20,Mairbek Taisumov,KO/TKO,0,0,0,0
Alan Patrick,2020-09-12,Bobby Green,Decision - Unanimous,0,0,0,0
Chris Fishgold,2019-02-23,Daniel Teymur,Submission,90,0,0,90
Chris Fishgold,2018-10-27,Calvin Kattar,KO/TKO,0,0,0,0
Chris Fishgold,2020-07-15,Jared Gordon,Decision - Unanimous,0,0,0,0
Chris Fishgold,2019-06-01,Makwan Amirkhani,Submission,0,7,0,7
Yaotzin Meza,2016-02-27,Arnold Allen,Decision - Unanimous,0,0,0,0
Yaotzin Meza,2012-12-14,Chad Mendes,KO/TKO,0,0,0,0
Yaotzin Meza,2013-07-27,John Albert,Submission,90,0,0,90
Yaotzin Meza,2014-06-07,Sergio Pettis,Decision - Unanimous,0,0,0,0
Yaotzin Meza,2015-07-15,Sam Sicilia,Decision - Unanimous,0,6,0,6
Yaotzin Meza,2015-04-11,Damian Stasiak,Decision - Unanimous,80,3,0,83
Coty Wheeler,2007-09-05,Ian McCall,KO/TKO,0,0,0,0
Coty Wheeler,2008-02-13,Del Hawkins,Submission,90,6,0,96
Coty Wheeler,2009-10-10,Charlie Valencia,Decision - Unanimous,0,0,0,0
Coty Wheeler,2010-01-10,Will Campuzano,Decision - Unanimous,0,0,0,0
Bruna Brasil,2023-07-22,Shauna Bannon,Decision - Unanimous,80,2,0,82
Bruna Brasil,2024-02-10,Loma Lookboonmee,Decision - Unanimous,0,0,0,0
Bruna Brasil,2022-09-13,Marnic Mann,KO/TKO,100,21,0,121
Bruna Brasil,2024-07-27,Molly McCann,Decision - Unanimous,80,12,0,92
Bruna Brasil,2023-04-15,Denise Gomes,KO/TKO,0,0,0,0
Clint Hester,2016-04-23,Marcos Rogerio de Lima,Submission,0,0,0,0
Clint Hester,2013-12-06,Dylan Andrews,TKO - Doctor's Stoppage,0,14,0,14
Clint Hester,2015-08-01,Vitor Miranda,KO/TKO,0,0,0,0
Clint Hester,2014-06-28,Antonio Braga Neto,Decision - Split,70,24,0,94
Clint Hester,2013-04-13,Bristol Marunde,KO/TKO,100,45,0,145
Clint Hester,2014-11-07,Robert Whittaker,KO/TKO,0,0,0,0
Clint Hester,2014-02-01,Andy Enz,Decision - Unanimous,80,3,0,83
Ricky Rainey,2018-11-30,Tim Means,KO/TKO,0,0,0,0
Ricky Rainey,2018-04-14,Muslim Salikhov,KO/TKO,0,0,0,0
Shayilan Nuerdanbieke,2021-05-22,Josh Culibao,Decision - Unanimous,0,0,0,0
Shayilan Nuerdanbieke,2024-06-15,Melquizael Costa,Submission,0,0,0,0
Shayilan Nuerdanbieke,2022-11-05,Darrick Minner,KO/TKO,100,14,0,114
Shayilan Nuerdanbieke,2022-06-25,TJ Brown,Decision - Unanimous,80,5,0,85
Shayilan Nuerdanbieke,2021-11-20,Sean Soriano,Decision - Unanimous,80,0,0,80
Shayilan Nuerdanbieke,2023-04-08,Steve Garcia,KO/TKO,0,1,0,1
Tom Gallicchio,2017-07-07,James Krause,Decision - Unanimous,0,0,0,0
LC Davis,2010-11-11,Raphael Assuncao,Decision - Unanimous,0,0,0,0
LC Davis,2010-06-20,Josh Grispi,Submission,0,0,0,0
LC Davis,2010-03-06,Deividas Taurosevicius,Decision - Majority,75,0,0,75
LC Davis,2009-11-18,Diego Nunes,Decision - Unanimous,80,22,0,102
LC Davis,2009-08-09,Javier Vazquez,Decision - Split,70,0,0,70
Nad Narimani,2018-11-17,Anderson Dos Santos,Decision - Unanimous,80,38,0,118
Nad Narimani,2020-07-18,Grant Dawson,Decision - Unanimous,0,0,0,0
Nad Narimani,2018-07-22,Khalid Taha,Decision - Unanimous,80,13,0,93
Nad Narimani,2019-03-16,Mike Grundy,KO/TKO,0,0,0,0
Anderson Dos Santos,2018-11-17,Nad Narimani,Decision - Unanimous,0,0,0,0
Anderson Dos Santos,2021-08-07,Miles Johns,KO/TKO,0,0,0,0
Anderson Dos Santos,2019-06-22,Andre Ewell,Decision - Unanimous,0,0,0,0
Anderson Dos Santos,2020-11-28,Martin Day,Submission,90,2,0,92
Wagner Prado,2013-01-19,Ildemar Alcantara,Submission,0,4,0,4
Patrick Williams,2015-06-13,Alejandro Perez,Submission,90,2,0,92
Patrick Williams,2014-04-26,Chris Beal,KO/TKO,0,0,0,0
Patrick Williams,2018-04-14,Luke Sanders,Decision - Unanimous,0,2,0,2
Patrick Williams,2017-04-15,Tom Duquesnoy,KO/TKO,0,1,0,1
Ivan Jorge,2015-07-18,Joe Duffy,Submission,0,0,0,0
Ivan Jorge,2015-02-22,Josh Shockley,Decision - Unanimous,80,3,0,83
Ivan Jorge,2013-09-04,Keith Wisniewski,Decision - Unanimous,80,27,0,107
Ivan Jorge,2014-02-15,Rodrigo Damm,Decision - Unanimous,0,0,0,0
Steven Nguyen,2023-09-12,AJ Cunningham,KO/TKO,100,34,0,134
Steven Nguyen,2019-07-30,Aalon Cruz,KO/TKO,0,0,0,0
Steven Nguyen,2021-09-21,Theo Rlayang,Decision - Unanimous,80,37,0,117
Steven Nguyen,2024-03-23,Jarno Errens,Decision - Unanimous,0,0,0,0
AJ Cunningham,2023-09-12,Steven Nguyen,KO/TKO,0,0,0,0
AJ Cunningham,2024-03-02,Ludovit Klein,KO/TKO,0,0,0,0
Jin Soo Son,2018-09-15,Petr Yan,Decision - Unanimous,0,0,0,0
Jin Soo Son,2019-07-20,Mario Bautista,Decision - Unanimous,0,0,0,0
Mike Kyle,2004-08-21,Justin Eilers,KO/TKO,0,3,0,3
Mike Kyle,2011-09-10,Marcos Rogerio de Lima,Decision - Unanimous,80,29,0,109
Mike Kyle,2010-12-04,Antonio Silva,KO/TKO,0,11,0,11
Mike Kyle,2009-08-15,Fabricio Werdum,Submission,0,0,0,0
Mike Kyle,2010-07-23,Abongo Humphrey,Submission,90,26,0,116
Mike Kyle,2008-03-29,Wayne Cole,Submission,0,0,0,0
Mike Kyle,2013-01-12,Gegard Mousasi,Submission,0,0,0,0
Mike Kyle,2005-02-05,James Irvin,KO/TKO,100,7,0,107
Mike Kyle,2006-01-13,Devin Cole,KO/TKO,0,0,0,0
Mike Kyle,2004-04-02,Wes Sims,KO/TKO,100,13,0,113
Claudio Puelles,2021-12-04,Chris Gruetzemacher,Submission,90,5,0,95
Claudio Puelles,2024-02-24,Fares Ziam,Decision - Split,0,0,0,0
Claudio Puelles,2018-05-19,Felipe Silva,Submission,90,0,0,90
Claudio Puelles,2022-11-12,Dan Hooker,KO/TKO,0,0,0,0
Claudio Puelles,2022-04-23,Clay Guida,Submission,90,0,0,90
Claudio Puelles,2021-06-05,Jordan Leavitt,Decision - Unanimous,80,0,0,80
Claudio Puelles,2019-09-21,Marcos Mariano,Decision - Unanimous,80,20,0,100
Claudio Puelles,2016-11-05,Martin Bravo,KO/TKO,0,0,0,0
Jorge Rivera,2007-02-03,Terry Martin,KO/TKO,0,0,0,0
Jorge Rivera,2004-01-31,Lee Murray,Submission,0,2,0,2
Jorge Rivera,2004-10-22,Rich Franklin,Submission,0,0,0,0
Jorge Rivera,2006-11-11,Edwin DeWees,KO/TKO,100,18,0,118
Jorge Rivera,2003-09-26,David Loiseau,Decision - Unanimous,80,45,0,125
Jorge Rivera,2005-04-30,Anderson Silva,KO/TKO,0,0,0,0
Jorge Rivera,2008-01-19,Kendall Grove,KO/TKO,100,28,0,128
Jorge Rivera,2009-10-24,Rob Kimmons,KO/TKO,100,43,0,143
Jorge Rivera,2010-03-31,Nate Quarry,KO/TKO,100,10,0,110
Jorge Rivera,2009-04-01,Nissen Osterneck,Decision - Split,70,0,0,70
Jorge Rivera,2008-06-07,Martin Kampmann,Submission,0,0,0,0
Jorge Rivera,2011-02-26,Michael Bisping,KO/TKO,0,0,0,0
Jorge Rivera,2005-10-07,Dennis Hallman,Decision - Unanimous,80,39,0,119
Jorge Rivera,2006-01-16,Chris Leben,KO/TKO,0,0,0,0
Jorge Rivera,2011-08-06,Constantinos Philippou,Decision - Split,0,0,0,0
Jorge Rivera,2012-01-20,Eric Schafer,KO/TKO,100,0,0,100
Paul Redmond,2015-01-24,Mirsad Bektic,Decision - Unanimous,0,0,0,0
Paul Redmond,2015-07-18,Robert Whiteford,KO/TKO,0,0,0,0
Carter Williams,2007-06-22,Paul Buentello,KO/TKO,0,0,0,0
Mike Massenzio,2012-01-14,Rousimar Palhares,Submission,0,0,0,0
Mike Massenzio,2008-12-27,CB Dollaway,KO/TKO,0,0,0,0
Mike Massenzio,2010-08-01,Brian Stann,Submission,0,0,0,0
Mike Massenzio,2012-05-05,Karlos Vemola,Submission,0,0,0,0
Mike Massenzio,2008-09-17,Drew McFedries,Submission,90,0,0,90
Mike Massenzio,2011-06-11,Krzysztof Soszynski,Decision - Unanimous,0,0,0,0
Mike Massenzio,2011-10-08,Steve Cantwell,Decision - Unanimous,80,22,0,102
Andre Roberts,1999-07-16,Ron Waterman,KO/TKO,100,0,0,100
Andre Roberts,1999-03-05,Gary Goodridge,KO/TKO,0,0,0,0
Paul Jones,1999-09-24,Chuck Liddell,TKO - Doctor's Stoppage,0,0,0,0
Paul Jones,1999-07-16,Flavio Luiz Moura,Submission,90,20,0,110
Zachary Micklewright,2010-08-18,Bart Palaszewski,KO/TKO,0,1,0,1
Zachary Micklewright,2009-12-19,Muhsin Corbbrey,Decision - Unanimous,80,49,0,129
Zachary Micklewright,2010-11-11,Dustin Poirier,KO/TKO,0,0,0,0
Hiromitsu Kanehara,2002-11-24,Wanderlei Silva,KO/TKO,0,0,0,0
Hiromitsu Kanehara,2004-05-23,Mirko Filipovic,Decision - Unanimous,0,0,0,0
Hiromitsu Kanehara,2004-10-31,Alistair Overeem,TKO - Doctor's Stoppage,0,0,0,0
Hiromitsu Kanehara,2005-02-20,Mauricio Rua,KO/TKO,0,0,0,0
Thibault Gouti,2016-06-18,Olivier Aubin-Mercier,Submission,0,0,0,0
Thibault Gouti,2017-09-02,Andrew Holbrook,KO/TKO,100,19,0,119
Thibault Gouti,2018-02-18,Sage Northcutt,Decision - Unanimous,0,0,0,0
Thibault Gouti,2016-02-27,Teemu Packalen,Submission,0,0,0,0
Thibault Gouti,2018-10-27,Nasrat Haqparast,Decision - Unanimous,0,0,0,0
Thibault Gouti,2016-08-27,Chad Laprise,KO/TKO,0,0,0,0
Dmitrii Smoliakov,2019-04-27,Greg Hardy,KO/TKO,0,0,0,0
Dmitrii Smoliakov,2017-01-15,Cyril Asker,KO/TKO,0,0,0,0
Dmitrii Smoliakov,2016-07-23,Luis Henrique,Submission,0,0,0,0
Michael McDonald,2011-03-26,Edwin Figueroa,Decision - Unanimous,80,6,0,86
Michael McDonald,2010-11-11,Clint Godfrey,Submission,90,4,0,94
Michael McDonald,2004-03-14,Lyoto Machida,Submission,0,0,0,0
Michael McDonald,2016-01-02,Masanori Kanehara,Submission,90,0,0,90
Michael McDonald,2013-08-17,Brad Pickett,Submission,90,34,0,124
Michael McDonald,2011-05-28,Chris Cariaso,Decision - Split,70,0,0,70
Michael McDonald,2011-11-19,Alex Soto,KO/TKO,100,6,0,106
Michael McDonald,2013-02-16,Renan Barao,Submission,0,0,25,25
Michael McDonald,2012-04-21,Miguel Torres,KO/TKO,100,8,0,108
Michael McDonald,2016-07-13,John Lineker,KO/TKO,0,0,25,25
Michael McDonald,2013-12-14,Urijah Faber,Submission,0,0,0,0
Bo Cantrell,2007-11-10,Kevin Ferguson,KO/TKO,0,0,0,0
Elias Garcia,2018-12-01,Kai Kara-France,Decision - Unanimous,0,0,0,0
Elias Garcia,2018-07-14,Mark De La Rosa,Submission,0,0,0,0
Yusaku Kinoshita,2023-02-04,Adam Fugitt,KO/TKO,0,0,0,0
Yusaku Kinoshita,2023-08-26,Billy Ray Goff,KO/TKO,0,0,0,0
Yusaku Kinoshita,2022-08-30,Jose Henrique,KO/TKO,100,25,0,125
Felipe Silva,2016-08-27,Shane Campbell,KO/TKO,100,2,0,102
Felipe Silva,2017-09-02,Mairbek Taisumov,KO/TKO,0,0,0,0
Felipe Silva,2018-05-19,Claudio Puelles,Submission,0,54,0,54
Shane Campbell,2016-08-27,Felipe Silva,KO/TKO,0,0,0,0
Shane Campbell,2016-02-21,James Krause,Decision - Unanimous,0,35,0,35
Shane Campbell,2016-05-29,Erik Koch,Submission,0,2,0,2
Shane Campbell,2015-08-23,Elias Silverio,Decision - Unanimous,80,22,0,102
Shane Campbell,2015-04-25,John Makdessi,KO/TKO,0,0,0,0
Tim Credeur,2009-04-01,Nick Catone,Submission,90,0,0,90
Tim Credeur,2008-07-19,Cale Yarbrough,KO/TKO,100,13,0,113
Tim Credeur,2009-09-16,Nate Quarry,Decision - Unanimous,0,0,0,0
Tim Credeur,2011-06-04,Ed Herman,KO/TKO,0,0,0,0
Tim Credeur,2008-12-10,Nate Loughran,KO/TKO,100,27,0,127
Asu Almabayev,2024-10-19,Matheus Nicolau,Decision - Unanimous,80,6,0,86
Asu Almabayev,2023-08-05,Ode Osbourne,Submission,90,22,0,112
Asu Almabayev,2024-03-09,CJ Vergara,Decision - Unanimous,80,15,0,95
Asu Almabayev,2024-06-15,Jose Johnson,Decision - Unanimous,80,15,0,95
Ketlen Souza,2024-09-14,Yazmin Jauregui,Submission,90,0,0,90
Ketlen Souza,2023-06-03,Karine Silva,Submission,0,0,0,0
Ketlen Souza,2024-04-27,Marnic Mann,Decision - Unanimous,80,49,0,129
CJ Hamilton,2017-07-18,Casey Kenney,Decision - Unanimous,0,0,0,0
Stefan Sekulic,2021-04-24,Dwight Grant,Decision - Split,0,0,0,0
Stefan Sekulic,2018-09-15,Ramazan Emeev,Decision - Unanimous,0,0,0,0
Ramiz Brahimaj,2022-02-26,Micheal Gillmore,Submission,90,0,0,90
Ramiz Brahimaj,2020-11-07,Max Griffin,KO/TKO,0,0,0,0
Ramiz Brahimaj,2021-08-21,Sasha Palatnikov,Submission,90,0,0,90
Ramiz Brahimaj,2022-01-15,Court McGee,Decision - Unanimous,0,0,0,0
Ramiz Brahimaj,2024-05-18,Themba Gorimbo,Decision - Unanimous,0,0,0,0
Ramiz Brahimaj,2024-11-16,Mickey Gall,KO/TKO,100,3,0,103
Micheal Gillmore,2022-02-26,Ramiz Brahimaj,Submission,0,0,0,0
Micheal Gillmore,2021-08-28,Andre Petroski,KO/TKO,0,0,0,0
Jan Finney,2010-06-26,Cristiane Justino,KO/TKO,0,0,25,25
Jan Finney,2010-11-19,Liz Carmouche,KO/TKO,0,0,0,0
Dong Hyun Ma,2016-12-03,Brendan O'Reilly,Decision - Unanimous,80,0,0,80
Dong Hyun Ma,2017-09-22,Takanori Gomi,KO/TKO,100,11,0,111
Dong Hyun Ma,2019-12-21,Omar Morales,Decision - Unanimous,0,0,0,0
Dong Hyun Ma,2018-02-10,Damien Brown,Decision - Split,70,21,0,91
Dong Hyun Ma,2019-02-09,Devonte Smith,KO/TKO,0,0,0,0
Dong Hyun Ma,2015-11-28,Dominique Steele,KO/TKO,0,0,0,0
Dong Hyun Ma,2019-08-03,Scott Holtzman,TKO - Doctor's Stoppage,0,0,0,0
Dong Hyun Ma,2016-06-04,Marco Polo Reyes,KO/TKO,0,0,0,0
Hilarie Rose,2020-08-18,Cheyanne Vlismas,Decision - Unanimous,0,0,0,0
Maurice Smith,2000-09-22,Bobby Hoffman,Decision - Split,70,33,0,103
Maurice Smith,1997-10-17,David Abbott,Submission,90,7,0,97
Maurice Smith,2008-02-23,Rick Roufus,Submission,90,1,0,91
Maurice Smith,1999-03-05,Kevin Randleman,Decision - Unanimous,0,0,0,0
Maurice Smith,1997-12-21,Randy Couture,Decision - Majority,0,0,0,0
Maurice Smith,1999-07-16,Marco Ruas,KO/TKO,100,3,0,103
Maurice Smith,2000-11-17,Renato Sobral,Decision - Majority,0,0,0,0
Maurice Smith,1999-09-12,Branko Cikatic,Submission,90,5,0,95
Maurice Smith,1997-07-27,Mark Coleman,Decision - Unanimous,80,36,0,116
Bobby Hoffman,2000-09-22,Maurice Smith,Decision - Split,0,0,0,0
Bobby Hoffman,2001-11-02,Josh Barnett,KO/TKO,0,0,0,0
Christian Aguilera,2020-08-29,Sean Brady,Submission,0,0,0,0
Christian Aguilera,2020-06-13,Anthony Ivy,KO/TKO,100,6,0,106
Christian Aguilera,2021-05-08,Carlston Harris,Submission,0,0,0,0
Marcin Held,2016-11-05,Diego Sanchez,Decision - Unanimous,0,0,0,0
Marcin Held,2017-05-28,Damir Hadzovic,KO/TKO,0,17,0,17
Marcin Held,2017-10-21,Nasrat Haqparast,Decision - Unanimous,80,0,0,80
Marcin Held,2017-01-15,Joe Lauzon,Decision - Split,0,3,0,3
Mike Moreno,2006-10-12,Dave Terrel,Decision - Unanimous,0,3,0,3
Heather Clark,2016-05-08,Karolina Kowalkiewicz,Decision - Unanimous,0,0,0,0
Heather Clark,2014-12-12,Bec Rawlings,Decision - Unanimous,80,0,0,80
Heather Clark,2016-11-05,Alexa Grasso,Decision - Unanimous,0,0,0,0
Bobby Nash,2017-01-28,Li Jingliang,KO/TKO,0,2,0,2
Bobby Nash,2017-11-25,Song Kenan,KO/TKO,0,0,0,0
Bobby Nash,2017-07-16,Danny Roberts,KO/TKO,0,1,0,1
Brad Kohler,1999-09-24,Steve Judson,KO/TKO,100,3,0,103
Brad Kohler,1997-12-21,Tra Telligman,Submission,0,6,0,6
Steve Judson,1999-09-24,Brad Kohler,KO/TKO,0,0,0,0
Steve Judson,2000-03-10,Tedd Williams,KO/TKO,0,5,0,5
Jhonoven Pati,2020-08-25,Jamie Pickett,KO/TKO,0,0,0,0
Poliana Botelho,2018-05-19,Syuri Kondo,KO/TKO,100,7,0,107
Poliana Botelho,2020-10-17,Gillian Robertson,Decision - Unanimous,0,0,0,0
Poliana Botelho,2018-11-17,Cynthia Calvillo,Submission,0,0,0,0
Poliana Botelho,2019-04-13,Lauren Mueller,Decision - Unanimous,80,0,0,80
Poliana Botelho,2022-06-04,Karine Silva,Submission,0,2,0,2
Poliana Botelho,2021-05-01,Luana Carolina,Decision - Split,0,9,0,9
Poliana Botelho,2017-10-07,Pearl Gonzalez,Decision - Unanimous,80,40,0,120
Sultan Aliev,2015-01-24,Kenny Robertson,KO/TKO,0,0,0,0
Sultan Aliev,2018-05-12,Warlley Alves,TKO - Doctor's Stoppage,0,0,0,0
Sultan Aliev,2019-04-20,Keita Nakamura,Decision - Unanimous,80,0,0,80
Sultan Aliev,2016-12-17,Bojan Velickovic,Decision - Split,70,0,0,70
Roberto Romero,2024-11-16,David Onama,Decision - Unanimous,0,0,0,0
Edimilson Souza,2014-05-31,Mark Eddiva,KO/TKO,100,25,0,125
Edimilson Souza,2015-03-21,Katsunori Kikuno,KO/TKO,100,4,0,104
Edimilson Souza,2015-11-07,Chas Skelly,Submission,0,12,0,12
Edimilson Souza,2013-09-04,Felipe Arantes,Decision - Split,70,17,0,87
Maria Oliveira,2018-08-11,Marina Rodriguez,KO/TKO,0,0,0,0
Maria Oliveira,2022-11-19,Vanessa Demopoulos,Decision - Unanimous,0,28,0,28
Maria Oliveira,2022-06-18,Gloria de Paula,Decision - Split,70,0,0,70
Maria Oliveira,2021-10-23,Tabatha Ricci,Decision - Unanimous,0,4,0,4
Maria Oliveira,2023-06-10,Diana Belbita,Decision - Unanimous,0,0,0,0
Sung Bin Jo,2019-06-01,Daniel Teymur,Decision - Unanimous,0,0,0,0
Yui Chul Nam,2014-03-01,Kazuki Tokudome,Decision - Split,70,46,0,116
Yui Chul Nam,2015-11-28,Mike de la Torre,Decision - Split,0,6,0,6
Yui Chul Nam,2015-05-16,Phillipe Nover,Decision - Split,0,17,0,17
Kazuki Tokudome,2014-03-01,Yui Chul Nam,Decision - Split,0,0,0,0
Kazuki Tokudome,2013-07-06,Norman Parke,Decision - Unanimous,0,0,0,0
Kazuki Tokudome,2013-03-02,Cristiano Marcello,Decision - Unanimous,80,0,0,80
Kazuki Tokudome,2014-09-20,Johnny Case,Submission,0,0,0,0
Jason DeLucia,1994-03-11,Scott Baker,Submission,90,3,0,93
Jason DeLucia,1994-03-11,Royce Gracie,Submission,0,0,0,0
Jason DeLucia,1999-11-19,Joe Slick,KO/TKO,0,0,0,0
Jason DeLucia,1993-11-12,Trent Jenkins,Submission,90,2,0,92
Scott Baker,1994-03-11,Jason DeLucia,Submission,0,0,0,0
Felipe Colares,2019-07-20,Domingo Pilarte,Decision - Split,70,12,0,82
Felipe Colares,2019-02-02,Geraldo de Freitas,Decision - Unanimous,0,0,0,0
Felipe Colares,2020-01-25,Montel Jackson,Decision - Unanimous,0,0,0,0
Felipe Colares,2021-10-09,Chris Gutierrez,Decision - Split,0,0,0,0
Felipe Colares,2022-05-21,Chase Hooper,KO/TKO,0,0,0,0
Felipe Colares,2021-05-01,Luke Sanders,Decision - Unanimous,80,0,0,80
Domingo Pilarte,2019-07-20,Felipe Colares,Decision - Split,0,0,0,0
Domingo Pilarte,2021-08-21,Brian Kelleher,Decision - Unanimous,0,0,0,0
Domingo Pilarte,2018-07-17,Vince Morales,Submission,90,0,0,90
Chris de la Rocha,2018-12-15,Juan Adams,KO/TKO,0,0,0,0
Chris de la Rocha,2016-05-29,Adam Milstead,KO/TKO,0,0,0,0
Chris de la Rocha,2015-07-18,Daniel Omielanczuk,KO/TKO,0,0,0,0
Chris de la Rocha,2018-06-09,Rashad Coulter,KO/TKO,100,10,0,110
Priscila Cachoeira,2022-02-26,Ji Yeon Kim,Decision - Unanimous,80,0,0,80
Priscila Cachoeira,2021-05-15,Gina Mazany,KO/TKO,100,3,0,103
Priscila Cachoeira,2022-08-13,Ariane da Silva,KO/TKO,100,16,0,116
Priscila Cachoeira,2019-03-16,Molly McCann,Decision - Unanimous,0,0,0,0
Priscila Cachoeira,2024-01-20,Jasmine Jasudavicius,Submission,0,0,0,0
Priscila Cachoeira,2023-07-29,Miranda Maverick,Submission,0,0,0,0
Priscila Cachoeira,2019-05-11,Luana Carolina,Decision - Unanimous,0,0,0,0
Priscila Cachoeira,2021-12-11,Gillian Robertson,Submission,0,0,0,0
Priscila Cachoeira,2018-02-03,Valentina Shevchenko,Submission,0,0,0,0
Priscila Cachoeira,2020-02-22,Shana Dobson,KO/TKO,100,3,0,103
Ji Yeon Kim,2022-02-26,Priscila Cachoeira,Decision - Unanimous,0,68,0,68
Ji Yeon Kim,2018-11-30,Antonina Shevchenko,Decision - Unanimous,0,0,0,0
Ji Yeon Kim,2017-06-17,Lucie Pudilova,Decision - Unanimous,0,7,0,7
Ji Yeon Kim,2018-01-27,Justine Kish,Decision - Split,70,0,0,70
Ji Yeon Kim,2023-05-13,Mandy Bohm,Decision - Split,0,0,0,0
Ji Yeon Kim,2019-10-05,Nadia Kassem,KO/TKO,100,35,0,135
Ji Yeon Kim,2018-06-23,Melinda Fabian,Decision - Split,70,1,0,71
Ji Yeon Kim,2020-08-29,Alexa Grasso,Decision - Unanimous,0,0,0,0
Ji Yeon Kim,2021-09-04,Molly McCann,Decision - Unanimous,0,0,0,0
Ji Yeon Kim,2022-07-30,Joselyne Edwards,Decision - Split,0,0,0,0
Victor Henry,2023-03-11,Tony Gravely,Decision - Split,70,79,0,149
Victor Henry,2022-10-15,Raphael Assuncao,Decision - Unanimous,0,0,0,0
Victor Henry,2024-04-27,Rani Yahya,KO/TKO,100,55,0,155
Victor Henry,2022-01-22,Raoni Barcelos,Decision - Unanimous,80,47,0,127
Victor Henry,2024-11-02,Charles Jourdain,Submission,0,0,0,0
Tony Gravely,2023-03-11,Victor Henry,Decision - Split,0,0,0,0
Tony Gravely,2022-09-17,Javid Basharat,Decision - Unanimous,0,0,0,0
Tony Gravely,2020-11-14,Geraldo de Freitas,Decision - Split,70,0,0,70
Tony Gravely,2022-01-22,Saimon Oliveira,Decision - Unanimous,80,11,0,91
Tony Gravely,2020-01-25,Brett Johns,Submission,0,0,0,0
Tony Gravely,2019-08-13,Ray Rodriguez,KO/TKO,100,58,0,158
Tony Gravely,2021-09-18,Nate Maness,KO/TKO,0,5,0,5
Tony Gravely,2022-06-04,Johnny Munoz,KO/TKO,100,3,0,103
Tony Gravely,2021-04-17,Anthony Birchak,KO/TKO,100,21,0,121
Dale Hartt,2008-12-10,Corey Hill,KO/TKO,100,0,0,100
Dale Hartt,2009-06-13,Dennis Siver,Submission,0,0,0,0
Dale Hartt,2008-07-19,Shannon Gugerty,Submission,0,0,0,0
Bibulatov Magomed,2017-04-08,Jenel Lausa,Decision - Unanimous,80,41,0,121
Bibulatov Magomed,2019-02-02,Rogerio Bontorin,Decision - Split,0,18,0,18
Bibulatov Magomed,2017-10-07,John Moraga,KO/TKO,0,0,0,0
Jenel Lausa,2017-04-08,Bibulatov Magomed,Decision - Unanimous,0,0,0,0
Jenel Lausa,2017-11-18,Eric Shelton,Decision - Unanimous,0,0,0,0
Jenel Lausa,2018-06-23,Yuta Sasaki,Submission,0,0,0,0
Jenel Lausa,2016-11-26,Yao Zhikui,Decision - Unanimous,80,27,0,107
Pat Audinwood,2010-12-11,John Makdessi,Decision - Unanimous,0,0,0,0
Pat Audinwood,2010-09-25,Thiago Tavares,Submission,0,0,0,0
Orlando Wiet,1994-03-11,Remco Pardoel,KO/TKO,0,0,0,0
Orlando Wiet,1994-03-11,Robert Lucarelli,KO/TKO,100,6,0,106
Ryan McGivern,2008-05-16,Dan Miller,Submission,0,0,25,25
Nobuhiro Obiya,2006-08-27,Gilbert Melendez,Decision - Unanimous,0,0,0,0
Nobuhiro Obiya,2006-11-05,Luiz Firmino,Decision - Unanimous,0,0,0,0
Nazareno Malegarie,2015-09-05,Joaquim Silva,Decision - Split,0,9,0,9
Zoila Frausto,2010-03-26,Miesha Tate,Submission,0,0,0,0
Jordan Griffin,2018-07-31,Maurice Mitchell,Submission,90,0,0,90
Jordan Griffin,2021-04-10,Luis Saldana,Decision - Unanimous,0,0,0,0
Jordan Griffin,2020-02-29,TJ Brown,Submission,90,0,0,90
Jordan Griffin,2019-09-14,Chas Skelly,Decision - Unanimous,0,16,0,16
Jordan Griffin,2018-12-15,Dan Ige,Decision - Unanimous,0,0,0,0
Jordan Griffin,2020-06-27,Youssef Zalal,Decision - Unanimous,0,0,0,0
Maurice Mitchell,2018-07-31,Jordan Griffin,Submission,0,1,0,1
Lucie Pudilova,2024-07-20,Luana Carolina,Decision - Unanimous,0,0,0,0
Lucie Pudilova,2018-09-08,Irene Aldana,Decision - Split,0,0,0,0
Lucie Pudilova,2023-04-15,Joselyne Edwards,Decision - Split,0,0,0,0
Lucie Pudilova,2017-06-17,Ji Yeon Kim,Decision - Unanimous,80,0,0,80
Lucie Pudilova,2023-11-18,Ailin Perez,Decision - Unanimous,0,0,0,0
Lucie Pudilova,2019-08-03,Antonina Shevchenko,Submission,0,0,0,0
Lucie Pudilova,2022-08-20,Wu Yanan,KO/TKO,100,13,0,113
Lucie Pudilova,2019-02-23,Liz Carmouche,Decision - Unanimous,0,19,0,19
Lucie Pudilova,2020-01-25,Justine Kish,Decision - Unanimous,0,0,0,0
Lucie Pudilova,2018-02-18,Sarah Moras,Decision - Unanimous,80,32,0,112
Lucie Pudilova,2017-03-18,Lina Lansberg,Decision - Unanimous,0,19,0,19
Satoru Kitaoka,2012-12-31,Will Brooks,KO/TKO,0,0,0,0
Satoru Kitaoka,2011-09-24,Willamy Freire,Decision - Split,70,0,0,70
Satoru Kitaoka,2011-12-31,Shinya Aoki,Decision - Unanimous,0,0,25,25
Josh Emmett,2023-06-24,Ilia Topuria,Decision - Unanimous,0,0,25,25
Josh Emmett,2017-04-08,Desmond Green,Decision - Split,0,0,0,0
Josh Emmett,2017-10-21,Felipe Arantes,Decision - Unanimous,80,24,0,104
Josh Emmett,2016-12-17,Scott Holtzman,Decision - Unanimous,80,22,0,102
Josh Emmett,2016-05-08,Jon Tuck,Decision - Split,70,1,0,71
Josh Emmett,2017-12-16,Ricardo Lamas,KO/TKO,100,0,0,100
Josh Emmett,2022-06-18,Calvin Kattar,Decision - Split,70,0,25,95
Josh Emmett,2021-12-11,Dan Ige,Decision - Unanimous,80,0,0,80
Josh Emmett,2019-03-30,Michael Johnson,KO/TKO,100,0,0,100
Josh Emmett,2018-02-24,Jeremy Stephens,KO/TKO,0,0,25,25
Josh Emmett,2020-06-20,Shane Burgos,Decision - Unanimous,80,0,0,80
Josh Emmett,2023-12-16,Bryce Mitchell,KO/TKO,100,2,0,102
Josh Emmett,2023-02-11,Yair Rodriguez,Submission,0,0,25,25
Josh Emmett,2019-07-13,Mirsad Bektic,KO/TKO,100,17,0,117
Jumabieke Tuerxun,2014-11-07,Marcus Brimage,KO/TKO,0,1,0,1
Jumabieke Tuerxun,2014-07-06,Leandro Issa,Submission,0,0,0,0
Jumabieke Tuerxun,2014-03-01,Mark Eddiva,Decision - Unanimous,0,0,0,0
James Hammortree,2010-06-19,Chris Camozzi,Decision - Unanimous,0,0,0,0
Kazula Vargas,2021-04-24,Rongzhu,Decision - Unanimous,80,54,0,134
Kazula Vargas,2020-02-15,Brok Weaver,DQ,0,10,0,10
Kazula Vargas,2019-08-10,Alex Da Silva,Decision - Unanimous,0,3,0,3
Kazula Vargas,2022-03-19,Paddy Pimblett,Submission,0,4,0,4
Rongzhu,2021-04-24,Kazula Vargas,Decision - Unanimous,0,0,0,0
Rongzhu,2021-09-18,Brandon Jenkins,KO/TKO,100,45,0,145
Rongzhu,2023-05-28,SeongChan Hong,KO/TKO,100,5,0,105
Rongzhu,2024-02-03,Shin Haraguchi,Submission,90,35,0,125
Rongzhu,2022-02-26,Ignacio Bahamondes,Submission,0,0,0,0
Rongzhu,2023-08-27,Sangwook Kim,Decision - Unanimous,80,38,0,118
Bentley Syler,2015-03-21,Fredy Serrano,KO/TKO,0,0,0,0
Nandor Guelmino,2013-09-21,Daniel Omielanczuk,KO/TKO,0,7,0,7
Nandor Guelmino,2013-01-12,Josh Barnett,Submission,0,0,0,0
Yoji Anjo,2000-12-16,Matt Lindland,KO/TKO,0,0,0,0
Yoji Anjo,2000-04-14,Murilo Bustamante,Submission,0,0,0,0
Yoji Anjo,1997-12-21,David Abbott,Decision - Unanimous,0,0,0,0
Yoji Anjo,2004-12-31,Ryan Gracie,Submission,0,0,0,0
Dylan Salvador,2023-08-29,Bolaji Oki,KO/TKO,0,0,0,0
Francimar Barroso,2017-03-18,Darren Stewart,Decision - Unanimous,80,0,0,80
Francimar Barroso,2014-03-23,Hans Stringer,Decision - Split,0,0,0,0
Francimar Barroso,2017-09-02,Aleksandar Rakic,Decision - Unanimous,0,0,0,0
Francimar Barroso,2013-08-03,Ednaldo Oliveira,Decision - Unanimous,80,12,0,92
Francimar Barroso,2015-05-30,Ryan Jimmo,Decision - Unanimous,80,11,0,91
Francimar Barroso,2016-01-17,Elvis Mutapcic,Decision - Unanimous,80,19,0,99
Francimar Barroso,2016-05-08,Nikita Krylov,Submission,0,0,0,0
Francimar Barroso,2018-01-20,Gian Villante,Decision - Split,0,0,0,0
Darren Stewart,2017-03-18,Francimar Barroso,Decision - Unanimous,0,3,0,3
Darren Stewart,2020-08-08,Maki Pitolo,Submission,90,1,0,91
Darren Stewart,2019-06-08,Bevon Lewis,Decision - Unanimous,80,0,0,80
Darren Stewart,2019-10-18,Deron Winn,Decision - Split,70,28,0,98
Darren Stewart,2021-06-12,Eryk Anders,Decision - Unanimous,0,0,0,0
Darren Stewart,2020-09-19,Kevin Holland,Decision - Split,0,0,0,0
Darren Stewart,2018-09-08,Charles Byrd,KO/TKO,100,0,0,100
Darren Stewart,2018-11-30,Edmen Shahbazyan,Decision - Split,0,12,0,12
Darren Stewart,2017-12-16,Julian Marquez,Submission,0,1,0,1
Darren Stewart,2017-11-11,Karl Roberson,Submission,0,0,0,0
Darren Stewart,2018-05-27,Eric Spicely,KO/TKO,100,19,0,119
Darren Stewart,2021-08-28,Dustin Jacoby,KO/TKO,0,0,0,0
Elaina Maxwell,2008-06-27,Miesha Tate,Decision - Unanimous,0,3,0,3
Elaina Maxwell,2006-12-08,Gina Carano,Decision - Unanimous,0,0,0,0
Jessamyn Duke,2014-04-26,Bethe Correia,Decision - Unanimous,0,0,0,0
Jessamyn Duke,2014-07-16,Leslie Smith,KO/TKO,0,0,0,0
Jessamyn Duke,2015-07-25,Elizabeth Phillips,Decision - Unanimous,0,0,0,0
Jessamyn Duke,2013-11-30,Peggy Morgan,Decision - Unanimous,80,89,0,169
Rodney Wallace,2009-12-05,Brian Stann,Decision - Unanimous,0,0,0,0
Rodney Wallace,2010-03-27,Jared Hamman,Decision - Unanimous,0,0,0,0
Rodney Wallace,2010-08-07,Phil Davis,Decision - Unanimous,0,0,0,0
Ken Stone,2010-12-16,Eddie Wineland,KO/TKO,0,0,0,0
Ken Stone,2011-06-04,Scott Jorgensen,KO/TKO,0,3,0,3
Ken Stone,2011-09-17,Donny Walker,Submission,90,6,0,96
Ken Stone,2012-08-11,Erik Perez,KO/TKO,0,0,0,0
Ken Stone,2012-06-22,Dustin Pague,Decision - Split,70,22,0,92
Del Hawkins,2008-02-13,Coty Wheeler,Submission,0,0,0,0
Josh Ferguson,2011-12-03,Roland Delorme,Submission,0,0,0,0
Josh Ferguson,2012-07-11,Chris Cariaso,Decision - Unanimous,0,0,0,0
Antonina Shevchenko,2018-11-30,Ji Yeon Kim,Decision - Unanimous,80,33,0,113
Antonina Shevchenko,2020-11-21,Ariane da Silva,KO/TKO,100,24,0,124
Antonina Shevchenko,2020-05-30,Katlyn Cerminara,Decision - Unanimous,0,0,0,0
Antonina Shevchenko,2019-04-20,Roxanne Modafferi,Decision - Split,0,31,0,31
Antonina Shevchenko,2022-07-09,Cortney Casey,Decision - Split,70,22,0,92
Antonina Shevchenko,2021-10-02,Casey O'Neill,KO/TKO,0,0,0,0
Antonina Shevchenko,2019-08-03,Lucie Pudilova,Submission,90,10,0,100
Antonina Shevchenko,2021-05-15,Andrea Lee,Submission,0,0,0,0
Antonina Shevchenko,2018-06-26,Jaimelene Nievera,KO/TKO,100,59,0,159
Louis Smolka,2014-01-15,Alptekin Ozkilic,Decision - Unanimous,80,32,0,112
Louis Smolka,2016-10-01,Brandon Moreno,Submission,0,0,0,0
Louis Smolka,2016-12-30,Ray Borg,Decision - Unanimous,0,0,0,0
Louis Smolka,2016-07-13,Ben Nguyen,KO/TKO,100,78,0,178
Louis Smolka,2015-07-11,Neil Seery,Decision - Unanimous,80,2,0,82
Louis Smolka,2015-10-24,Paddy Holohan,Submission,90,43,0,133
Louis Smolka,2018-11-24,Sumudaerji,Submission,90,14,0,104
Louis Smolka,2019-03-09,Matt Schnell,Submission,0,0,0,0
Louis Smolka,2017-12-30,Matheus Nicolau,Decision - Unanimous,0,0,0,0
Louis Smolka,2014-05-10,Chris Cariaso,Decision - Split,0,0,0,0
Louis Smolka,2020-12-05,Jose Quinonez,KO/TKO,100,16,0,116
Louis Smolka,2020-05-30,Casey Kenney,Submission,0,0,0,0
Louis Smolka,2022-05-14,Davey Grant,KO/TKO,0,0,0,0
Louis Smolka,2017-04-15,Tim Elliott,Decision - Unanimous,0,0,0,0
Louis Smolka,2019-09-14,Ryan MacDonald,KO/TKO,100,29,0,129
Louis Smolka,2021-12-04,Vince Morales,KO/TKO,0,0,0,0
Louis Smolka,2014-11-07,Richie Vaculik,KO/TKO,100,0,0,100
Alptekin Ozkilic,2014-01-15,Louis Smolka,Decision - Unanimous,0,0,0,0
Alptekin Ozkilic,2014-07-16,John Lineker,KO/TKO,0,0,0,0
Alptekin Ozkilic,2015-05-09,Ben Nguyen,KO/TKO,0,0,0,0
Alptekin Ozkilic,2013-12-14,Darren Uyenoyama,Decision - Split,70,0,0,70
James Wallace,2019-07-09,Joe Solecki,Submission,0,0,0,0
Zhalgas Zhumagulov,2023-06-24,Joshua Van,Decision - Split,0,0,0,0
Zhalgas Zhumagulov,2022-11-19,Charles Johnson,Decision - Split,0,4,0,4
Zhalgas Zhumagulov,2021-07-10,Jerome Rivera,Submission,90,0,0,90
Zhalgas Zhumagulov,2021-01-23,Amir Albazi,Decision - Unanimous,0,0,0,0
Zhalgas Zhumagulov,2022-06-04,Jeff Molina,Decision - Split,0,0,0,0
Zhalgas Zhumagulov,2021-12-04,Manel Kape,KO/TKO,0,0,0,0
Zhalgas Zhumagulov,2020-07-11,Raulian Paiva,Decision - Unanimous,0,14,0,14
Mike Davis,2019-04-27,Gilbert Burns,Submission,0,0,0,0
Mike Davis,2018-07-24,Sodiq Yusuff,Decision - Unanimous,0,0,0,0
Mike Davis,2019-10-12,Thomas Gifford,KO/TKO,100,51,0,151
Mike Davis,2024-03-16,Natan Levy,Submission,90,0,0,90
Mike Davis,2022-10-01,Viacheslav Borshchev,Decision - Unanimous,80,2,0,82
Mike Davis,2021-01-20,Mason Jones,Decision - Unanimous,80,0,0,80
Matthieu Duclos,2024-08-27,Marco Tulio,KO/TKO,0,0,0,0
Julian Marquez,2023-03-04,Marc-Andre Barriault,KO/TKO,0,0,0,0
Julian Marquez,2021-02-13,Maki Pitolo,Submission,90,9,0,99
Julian Marquez,2018-07-06,Alessio Di Chirico,Decision - Split,0,0,0,0
Julian Marquez,2021-04-10,Sam Alvey,Submission,90,32,0,122
Julian Marquez,2017-12-16,Darren Stewart,Submission,90,0,0,90
Julian Marquez,2022-06-18,Gregory Rodrigues,KO/TKO,0,0,0,0
Julian Marquez,2024-06-08,Zachary Reese,KO/TKO,0,0,0,0
Julian Marquez,2017-08-01,Phil Hawes,KO/TKO,100,18,0,118
Mike de la Torre,2016-09-24,Godofredo Pepey,Submission,0,0,0,0
Mike de la Torre,2015-02-22,Tiago dos Santos e Silva,KO/TKO,100,9,0,109
Mike de la Torre,2014-04-16,Mark Bocek,Decision - Split,0,0,0,0
Mike de la Torre,2015-11-28,Yui Chul Nam,Decision - Split,70,0,0,70
Mike de la Torre,2015-07-12,Maximo Blanco,KO/TKO,0,0,0,0
Mike de la Torre,2017-04-08,Myles Jury,KO/TKO,0,0,0,0
Flavio Luiz Moura,2007-08-04,Rousimar Palhares,Submission,0,1,0,1
Flavio Luiz Moura,1999-07-16,Paul Jones,Submission,0,0,0,0
Julija Stoliarenko,2024-02-03,Luana Carolina,KO/TKO,0,0,0,0
Julija Stoliarenko,2020-08-08,Yana Santos,Decision - Unanimous,0,0,0,0
Julija Stoliarenko,2022-10-01,Chelsea Chandler,KO/TKO,0,0,0,0
Julija Stoliarenko,2023-07-22,Molly McCann,Submission,90,3,0,93
Julija Stoliarenko,2018-11-30,Leah Letson,Decision - Split,0,0,0,0
Julija Stoliarenko,2022-02-05,Alexis Davis,Decision - Unanimous,0,0,0,0
Julija Stoliarenko,2021-06-26,Julia Avila,Submission,0,0,0,0
Julija Stoliarenko,2022-07-02,Jessica-Rose Clark,Submission,90,0,0,90
Danny Silva,2024-03-16,Josh Culibao,Decision - Split,70,0,0,70
Danny Silva,2023-09-26,Angel Pacheco,Decision - Unanimous,80,7,0,87
Adam Lynn,2007-09-29,Josh Thomson,KO/TKO,0,0,0,0
Jay Hieron,2005-10-03,Jonathan Goulet,TKO - Doctor's Stoppage,0,0,0,0
Jay Hieron,2004-06-19,Georges St-Pierre,KO/TKO,0,0,0,0
Jay Hieron,2010-01-30,Joe Riggs,Decision - Unanimous,80,15,0,95
Jay Hieron,2013-02-02,Tyron Woodley,KO/TKO,0,0,0,0
Jay Hieron,2012-10-05,Jake Ellenberger,Decision - Unanimous,0,7,0,7
Jay Hieron,2009-01-24,Jason High,KO/TKO,100,6,0,106
Cung Le,2006-06-09,Brian Warren,KO/TKO,100,15,0,115
Cung Le,2014-08-23,Michael Bisping,KO/TKO,0,0,25,25
Cung Le,2008-03-29,Frank Shamrock,TKO - Doctor's Stoppage,0,21,25,46
Cung Le,2009-12-19,Scott Smith,KO/TKO,0,43,0,43
Cung Le,2012-07-07,Patrick Cote,Decision - Unanimous,80,4,0,84
Cung Le,2010-06-26,Scott Smith,KO/TKO,100,54,0,154
Cung Le,2007-11-16,Sammy Morgan,KO/TKO,100,24,0,124
Cung Le,2006-12-08,Jason Von Flue,TKO - Doctor's Stoppage,0,2,0,2
Cung Le,2011-11-19,Wanderlei Silva,KO/TKO,0,0,0,0
Cung Le,2012-11-10,Rich Franklin,KO/TKO,100,0,25,125
Cung Le,2007-06-22,Tony Fryklund,KO/TKO,100,55,0,155
Cung Le,2006-03-10,Mike Altman,KO/TKO,100,2,0,102
Brian Warren,2006-06-09,Cung Le,KO/TKO,0,0,0,0
Mike Campbell,2009-06-07,Anthony Pettis,Submission,0,2,0,2
Mike Campbell,2009-01-25,Danillo Villefort,KO/TKO,0,0,0,0
Clint Godfrey,2010-01-10,Wagnney Fabiano,Decision - Unanimous,0,0,0,0
Clint Godfrey,2010-11-11,Michael McDonald,Submission,0,0,0,0
Richie Santiago,2019-06-25,Miles Johns,Decision - Unanimous,0,0,0,0
Chase Gibson,2020-09-01,Tucker Lutz,Decision - Unanimous,0,0,0,0
Marco Polo Reyes,2016-11-05,Jason Novelli,Decision - Split,70,21,0,91
Marco Polo Reyes,2019-09-21,Kyle Nelson,KO/TKO,0,0,0,0
Marco Polo Reyes,2019-06-29,Drew Dober,KO/TKO,0,0,0,0
Marco Polo Reyes,2015-11-21,Cesar Arzamendia,KO/TKO,100,0,0,100
Marco Polo Reyes,2017-05-13,James Vick,KO/TKO,0,0,0,0
Marco Polo Reyes,2018-01-14,Matt Frevola,KO/TKO,100,9,0,109
Marco Polo Reyes,2016-06-04,Dong Hyun Ma,KO/TKO,100,52,0,152
Marco Polo Reyes,2019-02-23,Damir Hadzovic,KO/TKO,0,0,0,0
Chandler Cole,2023-08-29,Thomas Petersen,Submission,0,0,0,0
Ryan Janes,2017-02-19,Gerald Meerschaert,Submission,0,0,0,0
Ryan Janes,2017-12-01,Andrew Sanchez,KO/TKO,100,63,0,163
Ryan Janes,2017-07-16,Jack Marshman,Decision - Unanimous,0,8,0,8
Ryan Janes,2016-12-09,Keith Berish,Decision - Unanimous,80,21,0,101
Dominique Steele,2015-07-25,Zak Cummings,KO/TKO,0,0,0,0
Dominique Steele,2016-04-23,Danny Roberts,Decision - Unanimous,0,0,0,0
Dominique Steele,2015-11-28,Dong Hyun Ma,KO/TKO,100,17,0,117
Dominique Steele,2016-08-06,Court McGee,Decision - Unanimous,0,8,0,8
Dominique Steele,2011-09-10,Chris Mierzwiak,Decision - Unanimous,80,2,0,82
Dominique Steele,2017-06-10,Luke Jumeau,Decision - Unanimous,0,4,0,4
Delson Heleno,2012-06-23,Francisco Trinaldo,KO/TKO,0,0,0,0
Doug Evans,2007-12-29,Mark Bocek,Decision - Unanimous,0,0,0,0
Doug Evans,2007-06-23,Roger Huerta,KO/TKO,0,0,0,0
Rilley Dutro,2018-07-10,Jordan Espinosa,KO/TKO,0,0,0,0
Jose Johnson,2023-11-18,Chad Anheliger,Submission,90,37,0,127
Jose Johnson,2022-08-16,Jack Cartwright,Decision - Unanimous,80,38,0,118
Jose Johnson,2023-08-12,Da'Mon Blackshear,Submission,0,0,0,0
Jose Johnson,2024-06-15,Asu Almabayev,Decision - Unanimous,0,0,0,0
Jose Johnson,2020-09-01,Ronnie Lawrence,Decision - Unanimous,0,0,0,0
Paulo Renato Junior,2022-08-09,Jamal Pogues,Decision - Unanimous,0,8,0,8
Paulo Renato Junior,2023-08-15,Ibo Aslan,KO/TKO,0,0,0,0
Kyle Kingsbury,2011-02-05,Ricardo Romero,KO/TKO,100,8,0,108
Kyle Kingsbury,2010-09-15,Jared Hamman,Decision - Unanimous,80,0,0,80
Kyle Kingsbury,2012-05-26,Glover Teixeira,Submission,0,0,0,0
Kyle Kingsbury,2011-11-19,Stephan Bonnar,Decision - Unanimous,0,0,0,0
Kyle Kingsbury,2011-06-04,Fabio Maldonado,Decision - Unanimous,80,17,0,97
Kyle Kingsbury,2014-07-26,Patrick Cummins,Decision - Unanimous,0,0,0,0
Kyle Kingsbury,2012-09-29,Jimi Manuwa,TKO - Doctor's Stoppage,0,0,0,0
Kyle Kingsbury,2008-12-13,Tom Lawlor,Decision - Unanimous,0,0,0,0
Kyle Kingsbury,2009-10-24,Razak Al-Hassan,Decision - Split,70,0,0,70
Ricardo Romero,2011-02-05,Kyle Kingsbury,KO/TKO,0,0,0,0
Ricardo Romero,2011-09-24,James Te Huna,KO/TKO,0,0,0,0
Ricardo Romero,2010-07-03,Seth Petruzelli,Submission,90,0,0,90
Gasan Umalatov,2014-05-31,Paulo Thiago,Decision - Unanimous,80,0,0,80
Gasan Umalatov,2014-02-01,Neil Magny,Decision - Unanimous,0,0,0,0
Gasan Umalatov,2014-10-04,Cathal Pendred,Decision - Split,0,0,0,0
Gasan Umalatov,2015-11-07,Viscardi Andrade,Decision - Unanimous,0,0,0,0
Vitor Miranda,2014-05-31,Antonio Carlos Junior,Decision - Unanimous,0,2,0,2
Vitor Miranda,2015-08-01,Clint Hester,KO/TKO,100,42,0,142
Vitor Miranda,2014-12-20,Jake Collier,KO/TKO,100,0,0,100
Vitor Miranda,2016-03-05,Marcelo Guimaraes,KO/TKO,100,23,0,123
Vitor Miranda,2017-06-25,Marvin Vettori,Decision - Unanimous,0,0,0,0
Vitor Miranda,2016-05-29,Chris Camozzi,Decision - Unanimous,0,0,0,0
Vitor Miranda,2018-07-22,Abu Azaitar,Decision - Unanimous,0,0,0,0
Vanessa Melo,2019-09-21,Irene Aldana,Decision - Unanimous,0,0,0,0
Vanessa Melo,2021-01-16,Sarah Moras,Decision - Unanimous,80,12,0,92
Vanessa Melo,2019-11-16,Tracy Cortez,Decision - Unanimous,0,0,0,0
Vanessa Melo,2020-07-11,Karol Rosa,Decision - Unanimous,0,0,0,0
Alex Andrade,2001-12-23,Murilo Rua,Decision - Unanimous,0,0,0,0
Alex Andrade,2000-06-09,Amaury Bitetti,DQ,0,6,0,6
Hiroshi Izumi,2010-12-31,Ikuhisa Minowa,KO/TKO,100,20,0,120
Hiroshi Izumi,2009-12-31,Katsuyori Shibata,Decision - Unanimous,80,0,0,80
Hiroshi Izumi,2011-07-16,Gegard Mousasi,KO/TKO,0,0,0,0
Cyril Asker,2017-01-15,Dmitrii Smoliakov,KO/TKO,100,14,0,114
Cyril Asker,2016-04-10,Jared Cannonier,KO/TKO,0,0,0,0
Cyril Asker,2017-06-17,Walt Harris,KO/TKO,0,0,0,0
Cyril Asker,2017-11-25,Hu Yaozong,Submission,90,12,0,102
Cyril Asker,2018-02-10,Tai Tuivasa,KO/TKO,0,0,0,0
Nolan Ticman,2015-05-16,Yao Zhikui,Decision - Split,0,43,0,43
Nolan Ticman,2014-08-16,Frankie Saenz,Decision - Unanimous,0,0,0,0
Terrion Ware,2017-12-01,Sean O'Malley,Decision - Unanimous,0,0,0,0
Terrion Ware,2018-03-17,Tom Duquesnoy,Decision - Unanimous,0,18,0,18
Terrion Ware,2018-09-15,Merab Dvalishvili,Decision - Unanimous,0,0,0,0
Terrion Ware,2017-07-08,Cody Stamann,Decision - Unanimous,0,0,0,0
Xie Bin,2022-06-10,JeongYeong Lee,Submission,0,0,0,0
Xie Bin,2024-05-18,Yibugele,Decision - Unanimous,80,63,0,143
Xie Bin,2024-08-23,Masuto Kawana,KO/TKO,100,9,0,109
Xie Bin,2021-10-26,Olivier Murad,Decision - Split,0,0,0,0
Din Thomas,2006-11-11,Rich Clementi,Submission,90,11,0,101
Din Thomas,2007-05-26,Jeremy Stephens,Submission,90,3,0,93
Din Thomas,2001-09-28,Fabiano Iha,Decision - Unanimous,80,23,0,103
Din Thomas,2007-01-25,Clay Guida,Decision - Unanimous,80,0,0,80
Din Thomas,2008-04-02,Josh Neer,Decision - Unanimous,0,0,0,0
Din Thomas,2002-09-27,Caol Uno,Decision - Unanimous,0,0,0,0
Din Thomas,2003-02-28,Matt Serra,Decision - Split,70,3,0,73
Din Thomas,2007-09-19,Kenny Florian,Submission,0,0,0,0
Din Thomas,2001-06-29,BJ Penn,KO/TKO,0,0,0,0
Aaron Riley,2005-05-22,Michihiro Omigawa,KO/TKO,100,26,0,126
Aaron Riley,2013-07-27,Justin Salas,Decision - Split,0,0,0,0
Aaron Riley,2009-11-14,Ross Pearson,TKO - Doctor's Stoppage,0,0,0,0
Aaron Riley,2008-11-15,Jorge Gurgel,Decision - Unanimous,80,28,0,108
Aaron Riley,2009-08-08,Shane Nelson,Decision - Unanimous,80,22,0,102
Aaron Riley,2010-05-29,Joe Brammer,Decision - Unanimous,80,9,0,89
Aaron Riley,2002-05-10,Robbie Lawler,Decision - Unanimous,0,0,0,0
Aaron Riley,2006-01-16,Spencer Fisher,TKO - Doctor's Stoppage,0,0,0,0
Aaron Riley,2011-09-24,Tony Ferguson,TKO - Doctor's Stoppage,0,0,0,0
Aaron Riley,2009-03-07,Shane Nelson,KO/TKO,0,0,0,0
Michihiro Omigawa,2005-05-22,Aaron Riley,KO/TKO,0,0,0,0
Michihiro Omigawa,2008-01-23,Thiago Tavares,Decision - Unanimous,0,0,0,0
Michihiro Omigawa,2011-02-05,Chad Mendes,Decision - Unanimous,0,0,0,0
Michihiro Omigawa,2011-11-05,Jason Young,Decision - Unanimous,80,0,0,80
Michihiro Omigawa,2007-09-22,Matt Wiman,Decision - Unanimous,0,0,0,0
Michihiro Omigawa,2009-12-31,Hiroyuki Takaya,KO/TKO,100,15,0,115
Michihiro Omigawa,2012-08-04,Manvel Gamburyan,Decision - Unanimous,0,0,0,0
Michihiro Omigawa,2010-07-10,Young Sam Jung,Submission,90,17,0,107
Michihiro Omigawa,2010-09-25,Cole Escovedo,Submission,90,0,0,90
Michihiro Omigawa,2011-06-11,Darren Elkins,Decision - Unanimous,0,0,0,0
Michihiro Omigawa,2012-12-31,Tatsuya Kawajiri,Decision - Unanimous,0,0,0,0
Michihiro Omigawa,2012-01-14,Iuri Alcantara,Decision - Unanimous,0,0,0,0
Danielle Taylor,2017-04-22,Jessica Penne,Decision - Unanimous,80,3,0,83
Danielle Taylor,2018-01-14,JJ Aldrich,Decision - Unanimous,0,0,0,0
Danielle Taylor,2018-08-04,Zhang Weili,Decision - Unanimous,0,0,0,0
Danielle Taylor,2016-08-06,Maryna Moroz,Decision - Split,0,0,0,0
Danielle Taylor,2016-11-26,Seo Hee Ham,Decision - Split,70,14,0,84
Vinicius Moreira,2019-06-29,Eryk Anders,KO/TKO,0,0,0,0
Vinicius Moreira,2019-09-21,Paul Craig,Submission,0,0,0,0
Vinicius Moreira,2019-01-19,Alonzo Menifield,KO/TKO,0,0,0,0
Vinicius Moreira,2018-08-12,John Allan,Submission,90,4,0,94
Vinicius Moreira,2021-01-20,Ike Villanueva,KO/TKO,0,0,0,0
Wulijiburen,2022-06-10,Shohei Nose,KO/TKO,0,0,0,0
Wulijiburen,2017-11-25,Rolando Dy,Decision - Unanimous,0,0,0,0
Wulijiburen,2018-08-04,Marlon Vera,KO/TKO,0,0,0,0
Wulijiburen,2019-02-09,Jonathan Martinez,Decision - Unanimous,0,0,0,0
Eric Shelton,2017-11-18,Jenel Lausa,Decision - Unanimous,80,81,0,161
Eric Shelton,2017-07-29,Jarred Brooks,Decision - Split,0,4,0,4
Eric Shelton,2019-03-23,Jordan Espinosa,Decision - Unanimous,0,0,0,0
Eric Shelton,2018-11-10,Joseph Morales,Decision - Split,70,0,0,70
Eric Shelton,2018-02-24,Alex Perez,Decision - Unanimous,0,12,0,12
Eric Shelton,2017-01-28,Alexandre Pantoja,Decision - Split,0,0,0,0
Anshul Jubli,2022-10-23,KyeungPyo Kim,Decision - Split,70,0,0,70
Anshul Jubli,2023-02-04,Jeka Saragih,KO/TKO,100,24,0,124
Anshul Jubli,2023-10-21,Mike Breeden,KO/TKO,0,11,0,11
KyeungPyo Kim,2022-10-23,Anshul Jubli,Decision - Split,0,3,0,3
KyeungPyo Kim,2022-06-10,Jinensibieke Asikeerbai,KO/TKO,100,4,0,104
Egan Inoue,2001-03-25,Guy Mezger,KO/TKO,0,0,0,0
Egan Inoue,1999-04-29,Minoru Toyonaga,KO/TKO,100,8,0,108
Egan Inoue,1999-07-04,Carl Malenko,Decision - Unanimous,0,0,0,0
Teddy Ash,2019-08-27,Dusko Todorovic,Decision - Unanimous,0,7,0,7
Cameron Else,2020-10-03,Kyler Phillips,KO/TKO,0,0,0,0
Cameron Else,2022-04-23,Aoriqileng,KO/TKO,0,0,0,0
Herbert Burns,2024-08-17,Jack Jenkins,KO/TKO,0,0,0,0
Herbert Burns,2024-03-30,Julio Arce,KO/TKO,0,0,0,0
Herbert Burns,2019-08-06,Darrick Minner,Submission,90,0,0,90
Herbert Burns,2020-01-25,Nate Landwehr,KO/TKO,100,3,0,103
Herbert Burns,2022-07-16,Bill Algeo,KO/TKO,0,0,0,0
Herbert Burns,2020-06-06,Evan Dunham,Submission,90,2,0,92
Herbert Burns,2020-08-15,Daniel Pineda,KO/TKO,0,0,0,0
Steve Erceg,2024-08-17,Kai Kara-France,KO/TKO,0,0,0,0
Steve Erceg,2023-06-10,David Dvorak,Decision - Unanimous,80,1,0,81
Steve Erceg,2023-11-11,Alessandro Costa,Decision - Unanimous,80,20,0,100
Steve Erceg,2024-05-04,Alexandre Pantoja,Decision - Unanimous,0,0,25,25
Steve Erceg,2024-03-02,Matt Schnell,KO/TKO,100,12,0,112
Gleidson Cutis,2018-08-12,Thiago Moises,KO/TKO,0,0,0,0
Josh Clopton,2013-08-03,Rani Yahya,Decision - Unanimous,0,0,0,0
Josh Clopton,2011-12-03,Steven Siler,Decision - Unanimous,0,0,0,0
Zelim Imadaev,2019-04-13,Max Griffin,Decision - Majority,0,17,0,17
Zelim Imadaev,2020-09-05,Michel Pereira,Submission,0,0,0,0
Zelim Imadaev,2019-11-09,Danny Roberts,KO/TKO,0,0,0,0
Bryan Battle,2023-09-23,AJ Fletcher,Submission,90,20,0,110
Bryan Battle,2022-12-17,Rinat Fakhretdinov,Decision - Unanimous,0,0,0,0
Bryan Battle,2023-05-13,Gabe Green,KO/TKO,100,0,0,100
Bryan Battle,2024-12-07,Randy Brown,Decision - Split,70,0,0,70
Bryan Battle,2021-08-28,Gilbert Urbina,Submission,90,1,0,91
Bryan Battle,2022-08-06,Takashi Sato,KO/TKO,100,5,0,105
Bryan Battle,2024-09-28,Kevin Jousset,KO/TKO,100,39,0,139
Bryan Battle,2022-02-05,Tresean Gore,Decision - Unanimous,80,55,0,135
AJ Fletcher,2023-09-23,Bryan Battle,Submission,0,0,0,0
AJ Fletcher,2022-08-20,Ange Loosa,Decision - Unanimous,0,0,0,0
AJ Fletcher,2023-02-18,Themba Gorimbo,Submission,90,1,0,91
AJ Fletcher,2022-03-12,Matthew Semelsberger,Decision - Unanimous,0,0,0,0
AJ Fletcher,2021-08-31,Leonardo Damiani,KO/TKO,100,6,0,106
Yurij Kiseliov,2007-03-12,Kazushi Sakuraba,Submission,0,7,0,7
Muhammed Lawal,2009-03-20,Ryo Kawamura,Decision - Unanimous,80,50,0,130
Muhammed Lawal,2009-12-19,Mike Whitehead,KO/TKO,100,2,0,102
Muhammed Lawal,2008-09-28,Travis Wiuff,KO/TKO,100,5,0,105
Muhammed Lawal,2009-08-28,Mark Kerr,KO/TKO,100,7,0,107
Muhammed Lawal,2008-11-01,Fabio Silva,KO/TKO,100,62,0,162
Muhammed Lawal,2010-04-17,Gegard Mousasi,Decision - Unanimous,80,21,25,126
Muhammed Lawal,2011-09-10,Roger Gracie,KO/TKO,100,3,0,103
Muhammed Lawal,2010-08-21,Rafael Cavalcante,KO/TKO,0,15,25,40
Muhammed Lawal,2009-01-04,Yukiya Naito,KO/TKO,100,14,0,114
Ryo Kawamura,2009-03-20,Muhammed Lawal,Decision - Unanimous,0,0,0,0
Clay Collard,2014-12-06,Alex White,Decision - Unanimous,80,2,0,82
Clay Collard,2015-09-05,Tiago dos Santos e Silva,Decision - Split,0,32,0,32
Clay Collard,2014-08-23,Max Holloway,KO/TKO,0,0,0,0
Clay Collard,2015-06-13,Gabriel Benitez,Decision - Unanimous,0,0,0,0
Justin Willis,2018-04-21,Chase Sherman,Decision - Unanimous,80,7,0,87
Justin Willis,2017-07-16,James Mulheron,Decision - Unanimous,80,16,0,96
Justin Willis,2019-03-23,Curtis Blaydes,Decision - Unanimous,0,0,0,0
Justin Willis,2018-12-01,Mark Hunt,Decision - Unanimous,80,40,0,120
Justin Willis,2017-12-02,Allen Crowder,KO/TKO,100,7,0,107
Lee Murray,2004-01-31,Jorge Rivera,Submission,90,0,0,90
Lee Murray,2004-09-11,Anderson Silva,Decision - Unanimous,0,0,0,0
Luis Pena,2019-10-12,Matt Frevola,Decision - Split,0,3,0,3
Luis Pena,2019-06-22,Matt Wiman,KO/TKO,100,63,0,163
Luis Pena,2021-04-17,Alexander Munoz,Decision - Split,70,10,0,80
Luis Pena,2020-02-29,Steve Garcia,Decision - Unanimous,80,6,0,86
Luis Pena,2020-06-27,Khama Worthy,Submission,0,0,0,0
Luis Pena,2018-07-06,Richie Smullen,Submission,90,1,0,91
Luis Pena,2019-03-23,Steven Peterson,Decision - Unanimous,80,18,0,98
Luis Pena,2018-11-10,Michael Trizano,Decision - Split,0,0,0,0
James Toney,2010-08-28,Randy Couture,Submission,0,0,0,0
Valesca Machado,2021-10-19,Piera Rodriguez,Decision - Unanimous,0,0,0,0
Nate Moore,2012-07-14,Jason High,Submission,0,0,0,0
Nate Moore,2010-05-21,Tarec Saffiedine,KO/TKO,0,0,0,0
Nate Moore,2011-01-29,Nathan Coy,KO/TKO,100,0,0,100
Takafumi Otsuka,2009-03-08,Bibiano Fernandes,Decision - Unanimous,0,0,0,0
Takafumi Otsuka,2011-05-29,Kenji Osawa,Decision - Split,0,0,0,0
Takafumi Otsuka,2011-09-24,Bibiano Fernandes,Submission,0,1,0,1
Takafumi Otsuka,2010-05-29,Kazuyuki Miyata,Decision - Split,0,0,0,0
John Lewis,2000-11-17,Jens Pulver,KO/TKO,0,0,0,0
John Lewis,1999-09-24,Lowell Anderson,KO/TKO,100,11,0,111
Javid Basharat,2022-09-17,Tony Gravely,Decision - Unanimous,80,47,0,127
Javid Basharat,2022-03-12,Trevin Jones,Decision - Unanimous,80,27,0,107
Javid Basharat,2024-03-02,Aiemann Zahabi,Decision - Unanimous,0,0,0,0
Javid Basharat,2023-01-14,Mateus Mendonca,Decision - Unanimous,80,66,0,146
Javid Basharat,2021-10-26,Oron Kahlon,Submission,90,58,0,148
Clay Harvison,2011-09-17,Seth Baczynski,Submission,0,0,0,0
Clay Harvison,2011-11-12,DaMarques Johnson,KO/TKO,0,0,0,0
Clay Harvison,2011-06-04,Justin Edwards,Decision - Split,70,15,0,85
Mike Grundy,2021-05-15,Lando Vannata,Decision - Split,0,0,0,0
Mike Grundy,2019-03-16,Nad Narimani,KO/TKO,100,11,0,111
Mike Grundy,2022-03-19,Makwan Amirkhani,Submission,0,0,0,0
Mike Grundy,2020-07-25,Movsar Evloev,Decision - Unanimous,0,0,0,0
Mana Martinez,2021-08-28,Guido Cannetti,Decision - Split,70,13,0,83
Mana Martinez,2022-10-15,Brandon Davis,Decision - Split,70,11,0,81
Mana Martinez,2020-09-08,Drako Rodriguez,Submission,0,2,0,2
Mana Martinez,2022-02-12,Ronnie Lawrence,Decision - Unanimous,0,0,0,0
Mana Martinez,2023-03-04,Cameron Saaiman,Decision - Majority,0,0,0,0
Jason Riley,2010-08-21,Daniel Cormier,KO/TKO,0,0,0,0
Eddie Ruiz,2003-06-06,Yves Edwards,Decision - Unanimous,0,0,0,0
John Campetella,1996-07-12,Gary Goodridge,KO/TKO,0,0,0,0
Alex Stiebling,2006-07-28,Jason Guida,Decision - Unanimous,80,22,0,102
Alex Stiebling,2000-11-17,Mark Hughes,Decision - Unanimous,0,0,0,0
Alex Stiebling,2006-08-17,Fernando Gonzalez,TKO - Doctor's Stoppage,0,0,0,0
Alex Stiebling,2002-02-24,Wallid Ismail,Decision - Unanimous,80,12,0,92
Alex Stiebling,2001-12-23,Allan Goes,KO/TKO,100,2,0,102
Alex Stiebling,2002-06-23,Anderson Silva,TKO - Doctor's Stoppage,0,0,0,0
Alex Stiebling,2003-03-16,Akira Shoji,Decision - Split,0,23,0,23
Jason Guida,2006-07-28,Alex Stiebling,Decision - Unanimous,0,0,0,0
Mariusz Ksiazkiewicz,2020-11-10,Mario Sousa,Decision - Unanimous,0,0,0,0
Jorge Santiago,2007-11-16,Sean Salmon,KO/TKO,100,2,0,102
Jorge Santiago,2006-06-28,Justin Levens,KO/TKO,100,9,0,109
Jorge Santiago,2006-08-17,Chris Leben,KO/TKO,0,0,0,0
Jorge Santiago,2006-12-13,Alan Belcher,KO/TKO,0,0,0,0
Jorge Santiago,2013-02-16,Gunnar Nelson,Decision - Unanimous,0,1,0,1
Jorge Santiago,2004-06-12,Diego Sanchez,Decision - Unanimous,0,0,0,0
Jorge Santiago,2011-05-28,Brian Stann,KO/TKO,0,0,0,0
Jorge Santiago,2011-10-08,Demian Maia,Decision - Unanimous,0,0,0,0
Jorge Santiago,2007-11-16,Trevor Prangley,KO/TKO,100,5,0,105
Sean Salmon,2007-11-16,Jorge Santiago,KO/TKO,0,0,0,0
Sean Salmon,2007-05-26,Alan Belcher,Submission,0,1,0,1
Sean Salmon,2007-01-25,Rashad Evans,KO/TKO,0,0,0,0
Ross Ebanez,2009-03-08,Tatsuya Kawajiri,Submission,0,0,0,0
David Bielkheden,2009-04-18,Mark Bocek,Submission,0,0,0,0
David Bielkheden,2008-03-01,Diego Sanchez,KO/TKO,0,0,0,0
David Bielkheden,2006-11-05,Mitsuhiro Ishida,Decision - Unanimous,0,0,0,0
David Bielkheden,2008-10-18,Jess Liaudin,Decision - Unanimous,80,24,0,104
Jeremiah Wells,2023-08-05,Carlston Harris,Submission,0,13,0,13
Jeremiah Wells,2022-06-18,Court McGee,KO/TKO,100,4,0,104
Jeremiah Wells,2021-06-26,Warlley Alves,KO/TKO,100,6,0,106
Jeremiah Wells,2022-02-12,Blood Diamond,Submission,90,14,0,104
Jeremiah Wells,2024-02-10,Max Griffin,Decision - Split,0,6,0,6
Jeremiah Wells,2023-04-22,Matthew Semelsberger,Decision - Split,70,16,0,86
Ryan Hall,2018-12-29,BJ Penn,Submission,90,3,0,93
Ryan Hall,2021-12-11,Darrick Minner,Decision - Unanimous,80,14,0,94
Ryan Hall,2019-07-13,Darren Elkins,Decision - Unanimous,80,7,0,87
Ryan Hall,2015-12-11,Artem Lobov,Decision - Unanimous,80,21,0,101
Ryan Hall,2021-07-10,Ilia Topuria,KO/TKO,0,0,0,0
Ryan Hall,2016-12-03,Gray Maynard,Decision - Unanimous,80,34,0,114
Charlie Ward,2016-11-19,Abdul Razak Alhassan,KO/TKO,0,0,0,0
Charlie Ward,2017-07-16,Galore Bofando,KO/TKO,0,0,0,0
Chris Cope,2012-02-04,Matt Brown,KO/TKO,0,0,0,0
Chris Cope,2011-11-05,Che Mills,KO/TKO,0,0,0,0
Chris Cope,2011-06-04,Chuck O'Neil,Decision - Unanimous,80,19,0,99
Chan-Mi Jeon,2017-06-10,JJ Aldrich,Decision - Unanimous,0,0,0,0
Chan-Mi Jeon,2017-09-22,Syuri Kondo,Decision - Split,0,0,0,0
Semmy Schilt,2001-11-03,Masaaki Satake,KO/TKO,100,4,0,104
Semmy Schilt,2001-12-23,Yoshihiro Takayama,KO/TKO,100,11,0,111
Semmy Schilt,2004-06-20,Sergei Kharitonov,KO/TKO,0,0,0,0
Semmy Schilt,2004-04-25,Gan McGee,Submission,90,0,0,90
Semmy Schilt,2001-05-04,Pete Williams,KO/TKO,100,9,0,109
Semmy Schilt,2008-12-31,Siala Siliga,Submission,90,2,0,92
Semmy Schilt,2002-06-23,Fedor Emelianenko,Decision - Unanimous,0,0,0,0
Semmy Schilt,2002-11-24,Antonio Rodrigo Nogueira,Submission,0,0,0,0
Semmy Schilt,2001-09-24,Akira Shoji,KO/TKO,100,15,0,115
Semmy Schilt,2001-06-29,Josh Barnett,Submission,0,0,0,0
Masaaki Satake,2001-11-03,Semmy Schilt,KO/TKO,0,0,0,0
Masaaki Satake,2001-03-25,Tadao Yasuda,Decision - Split,0,0,0,0
Masaaki Satake,2000-08-27,Kazunari Murakami,KO/TKO,100,11,0,111
Masaaki Satake,2000-01-30,Mark Coleman,Submission,0,0,0,0
Masaaki Satake,2000-05-01,Guy Mezger,Decision - Unanimous,0,0,0,0
Masaaki Satake,2001-07-29,Igor Vovchanchyn,Decision - Unanimous,0,0,0,0
Masaaki Satake,2002-04-28,Quinton Jackson,KO/TKO,0,0,0,0
Masaaki Satake,2000-10-31,Naoya Ogawa,Submission,0,21,0,21
Natalia Silva,2024-09-07,Jessica Andrade,Decision - Unanimous,80,67,0,147
Natalia Silva,2023-08-19,Andrea Lee,Decision - Unanimous,80,27,0,107
Natalia Silva,2024-02-03,Viviane Araujo,Decision - Unanimous,80,12,0,92
Natalia Silva,2023-05-20,Victoria Leonardo,KO/TKO,100,13,0,113
Natalia Silva,2022-11-19,Tereza Bleda,KO/TKO,100,27,0,127
Natalia Silva,2022-06-18,Jasmine Jasudavicius,Decision - Unanimous,80,65,0,145
Danny Henry,2019-03-16,Dan Ige,Submission,0,0,0,0
Danny Henry,2017-07-16,Daniel Teymur,Decision - Unanimous,80,24,0,104
Danny Henry,2020-07-11,Makwan Amirkhani,Submission,0,4,0,4
Danny Henry,2018-03-17,Hakeem Dawodu,Submission,90,0,0,90
Tracy Cortez,2023-09-16,Jasmine Jasudavicius,Decision - Unanimous,80,26,0,106
Tracy Cortez,2020-10-10,Stephanie Egger,Decision - Unanimous,80,10,0,90
Tracy Cortez,2022-05-07,Melissa Gatto,Decision - Unanimous,80,6,0,86
Tracy Cortez,2019-07-30,Mariya Agapova,Decision - Unanimous,80,27,0,107
Tracy Cortez,2019-11-16,Vanessa Melo,Decision - Unanimous,80,39,0,119
Tracy Cortez,2024-07-13,Rose Namajunas,Decision - Unanimous,0,0,25,25
Tracy Cortez,2021-04-17,Justine Kish,Decision - Split,70,11,0,81
Austin Lingo,2023-03-25,Nate Landwehr,Submission,0,0,0,0
Austin Lingo,2023-07-15,Melquizael Costa,Decision - Unanimous,0,0,0,0
Austin Lingo,2020-02-08,Youssef Zalal,Decision - Unanimous,0,0,0,0
Austin Lingo,2021-01-16,Jacob Kilburn,Decision - Unanimous,80,31,0,111
Austin Lingo,2021-08-21,Luis Saldana,Decision - Unanimous,80,0,0,80
Takashi Sato,2022-03-19,Gunnar Nelson,Decision - Unanimous,0,0,0,0
Takashi Sato,2023-05-20,Themba Gorimbo,Decision - Unanimous,0,0,0,0
Takashi Sato,2019-04-27,Ben Saunders,KO/TKO,100,0,0,100
Takashi Sato,2020-06-27,Jason Witt,KO/TKO,100,16,0,116
Takashi Sato,2022-08-06,Bryan Battle,KO/TKO,0,0,0,0
Takashi Sato,2020-11-28,Miguel Baeza,Submission,0,0,0,0
Takashi Sato,2019-09-07,Belal Muhammad,Submission,0,0,0,0
Sidney Outlaw,2017-07-18,Michael Cora,Decision - Unanimous,80,0,0,80
Michael Cora,2017-07-18,Sidney Outlaw,Decision - Unanimous,0,10,0,10
Brok Weaver,2020-09-12,Jalin Turner,Submission,0,0,0,0
Brok Weaver,2020-02-15,Kazula Vargas,DQ,0,0,0,0
Brok Weaver,2019-08-13,Devin Smyth,Decision - Unanimous,80,62,0,142
Brok Weaver,2020-05-30,Roosevelt Roberts,Submission,0,0,0,0
Naoya Ogawa,2004-08-15,Fedor Emelianenko,Submission,0,0,0,0
Naoya Ogawa,1999-07-04,Gary Goodridge,Submission,90,0,0,90
Naoya Ogawa,2005-12-31,Hidehiko Yoshida,Submission,0,0,0,0
Naoya Ogawa,2004-04-25,Stefan Leko,Submission,90,6,0,96
Naoya Ogawa,2000-10-31,Masaaki Satake,Submission,90,0,0,90
Naoya Ogawa,2004-06-20,Paulo Cesar Silva,KO/TKO,100,13,0,113
Maxim Grishin,2021-02-27,Dustin Jacoby,Decision - Unanimous,0,9,0,9
Maxim Grishin,2020-10-17,Gadzhimurad Antigulov,KO/TKO,100,22,0,122
Maxim Grishin,2023-06-03,Philipe Lins,Decision - Unanimous,0,0,0,0
Maxim Grishin,2022-02-12,William Knight,Decision - Unanimous,80,48,0,128
Maxim Grishin,2020-07-11,Marcin Tybura,Decision - Unanimous,0,0,0,0
Jess Liaudin,2007-04-21,Dennis Siver,Submission,90,0,0,90
Jess Liaudin,2008-06-07,Paul Taylor,Decision - Split,0,0,0,0
Jess Liaudin,2007-09-08,Anthony Torres,KO/TKO,100,25,0,125
Jess Liaudin,2008-01-19,Marcus Davis,KO/TKO,0,0,0,0
Jess Liaudin,2008-10-18,David Bielkheden,Decision - Unanimous,0,0,0,0
Benito Lopez,2017-12-09,Albert Morales,Decision - Unanimous,80,0,0,80
Benito Lopez,2017-08-22,Steven Peterson,Decision - Split,70,0,0,70
Benito Lopez,2019-07-13,Vince Morales,Decision - Unanimous,80,0,0,80
Benito Lopez,2022-11-05,Mario Bautista,Submission,0,0,0,0
Benito Lopez,2019-02-17,Manny Bermudez,Submission,0,0,0,0
Albert Morales,2017-12-09,Benito Lopez,Decision - Unanimous,0,0,0,0
Albert Morales,2016-11-19,Thomas Almeida,KO/TKO,0,0,0,0
Albert Morales,2017-07-16,Brett Johns,Decision - Unanimous,0,0,0,0
Albert Morales,2017-03-04,Andre Soukhamthath,Decision - Split,70,10,0,80
Albert Morales,2018-02-24,Manny Bermudez,Submission,0,7,0,7
Rana Rudra Pratap Singh,2023-05-28,ChangHo Lee,KO/TKO,0,0,0,0
Jeremiah Metcalf,2006-10-07,Luke Stewart,Submission,0,0,0,0
Jeremiah Metcalf,2008-06-27,Raymond Daniels,Submission,90,13,0,103
Paul Bradley,2010-02-26,Luke Rockhold,KO/TKO,0,0,0,0
Paul Bradley,2011-08-06,Rafael Natal,Decision - Unanimous,0,0,0,0
Paul Bradley,2011-11-12,Mike Pierce,Decision - Split,0,0,0,0
Justin Sumter,2018-07-31,Ian Heinisch,KO/TKO,0,0,0,0
Justin Sumter,2019-07-09,Maki Pitolo,KO/TKO,0,0,0,0
Royler Gracie,1998-03-05,Yuhi Sano,Submission,90,8,0,98
Royler Gracie,1999-11-21,Kazushi Sakuraba,Submission,0,0,0,0
Yuhi Sano,1998-03-05,Royler Gracie,Submission,0,0,0,0
Yuhi Sano,2000-06-04,Carlos Newton,Submission,0,0,0,0
Yuhi Sano,1998-10-11,Satoshi Honma,KO/TKO,0,0,0,0
Louis Cosce,2020-08-18,Victor Reyna,KO/TKO,100,11,0,111
Louis Cosce,2020-11-21,Sasha Palatnikov,KO/TKO,0,0,0,0
Louis Cosce,2022-09-17,Trevin Giles,Decision - Unanimous,0,0,0,0
Jimmy Flick,2023-06-17,Alessandro Costa,KO/TKO,0,0,0,0
Jimmy Flick,2023-01-14,Charles Johnson,KO/TKO,0,0,0,0
Jimmy Flick,2024-01-20,Malcolm Gordon,Submission,90,0,0,90
Jimmy Flick,2020-09-01,Nate Smith,Submission,90,10,0,100
Jimmy Flick,2024-06-15,Nate Maness,Decision - Unanimous,0,0,0,0
Jimmy Flick,2020-12-19,Cody Durden,Submission,90,0,0,90
Gabriel Silva,2019-07-20,Ray Borg,Decision - Unanimous,0,0,0,0
Gabriel Silva,2020-02-29,Kyler Phillips,Decision - Unanimous,0,0,0,0
Brandon Royval,2023-04-15,Matheus Nicolau,KO/TKO,100,11,0,111
Brandon Royval,2020-09-26,Kai Kara-France,Submission,90,17,0,107
Brandon Royval,2024-10-12,Tatsuro Taira,Decision - Split,70,82,25,177
Brandon Royval,2022-01-15,Rogerio Bontorin,Decision - Split,70,12,0,82
Brandon Royval,2020-11-21,Brandon Moreno,KO/TKO,0,1,0,1
Brandon Royval,2022-05-07,Matt Schnell,Submission,90,2,0,92
Brandon Royval,2024-02-24,Brandon Moreno,Decision - Split,70,33,25,128
Brandon Royval,2023-12-16,Alexandre Pantoja,Decision - Unanimous,0,16,25,41
Brandon Royval,2021-08-21,Alexandre Pantoja,Submission,0,0,0,0
Brandon Royval,2020-05-30,Tim Elliott,Submission,90,0,0,90
Chris Heatherly,2014-08-23,Ben Saunders,Submission,0,0,0,0
Chris Heatherly,2014-11-15,Augusto Montano,KO/TKO,0,0,0,0
Marcelo Rojo,2021-03-13,Charles Jourdain,KO/TKO,0,0,0,0
Marcelo Rojo,2022-02-12,Kyler Phillips,Submission,0,0,0,0
Marcelo Rojo,2022-12-03,Francis Marshall,KO/TKO,0,8,0,8
Rolando Dy,2018-06-23,Shane Young,KO/TKO,0,0,0,0
Rolando Dy,2017-06-17,Alex Caceres,TKO - Doctor's Stoppage,0,0,0,0
Rolando Dy,2017-11-25,Wulijiburen,Decision - Unanimous,80,9,0,89
Rolando Dy,2017-09-22,Teruto Ishihara,Decision - Unanimous,0,0,0,0
Laureano Staropoli,2021-06-05,Roman Dolidze,Decision - Unanimous,0,0,0,0
Laureano Staropoli,2019-10-26,Muslim Salikhov,Decision - Unanimous,0,0,0,0
Laureano Staropoli,2021-10-23,Jamie Pickett,Decision - Unanimous,0,0,0,0
Laureano Staropoli,2020-08-08,Tim Means,Decision - Unanimous,0,0,0,0
Laureano Staropoli,2018-11-17,Hector Aldana,Decision - Unanimous,80,28,0,108
Laureano Staropoli,2019-05-11,Thiago Alves,Decision - Unanimous,80,0,0,80
Aaron Jeffery,2021-09-28,Caio Borralho,Decision - Unanimous,0,0,0,0
Aaron Jeffery,2019-07-16,Brendan Allen,Submission,0,7,0,7
Joe Pearson,2006-11-05,Yoshiro Maeda,Submission,90,1,0,91
Joe Pearson,2007-01-20,Urijah Faber,KO/TKO,0,0,25,25
Tadao Yasuda,2001-03-25,Masaaki Satake,Decision - Split,70,37,0,107
Jae Suk Lim,2008-03-29,Drew Fickett,Submission,0,0,0,0
John Doyle,2008-02-16,Rafael Cavalcante,KO/TKO,0,0,0,0
Joshua Wang-Kim,2022-08-23,Cameron Saaiman,KO/TKO,0,0,0,0
Hans Nijman,2000-01-30,Kazuyuki Fujita,Submission,0,0,0,0
Albert Duraev,2021-09-14,Caio Bittencourt,Submission,90,1,0,91
Albert Duraev,2021-10-30,Roman Kopylov,Decision - Unanimous,80,29,0,109
Albert Duraev,2023-07-15,JunYong Park,Submission,0,0,0,0
Albert Duraev,2023-03-25,Chidi Njokuani,Decision - Split,70,5,0,75
Albert Duraev,2022-06-18,Joaquin Buckley,TKO - Doctor's Stoppage,0,0,0,0
Caio Bittencourt,2021-09-14,Albert Duraev,Submission,0,0,0,0
Kyle Noke,2016-07-13,Keita Nakamura,Submission,0,3,0,3
Kyle Noke,2012-03-02,Andrew Craig,Decision - Unanimous,0,0,0,0
Kyle Noke,2012-09-22,Charlie Brenneman,KO/TKO,100,7,0,107
Kyle Noke,2015-11-14,Peter Sobotta,KO/TKO,100,21,0,121
Kyle Noke,2011-02-26,Chris Camozzi,Submission,90,0,0,90
Kyle Noke,2007-11-10,Seth Kleinbeck,TKO - Doctor's Stoppage,0,9,0,9
Kyle Noke,2016-01-02,Alex Morono,Decision - Split,0,16,0,16
Kyle Noke,2016-11-26,Omari Akhmedov,Decision - Unanimous,0,0,0,0
Kyle Noke,2015-05-09,Jonavin Webb,Decision - Split,70,8,0,78
Kyle Noke,2010-06-19,Josh Bryant,KO/TKO,100,41,0,141
Kyle Noke,2011-08-14,Ed Herman,Submission,0,10,0,10
Kyle Noke,2014-04-16,Patrick Cote,Decision - Unanimous,0,17,0,17
Kyle Noke,2010-11-13,Rob Kimmons,Submission,90,9,0,99
Lewis Gonzalez,2015-06-27,Leandro Silva,Decision - Unanimous,0,0,0,0
Muhsin Corbbrey,2009-12-19,Zachary Micklewright,Decision - Unanimous,0,0,0,0
Muhsin Corbbrey,2008-06-14,Nick Diaz,KO/TKO,0,0,0,0
Muhsin Corbbrey,2009-10-10,Anthony Njokuani,KO/TKO,0,0,0,0
James Llontop,2024-08-24,Viacheslav Borshchev,Decision - Split,0,0,0,0
James Llontop,2023-09-12,Malik Lewis,Decision - Unanimous,80,45,0,125
James Llontop,2024-11-16,Mauricio Ruffy,Decision - Unanimous,0,23,0,23
James Llontop,2024-04-27,Chris Padilla,Submission,0,7,0,7
Carlos Felipe,2020-10-03,Yorgan De Castro,Decision - Unanimous,80,30,0,110
Carlos Felipe,2021-06-12,Jake Collier,Decision - Split,70,0,0,70
Carlos Felipe,2021-10-16,Andrei Arlovski,Decision - Unanimous,0,0,0,0
Carlos Felipe,2020-07-18,Serghei Spivac,Decision - Majority,0,0,0,0
Carlos Felipe,2021-01-16,Justin Tafa,Decision - Split,70,0,0,70
Jonathan Wiezorek,2004-04-02,Wade Shipp,KO/TKO,100,0,0,100
Jonathan Wiezorek,2007-11-10,Antonio Silva,Submission,0,0,0,0
Wade Shipp,2004-04-02,Jonathan Wiezorek,KO/TKO,0,10,0,10
Yoshihiro Takayama,2001-12-23,Semmy Schilt,KO/TKO,0,0,0,0
Yoshihiro Takayama,2001-05-27,Kazuyuki Fujita,Submission,0,0,0,0
Yoshihiro Takayama,2002-06-23,Don Frye,KO/TKO,0,0,0,0
Ray Routh,2006-03-10,Crafton Wallace,KO/TKO,0,0,0,0
Louis Taylor,2010-08-13,Joe Riggs,KO/TKO,0,10,0,10
Ryan McGillivray,2011-06-04,Shamar Bailey,Decision - Unanimous,0,0,0,0
Steven Peterson,2023-03-25,Lucas Alexander,Decision - Unanimous,0,0,0,0
Steven Peterson,2018-02-18,Brandon Davis,Decision - Unanimous,0,0,0,0
Steven Peterson,2019-07-20,Alex Caceres,Decision - Unanimous,0,0,0,0
Steven Peterson,2021-06-12,Chase Hooper,Decision - Unanimous,80,18,0,98
Steven Peterson,2018-07-06,Matt Bessette,Decision - Split,70,17,0,87
Steven Peterson,2019-09-21,Martin Bravo,KO/TKO,100,0,0,100
Steven Peterson,2017-08-22,Benito Lopez,Decision - Split,0,5,0,5
Steven Peterson,2019-03-23,Luis Pena,Decision - Unanimous,0,0,0,0
Steven Peterson,2022-02-05,Julian Erosa,Decision - Split,0,0,0,0
Mauricio Ruffy,2024-05-04,Jamie Mullarkey,KO/TKO,100,11,0,111
Mauricio Ruffy,2023-10-03,Raimond Magomedaliev,KO/TKO,100,10,0,110
Mauricio Ruffy,2024-11-16,James Llontop,Decision - Unanimous,80,0,0,80
Eiji Ishikawa,2011-07-16,Marius Zaromskis,Decision - Unanimous,0,0,0,0
Drako Rodriguez,2021-02-20,Aiemann Zahabi,KO/TKO,0,2,0,2
Drako Rodriguez,2020-09-08,Mana Martinez,Submission,90,0,0,90
Drako Rodriguez,2021-08-07,Vince Morales,Decision - Unanimous,0,0,0,0
Mayana Kellem,2018-08-10,Mayra Bueno Silva,Submission,0,0,0,0
Cale Yarbrough,2008-07-19,Tim Credeur,KO/TKO,0,0,0,0
Malcolm Gordon,2020-07-18,Amir Albazi,Submission,0,0,0,0
Malcolm Gordon,2024-01-20,Jimmy Flick,Submission,0,34,0,34
Malcolm Gordon,2020-11-28,Sumudaerji,KO/TKO,0,0,0,0
Malcolm Gordon,2023-03-18,Jake Hadley,KO/TKO,0,0,0,0
Malcolm Gordon,2021-07-17,Francisco Figueiredo,Decision - Unanimous,80,18,0,98
Malcolm Gordon,2022-10-22,Muhammad Mokaev,Submission,0,0,0,0
Malcolm Gordon,2022-02-05,Denys Bondar,KO/TKO,100,0,0,100
Soichi Nishida,1999-04-29,Enson Inoue,Submission,0,0,0,0
Herman Renting,2000-10-31,Akira Shoji,Submission,0,0,0,0
Chris Birchler,2018-07-24,Jimmy Crute,KO/TKO,0,0,0,0
Jason Lambert,2008-06-07,Luiz Cane,KO/TKO,0,0,0,0
Jason Lambert,2006-06-28,Branden Lee Hinkle,KO/TKO,100,40,0,140
Jason Lambert,2007-03-03,Renato Sobral,KO/TKO,100,14,0,114
Jason Lambert,2006-09-23,Rashad Evans,KO/TKO,0,0,0,0
Jason Lambert,2008-09-06,Jason MacDonald,Submission,0,0,0,0
Jason Lambert,2006-03-04,Rob MacDonald,Submission,90,4,0,94
Jason Lambert,2006-04-15,Terry Martin,KO/TKO,100,16,0,116
Jason Lambert,2008-01-19,Wilson Gouveia,KO/TKO,0,22,0,22
Jared Hamman,2010-09-15,Kyle Kingsbury,Decision - Unanimous,0,9,0,9
Jared Hamman,2013-08-31,Magnus Cedenblad,Submission,0,0,0,0
Jared Hamman,2009-11-14,Alexander Gustafsson,KO/TKO,0,0,0,0
Jared Hamman,2012-08-11,Michael Kuiper,KO/TKO,0,5,0,5
Jared Hamman,2006-06-09,Scott Graham,KO/TKO,100,9,0,109
Jared Hamman,2011-12-10,Constantinos Philippou,KO/TKO,0,0,0,0
Jared Hamman,2011-08-14,CB Dollaway,KO/TKO,100,34,0,134
Jared Hamman,2010-03-27,Rodney Wallace,Decision - Unanimous,80,26,0,106
Motoki Miyazawa,2008-07-21,Kuniyoshi Hironaka,TKO - Doctor's Stoppage,0,0,0,0
Shannon Ross,2022-08-02,Vinicius Salvador,KO/TKO,0,0,0,0
Shannon Ross,2023-07-08,Jesus Aguilar,KO/TKO,0,0,0,0
Shannon Ross,2023-12-09,HyunSung Park,KO/TKO,0,0,0,0
Shannon Ross,2023-02-11,Kleydson Rodrigues,KO/TKO,0,0,0,0
Ashkan Mokhtarian,2017-11-18,Ryan Benoit,KO/TKO,0,0,0,0
Ashkan Mokhtarian,2017-06-10,John Moraga,Decision - Unanimous,0,0,0,0
Yosdenis Cedeno,2015-07-11,Cody Pfister,Decision - Unanimous,0,11,0,11
Yosdenis Cedeno,2014-07-16,Jerrod Sanders,TKO - Doctor's Stoppage,0,11,0,11
Yosdenis Cedeno,2014-02-22,Ernest Chavez,Decision - Split,0,0,0,0
Yosdenis Cedeno,2014-10-04,Chad Laprise,Decision - Unanimous,0,0,0,0
Bruno Assis,2018-08-11,Andre Muniz,Decision - Unanimous,0,0,0,0
Issa Isakov,2023-10-10,MarQuel Mederos,KO/TKO,0,0,0,0
Mark Hughes,2000-11-17,Alex Stiebling,Decision - Unanimous,80,5,0,85
Muhammad Naimov,2023-10-21,Nathaniel Wood,Decision - Unanimous,80,0,0,80
Muhammad Naimov,2023-06-03,Jamie Mullarkey,KO/TKO,100,0,0,100
Muhammad Naimov,2024-06-22,Felipe Lima,Submission,0,0,0,0
Muhammad Naimov,2020-09-15,Collin Anglin,Decision - Unanimous,0,0,0,0
Muhammad Naimov,2024-02-24,Erik Silva,KO/TKO,100,1,0,101
Hong Man Choi,2009-05-26,Jose Canseco,KO/TKO,100,5,0,105
Hong Man Choi,2008-12-31,Mirko Filipovic,KO/TKO,0,0,0,0
Hong Man Choi,2009-10-06,Ikuhisa Minowa,Submission,0,0,0,0
Hong Man Choi,2007-12-31,Fedor Emelianenko,Submission,0,3,0,3
Jose Canseco,2009-05-26,Hong Man Choi,KO/TKO,0,0,0,0
Josh Samman,2015-07-12,Caio Magalhaes,Submission,90,9,0,99
Josh Samman,2014-12-06,Eddie Gordon,KO/TKO,100,3,0,103
Josh Samman,2015-12-19,Tamdan McCrory,Submission,0,0,0,0
Josh Samman,2013-04-13,Kevin Casey,KO/TKO,100,22,0,122
Josh Samman,2016-07-13,Tim Boetsch,KO/TKO,0,0,0,0
Matt Ricehouse,2011-06-24,Ryan Couture,Decision - Unanimous,80,0,0,80
Matt Ricehouse,2012-08-18,Bobby Green,Decision - Unanimous,0,0,0,0
Shimon Smotritsky,2021-10-05,Mike Malott,Submission,0,0,0,0
Shimon Smotritsky,2022-08-02,Billy Ray Goff,KO/TKO,0,0,0,0
Andrews Nakahara,2009-04-05,Shungo Oyama,KO/TKO,100,12,0,112
Andrews Nakahara,2010-03-22,Ryo Chonan,Decision - Unanimous,0,0,0,0
Andrews Nakahara,2008-04-29,Kazushi Sakuraba,Submission,0,7,0,7
Andrews Nakahara,2008-09-23,Dong Sik Yoon,KO/TKO,100,26,0,126
Andrew Holbrook,2017-09-02,Thibault Gouti,KO/TKO,0,0,0,0
Andrew Holbrook,2017-04-08,Gregor Gillespie,KO/TKO,0,0,0,0
Andrew Holbrook,2016-07-08,Joaquim Silva,KO/TKO,0,0,0,0
Andrew Holbrook,2015-07-25,Ramsey Nijem,Decision - Split,70,0,0,70
Andrew Holbrook,2016-11-26,Jake Matthews,Decision - Split,70,8,0,78
Yasuhiro Urushitani,2012-11-10,John Lineker,Decision - Unanimous,0,0,0,0
Yasuhiro Urushitani,2012-03-02,Joseph Benavidez,KO/TKO,0,0,0,0
Kevin Syler,2019-07-16,Lance Lawrence,Decision - Unanimous,80,59,0,139
Kevin Syler,2020-08-18,Ken Cross,Decision - Unanimous,0,0,0,0
Lance Lawrence,2019-07-16,Kevin Syler,Decision - Unanimous,0,0,0,0
Philip De Fries,2011-11-05,Rob Broughton,Decision - Unanimous,80,0,0,80
Philip De Fries,2013-04-06,Matt Mitrione,KO/TKO,0,0,0,0
Philip De Fries,2012-12-29,Todd Duffee,KO/TKO,0,0,0,0
Philip De Fries,2012-02-15,Stipe Miocic,KO/TKO,0,0,0,0
Philip De Fries,2012-08-04,Oli Thompson,Submission,90,17,0,107
Rob Broughton,2011-11-05,Philip De Fries,Decision - Unanimous,0,15,0,15
Rob Broughton,2010-10-16,Vinicius Queiroz,Submission,90,20,0,110
Rob Broughton,2011-09-24,Travis Browne,Decision - Unanimous,0,0,0,0
Jeff Hughes,2019-03-09,Maurice Greene,Decision - Split,0,0,0,0
Jeff Hughes,2018-07-24,Josh Appelt,KO/TKO,100,45,0,145
Jeff Hughes,2020-09-26,Juan Espino,Submission,0,0,0,0
Jeff Hughes,2019-10-26,Raphael Pessoa,Decision - Unanimous,0,0,0,0
Yuki Kondo,2005-04-23,Igor Vovchanchyn,Decision - Unanimous,0,0,0,0
Yuki Kondo,2000-09-22,Alexandre Dantas,KO/TKO,100,19,0,119
Yuki Kondo,2005-12-31,Kazuhiro Nakamura,Decision - Unanimous,0,0,0,0
Yuki Kondo,2001-06-29,Vladimir Matyushenko,Decision - Unanimous,0,0,0,0
Yuki Kondo,2006-12-31,Akihiro Gono,Decision - Split,0,0,0,0
Yuki Kondo,2004-08-15,Wanderlei Silva,KO/TKO,0,0,0,0
Yuki Kondo,2003-12-31,Mario Sperry,TKO - Doctor's Stoppage,0,2,0,2
Yuki Kondo,2004-12-31,Dan Henderson,Decision - Split,0,0,0,0
Yuki Kondo,2000-12-16,Tito Ortiz,Submission,0,0,25,25
Yuki Kondo,2006-04-02,Phil Baroni,KO/TKO,0,0,0,0
James Gray,2017-08-01,Kyler Phillips,KO/TKO,0,0,0,0
Leonardo Silva de Oliveira,2018-08-11,Marcio Alexandre Junior,Submission,0,1,0,1
Ian Murphy,2008-04-29,Jacare Souza,Submission,0,0,0,0
Fred Ettish,1994-03-11,Johnny Rhodes,Submission,0,0,0,0
Jack Cartwright,2022-08-16,Jose Johnson,Decision - Unanimous,0,0,0,0
Saparbeg Safarov,2018-02-10,Tyson Pedro,Submission,0,0,0,0
Saparbeg Safarov,2020-03-07,Rodolfo Vieira,Submission,0,0,0,0
Saparbeg Safarov,2019-03-16,Nicolae Negumereanu,Decision - Unanimous,80,59,0,139
Saparbeg Safarov,2016-12-09,Gian Villante,KO/TKO,0,0,0,0
Kengo Watanabe,2003-05-02,Lyoto Machida,Decision - Unanimous,0,0,0,0
Jamie Colleen,2017-08-15,Tiffany Masters,Submission,90,0,0,90
Jamie Colleen,2018-07-17,Maycee Barber,KO/TKO,0,0,0,0
Tiffany Masters,2017-08-15,Jamie Colleen,Submission,0,14,0,14
Josh Shockley,2015-02-22,Ivan Jorge,Decision - Unanimous,0,0,0,0
Josh Shockley,2014-06-14,Jason Saggo,KO/TKO,0,0,0,0
Raimond Magomedaliev,2023-10-03,Mauricio Ruffy,KO/TKO,0,0,0,0
Kalib Starnes,2008-04-19,Nate Quarry,Decision - Unanimous,0,0,0,0
Kalib Starnes,2006-10-14,Yushin Okami,KO/TKO,0,0,0,0
Kalib Starnes,2007-05-26,Chris Leben,Decision - Unanimous,80,3,0,83
Kalib Starnes,2007-10-20,Alan Belcher,TKO - Doctor's Stoppage,0,0,0,0
Kalib Starnes,2006-06-24,Danny Abbadi,Submission,90,18,0,108
Rickson Zenidim,2023-10-10,Andre Lima,Decision - Unanimous,0,0,0,0
Alan Belcher,2007-05-26,Sean Salmon,Submission,90,0,0,90
Alan Belcher,2011-09-17,Jason MacDonald,KO/TKO,100,23,0,123
Alan Belcher,2008-04-19,Jason Day,KO/TKO,0,0,0,0
Alan Belcher,2009-12-12,Wilson Gouveia,KO/TKO,100,0,0,100
Alan Belcher,2006-12-13,Jorge Santiago,KO/TKO,100,15,0,115
Alan Belcher,2012-05-05,Rousimar Palhares,KO/TKO,100,20,0,120
Alan Belcher,2006-08-26,Yushin Okami,Decision - Unanimous,0,0,0,0
Alan Belcher,2009-01-17,Denis Kang,Submission,90,0,0,90
Alan Belcher,2010-05-08,Patrick Cote,Submission,90,5,0,95
Alan Belcher,2007-10-20,Kalib Starnes,TKO - Doctor's Stoppage,0,17,0,17
Alan Belcher,2008-09-17,Ed Herman,Decision - Split,70,11,0,81
Alan Belcher,2007-04-07,Kendall Grove,Submission,0,0,0,0
Alan Belcher,2012-12-29,Yushin Okami,Decision - Unanimous,0,0,0,0
Alan Belcher,2013-04-27,Michael Bisping,Decision - Unanimous,0,0,0,0
Alan Belcher,2009-07-11,Yoshihiro Akiyama,Decision - Split,0,21,0,21
Anton Kuivanen,2012-07-21,Mitch Clarke,Decision - Split,70,23,0,93
Anton Kuivanen,2012-02-15,Justin Salas,Decision - Unanimous,0,0,0,0
Anton Kuivanen,2013-02-23,Michael Chiesa,Submission,0,13,0,13
Augusto Mendes,2017-01-15,Frankie Saenz,Decision - Split,70,2,0,72
Augusto Mendes,2017-04-15,Aljamain Sterling,Decision - Unanimous,0,0,0,0
Augusto Mendes,2016-02-21,Cody Garbrandt,KO/TKO,0,0,0,0
Jose Aldo,2019-12-14,Marlon Moraes,Decision - Split,0,0,0,0
Jose Aldo,2024-05-04,Jonathan Martinez,Decision - Unanimous,80,25,0,105
Jose Aldo,2015-12-12,Conor McGregor,KO/TKO,0,0,25,25
Jose Aldo,2014-02-01,Ricardo Lamas,Decision - Unanimous,80,21,25,126
Jose Aldo,2017-06-03,Max Holloway,KO/TKO,0,0,25,25
Jose Aldo,2012-01-14,Chad Mendes,KO/TKO,100,0,25,125
Jose Aldo,2021-08-07,Pedro Munhoz,Decision - Unanimous,80,39,0,119
Jose Aldo,2009-03-01,Chris Mickle,KO/TKO,100,11,0,111
Jose Aldo,2016-07-09,Frankie Edgar,Decision - Unanimous,80,1,25,106
Jose Aldo,2019-05-11,Alexander Volkanovski,Decision - Unanimous,0,0,0,0
Jose Aldo,2013-08-03,Chan Sung Jung,KO/TKO,100,15,25,140
Jose Aldo,2014-10-25,Chad Mendes,Decision - Unanimous,80,25,25,130
Jose Aldo,2018-07-28,Jeremy Stephens,KO/TKO,100,9,0,109
Jose Aldo,2009-06-07,Cub Swanson,KO/TKO,100,2,0,102
Jose Aldo,2009-11-18,Mike Brown,KO/TKO,100,20,25,145
Jose Aldo,2008-11-05,Jonathan Brookins,KO/TKO,100,23,0,123
Jose Aldo,2024-10-05,Mario Bautista,Decision - Split,0,2,0,2
Jose Aldo,2009-01-25,Rolando Perez,KO/TKO,100,14,0,114
Jose Aldo,2021-12-04,Rob Font,Decision - Unanimous,80,0,25,105
Jose Aldo,2019-02-02,Renato Moicano,KO/TKO,100,2,0,102
Jose Aldo,2022-08-20,Merab Dvalishvili,Decision - Unanimous,0,0,0,0
Jose Aldo,2017-12-02,Max Holloway,KO/TKO,0,0,25,25
Jose Aldo,2011-10-08,Kenny Florian,Decision - Unanimous,80,11,25,116
Jose Aldo,2013-02-02,Frankie Edgar,Decision - Unanimous,80,16,25,121
Jose Aldo,2010-09-30,Manvel Gamburyan,KO/TKO,100,17,25,142
Jose Aldo,2010-04-24,Urijah Faber,Decision - Unanimous,80,57,25,162
Jose Aldo,2011-04-30,Mark Hominick,Decision - Unanimous,80,23,25,128
Jose Aldo,2020-07-11,Petr Yan,KO/TKO,0,0,25,25
Jose Aldo,2008-06-01,Alexandre Franca Nogueira,KO/TKO,100,30,0,130
Jose Aldo,2020-12-19,Marlon Vera,Decision - Unanimous,80,0,0,80
Jakob Lovstad,2005-10-01,Michael Bisping,KO/TKO,0,0,25,25
Chris Haseman,2002-07-13,Evan Tanner,Decision - Unanimous,0,0,0,0
Dakota Bush,2022-01-15,Viacheslav Borshchev,KO/TKO,0,0,0,0
Dakota Bush,2021-04-17,Austin Hubbard,Decision - Unanimous,0,0,0,0
Jeff Molina,2021-04-24,Aoriqileng,Decision - Unanimous,80,73,0,153
Jeff Molina,2021-10-23,Daniel Lacerda,KO/TKO,100,27,0,127
Jeff Molina,2022-06-04,Zhalgas Zhumagulov,Decision - Split,70,19,0,89
Jeff Molina,2020-08-25,Jacob Silva,Decision - Unanimous,80,0,0,80
Michael Lombardo,2019-06-25,Kyle Daukaus,Decision - Unanimous,0,0,0,0
Michael Lombardo,2020-09-15,Korey Kuppe,Decision - Unanimous,80,9,0,89
Duda Santana,2019-06-01,Bea Malecki,Submission,0,23,0,23
Wes Sims,2003-06-06,Frank Mir,DQ,0,0,0,0
Wes Sims,2010-01-30,Bobby Lashley,KO/TKO,0,0,0,0
Wes Sims,2004-01-31,Frank Mir,KO/TKO,0,0,0,0
Wes Sims,2004-04-02,Mike Kyle,KO/TKO,0,0,0,0
Solomon Renfro,2021-10-19,Jonny Parsons,Decision - Split,0,25,0,25
David Michaud,2014-05-24,Li Jingliang,Decision - Split,0,0,0,0
David Michaud,2014-12-13,Garett Whiteley,Decision - Unanimous,80,2,0,82
David Michaud,2015-04-25,Olivier Aubin-Mercier,Submission,0,0,0,0
Miranda Granger,2022-08-06,Cory McKenna,Submission,0,0,0,0
Miranda Granger,2019-08-03,Hannah Goldy,Decision - Unanimous,80,6,0,86
Miranda Granger,2019-12-21,Amanda Lemos,Submission,0,0,0,0
Miranda Granger,2020-11-14,Ashley Yoder,Decision - Unanimous,0,7,0,7
Ottman Azaitar,2023-07-15,Francisco Prado,KO/TKO,0,0,0,0
Ottman Azaitar,2024-12-14,Michael Johnson,KO/TKO,0,0,0,0
Ottman Azaitar,2022-11-12,Matt Frevola,KO/TKO,0,0,0,0
Ottman Azaitar,2019-09-07,Teemu Packalen,KO/TKO,100,19,0,119
Ottman Azaitar,2020-09-12,Khama Worthy,KO/TKO,100,15,0,115
Kenji Osawa,2011-05-29,Takafumi Otsuka,Decision - Split,70,21,0,91
Kenji Osawa,2011-05-29,Masakazu Imanari,Submission,0,5,0,5
Kenji Osawa,2011-07-16,Keisuke Fujiwara,Decision - Unanimous,80,3,0,83
Kenji Osawa,2010-05-29,Yoshiro Maeda,Decision - Split,70,14,0,84
Kenji Osawa,2009-11-18,Antonio Banuelos,Decision - Unanimous,0,21,0,21
Kenji Osawa,2009-03-01,Rafael Rebello,Decision - Split,70,0,0,70
Kenji Osawa,2008-08-03,Scott Jorgensen,Decision - Unanimous,0,0,0,0
Masanori Kanehara,2014-09-20,Alex Caceres,Decision - Unanimous,80,8,0,88
Masanori Kanehara,2016-01-02,Michael McDonald,Submission,0,10,0,10
Masanori Kanehara,2009-12-31,Norifumi Yamamoto,Decision - Unanimous,80,0,0,80
Masanori Kanehara,2015-07-15,Rani Yahya,Decision - Split,0,0,0,0
David Branch,2018-11-03,Jared Cannonier,KO/TKO,0,0,0,0
David Branch,2019-03-30,Jack Hermansson,Submission,0,0,0,0
David Branch,2018-04-21,Thiago Santos,KO/TKO,100,0,0,100
David Branch,2010-07-03,Gerald Harris,KO/TKO,0,10,0,10
David Branch,2010-12-04,Rich Attonito,Decision - Unanimous,80,10,0,90
David Branch,2017-05-13,Krzysztof Jotko,Decision - Split,70,11,0,81
David Branch,2010-09-15,Tomasz Drwal,Decision - Unanimous,80,5,0,85
David Branch,2017-09-16,Luke Rockhold,KO/TKO,0,0,25,25
David Branch,2011-03-03,Rousimar Palhares,Submission,0,4,0,4
Melquizael Costa,2023-07-15,Austin Lingo,Decision - Unanimous,80,61,0,141
Melquizael Costa,2024-06-15,Shayilan Nuerdanbieke,Submission,90,10,0,100
Melquizael Costa,2023-01-21,Thiago Moises,Submission,0,1,0,1
Melquizael Costa,2023-12-09,Steve Garcia,KO/TKO,0,0,0,0
Dino Pezao,2006-11-09,Thiago Silva,KO/TKO,0,0,0,0
Josh Haynes,2006-06-24,Michael Bisping,KO/TKO,0,0,0,0
Josh Haynes,2006-10-10,Rory Singer,Decision - Unanimous,0,0,0,0
Josh Haynes,2007-04-07,Luke Cummo,KO/TKO,0,0,0,0
Michinori Tanaka,2016-01-02,Joe Soto,Decision - Split,70,0,0,70
Michinori Tanaka,2014-09-20,Kyung Ho Kang,Decision - Split,0,1,0,1
Michinori Tanaka,2017-02-04,Ricardo Ramos,Decision - Unanimous,0,0,0,0
Michinori Tanaka,2014-06-14,Roland Delorme,Decision - Unanimous,80,19,0,99
Michinori Tanaka,2016-09-24,Rani Yahya,Decision - Unanimous,0,10,0,10
Gloria de Paula,2021-07-31,Cheyanne Vlismas,KO/TKO,0,0,0,0
Gloria de Paula,2021-03-13,Jinh Yu Frey,Decision - Unanimous,0,7,0,7
Gloria de Paula,2022-06-18,Maria Oliveira,Decision - Split,0,9,0,9
Gloria de Paula,2022-02-19,Diana Belbita,Decision - Unanimous,80,1,0,81
Gloria de Paula,2020-11-17,Pauline Macias,Decision - Unanimous,80,57,0,137
Soa Palelei,2013-08-31,Nikita Krylov,KO/TKO,100,0,0,100
Soa Palelei,2015-08-01,Antonio Silva,KO/TKO,0,3,0,3
Soa Palelei,2014-06-28,Jared Rosholt,Decision - Unanimous,0,0,0,0
Soa Palelei,2007-12-29,Eddie Sanchez,KO/TKO,0,0,0,0
Soa Palelei,2014-05-10,Ruan Potts,KO/TKO,100,5,0,105
Soa Palelei,2013-12-06,Pat Barry,KO/TKO,100,11,0,111
Soa Palelei,2014-11-07,Walt Harris,KO/TKO,100,2,0,102
Soa Palelei,2004-10-31,Mu Bae Choi,Submission,0,42,0,42
Alex Soto,2012-05-15,Francisco Rivera,Decision - Unanimous,0,0,0,0
Alex Soto,2011-11-19,Michael McDonald,KO/TKO,0,0,0,0
Jared Papazian,2012-12-15,Tim Elliott,Decision - Unanimous,0,0,0,0
Jared Papazian,2012-01-20,Mike Easton,Decision - Majority,0,0,0,0
Jared Papazian,2012-06-08,Dustin Pague,Submission,0,1,0,1
Jacob Silva,2020-11-17,JP Buys,Submission,0,0,0,0
Jacob Silva,2020-08-25,Jeff Molina,Decision - Unanimous,0,7,0,7
Mostapha Al-Turk,2008-12-27,Cheick Kongo,KO/TKO,0,0,0,0
Mostapha Al-Turk,2009-06-13,Mirko Filipovic,KO/TKO,0,0,0,0
Mostapha Al-Turk,2010-04-10,Jon Madsen,Decision - Unanimous,0,0,0,0
Cheyden Leialoha,2017-08-01,John Castaneda,Decision - Unanimous,0,0,0,0
Trenell Young,2008-07-19,Mark Hominick,Submission,0,0,0,0
Trenell Young,2006-01-13,Chris Lytle,KO/TKO,0,0,0,0
Imani Lee,2010-05-29,Ikuhisa Minowa,Submission,0,0,0,0
Gadzhimurad Antigulov,2020-10-17,Maxim Grishin,KO/TKO,0,0,0,0
Gadzhimurad Antigulov,2016-11-19,Marcos Rogerio de Lima,Submission,90,0,0,90
Gadzhimurad Antigulov,2018-07-28,Ion Cutelaba,KO/TKO,0,0,0,0
Gadzhimurad Antigulov,2020-07-25,Paul Craig,Submission,0,9,0,9
Gadzhimurad Antigulov,2019-04-20,Michal Oleksiejczuk,KO/TKO,0,0,0,0
Gadzhimurad Antigulov,2017-05-13,Joachim Christensen,Submission,90,1,0,91
Rachael Ostovich,2018-07-06,Montana De La Rosa,Submission,0,0,0,0
Rachael Ostovich,2017-12-01,Karine Gevorgyan,Submission,90,1,0,91
Rachael Ostovich,2019-01-19,Paige VanZant,Submission,0,0,0,0
Rachael Ostovich,2020-11-28,Gina Mazany,KO/TKO,0,0,0,0
Moise Rimbon,2008-11-01,Rogerio Nogueira,Decision - Unanimous,0,0,0,0
Edson Silva,2003-12-18,Forrest Griffin,KO/TKO,0,0,0,0
Victor Rodriguez,2021-05-22,Bruno Silva,KO/TKO,0,0,0,0
Victor Rodriguez,2020-10-31,Adrian Yanez,KO/TKO,0,0,0,0
Yoshiyuki Yoshida,2008-05-24,War Machine,Submission,90,0,0,90
Yoshiyuki Yoshida,2009-10-24,Anthony Johnson,KO/TKO,0,0,0,0
Yoshiyuki Yoshida,2009-05-23,Brandon Wolff,Submission,90,2,0,92
Yoshiyuki Yoshida,2010-05-08,Mike Guymon,Decision - Unanimous,0,0,0,0
Yoshiyuki Yoshida,2008-12-10,Josh Koscheck,KO/TKO,0,0,0,0
Ryan Thomas,2008-11-15,Matt Brown,Submission,0,0,0,0
Ryan Thomas,2008-08-09,Ben Saunders,Submission,0,0,0,0
Edwin DeWees,2006-11-11,Jorge Rivera,KO/TKO,0,0,0,0
Edwin DeWees,2008-07-19,Rogerio Nogueira,KO/TKO,0,0,0,0
Edwin DeWees,2003-09-26,Rich Franklin,KO/TKO,0,0,0,0
Edwin DeWees,2005-10-03,Chris Leben,Submission,0,0,0,0
Steve Lopez,2010-09-25,Waylon Lowe,Decision - Split,0,0,0,0
Steve Lopez,2009-09-19,Jim Miller,KO/TKO,0,0,0,0
Dominic Waters,2015-07-12,George Sullivan,Decision - Unanimous,0,0,0,0
Dominic Waters,2015-11-28,Dong Hyun Kim,KO/TKO,0,0,0,0
Dominic Waters,2016-05-08,Leon Edwards,Decision - Unanimous,0,0,0,0
Jaime Jara,2004-06-03,Rashad Evans,Decision - Unanimous,0,11,0,11
Daisuke Sugie,2005-07-17,Josh Thomson,Submission,0,0,0,0
Carlo Prater,2012-01-14,Erick Silva,DQ,0,0,0,0
Carlo Prater,2008-08-03,Brock Larson,KO/TKO,0,0,0,0
Carlo Prater,2008-02-13,Carlos Condit,Submission,0,0,25,25
Carlo Prater,2012-10-05,Marcus LeVesseur,Decision - Split,0,0,0,0
Carlo Prater,2012-05-15,TJ Grant,Decision - Unanimous,0,0,0,0
Dustin Neace,2011-12-03,Bryan Caraway,Submission,0,0,0,0
Herschel Walker,2011-01-29,Scott Carson,KO/TKO,100,18,0,118
Herschel Walker,2010-01-30,Greg Nagy,KO/TKO,100,28,0,128
Scott Carson,2011-01-29,Herschel Walker,KO/TKO,0,0,0,0
Karl Amoussou,2010-07-10,Kazuhiro Nakamura,Decision - Unanimous,0,0,0,0
Phil Harris,2014-07-19,Neil Seery,Decision - Unanimous,0,0,0,0
Phil Harris,2013-10-26,John Lineker,KO/TKO,0,0,0,0
Phil Harris,2013-02-16,Ulysses Gomez,Decision - Unanimous,80,0,0,80
Phil Harris,2012-10-05,Darren Uyenoyama,Submission,0,3,0,3
Stanislav Nedkov,2015-01-24,Nikita Krylov,Submission,0,0,0,0
Stanislav Nedkov,2011-08-27,Luiz Cane,KO/TKO,100,14,0,114
Stanislav Nedkov,2013-02-16,Tom Watson,KO/TKO,0,0,0,0
Cody Haddon,2024-10-12,Dan Argueta,Decision - Unanimous,80,86,0,166
Dan Argueta,2024-10-12,Cody Haddon,Decision - Unanimous,0,0,0,0
Dan Argueta,2023-01-14,Nick Aguirre,Decision - Unanimous,80,33,0,113
Dan Argueta,2024-04-06,Jean Matsumoto,Submission,0,0,0,0
Dan Argueta,2022-06-04,Damon Jackson,Decision - Unanimous,0,0,0,0
Abner Lloveras,2015-12-11,Chris Gruetzemacher,Decision - Unanimous,0,0,0,0
Nick Penner,2012-03-02,Anthony Perosh,KO/TKO,0,0,0,0
Nick Penner,2012-12-14,Cody Donovan,KO/TKO,0,0,0,0
Frankie Perez,2017-07-22,Chris Wade,Decision - Unanimous,0,0,0,0
Frankie Perez,2016-12-09,Marc Diakiese,Decision - Unanimous,0,11,0,11
Frankie Perez,2015-01-18,Johnny Case,KO/TKO,0,0,0,0
Frankie Perez,2015-08-23,Sam Stout,KO/TKO,100,10,0,110
Puja Tomar,2024-06-08,Rayanne dos Santos,Decision - Split,70,11,0,81
Myktybek Orolbai,2023-11-18,Uros Medic,Submission,90,0,0,90
Myktybek Orolbai,2024-10-26,Mateusz Rebecki,Decision - Split,0,0,0,0
Myktybek Orolbai,2024-05-04,Elves Brener,Decision - Unanimous,80,17,0,97
Irwin Rivera,2020-05-16,Giga Chikadze,Decision - Unanimous,0,0,0,0
Irwin Rivera,2020-08-08,Ali AlQaisi,Decision - Split,70,0,0,70
Irwin Rivera,2020-09-19,Andre Ewell,Decision - Split,0,0,0,0
Charles Bennett,2005-05-22,Yoshiro Maeda,KO/TKO,100,7,0,107
Charles Bennett,2004-10-14,Takanori Gomi,Submission,0,0,0,0
Charles Bennett,2007-02-10,KJ Noons,KO/TKO,100,1,0,101
Charles Bennett,2005-12-31,Ken Kaneko,Submission,90,4,0,94
Charles Bennett,2006-06-04,Tatsuya Kawajiri,Submission,0,2,0,2
Charles Bennett,2005-09-25,Dokonjonosuke Mishima,Submission,0,0,0,0
Kayla Harrison,2024-04-13,Holly Holm,Submission,90,49,0,139
Kayla Harrison,2024-10-05,Ketlen Vieira,Decision - Unanimous,80,31,0,111
Emily Ducote,2022-07-16,Jessica Penne,Decision - Unanimous,80,53,0,133
Emily Ducote,2023-05-20,Loopy Godinez,Decision - Unanimous,0,0,0,0
Emily Ducote,2023-10-14,Ashley Yoder,Decision - Unanimous,80,15,0,95
Emily Ducote,2022-12-03,Angela Hill,Decision - Unanimous,0,0,0,0
Emily Ducote,2024-05-18,Vanessa Demopoulos,Decision - Split,0,34,0,34
Stefan Leko,2004-12-31,Ikuhisa Minowa,Submission,0,4,0,4
Stefan Leko,2004-04-25,Naoya Ogawa,Submission,0,0,0,0
Stefan Leko,2005-02-20,Kazuhiro Nakamura,KO/TKO,0,0,0,0
Scott Norton,2007-03-24,Alex Serdyukov,Submission,0,2,0,2
Nicolle Caliari,2024-09-10,Corinne Laframboise,Submission,90,0,0,90
Corinne Laframboise,2024-09-10,Nicolle Caliari,Submission,0,6,0,6
Hector Aldana,2018-06-23,Song Kenan,KO/TKO,0,7,0,7
Hector Aldana,2018-11-17,Laureano Staropoli,Decision - Unanimous,0,0,0,0
Hector Aldana,2019-10-12,Miguel Baeza,KO/TKO,0,0,0,0
Josh Appelt,2018-07-24,Jeff Hughes,KO/TKO,0,0,0,0
Ross Pointon,2005-11-26,Michael Bisping,Submission,0,0,25,25
Ross Pointon,2006-06-24,Rory Singer,Submission,0,2,0,2
Ross Pointon,2007-01-25,Rich Clementi,Submission,0,0,0,0
Hans Stringer,2015-07-18,Ilir Latifi,KO/TKO,0,0,0,0
Hans Stringer,2014-03-23,Francimar Barroso,Decision - Split,70,8,0,78
Hans Stringer,2014-10-25,Fabio Maldonado,KO/TKO,0,5,0,5
Chris Dempsey,2015-08-08,Jonathan Wilson,KO/TKO,0,0,0,0
Chris Dempsey,2014-07-19,Ilir Latifi,KO/TKO,0,0,0,0
Chris Dempsey,2015-04-18,Eddie Gordon,Decision - Split,70,7,0,77
Chris Dempsey,2016-02-27,Scott Askham,KO/TKO,0,0,0,0
Gil Castillo,2002-11-22,Matt Hughes,TKO - Doctor's Stoppage,0,0,25,25
Gil Castillo,2002-01-11,Chris Brennan,Decision - Unanimous,80,9,0,89
Gil Castillo,2001-09-28,Dave Menne,Decision - Unanimous,0,0,25,25
Josh McDonald,2006-08-17,Patrick Murphy,Decision - Majority,75,0,0,75
Patrick Murphy,2006-08-17,Josh McDonald,Decision - Majority,0,39,0,39
Seo Hee Ham,2014-12-12,Joanne Wood,Decision - Unanimous,0,0,0,0
Seo Hee Ham,2016-03-19,Bec Rawlings,Decision - Unanimous,0,15,0,15
Seo Hee Ham,2016-11-26,Danielle Taylor,Decision - Split,0,0,0,0
Seo Hee Ham,2015-11-28,Cortney Casey,Decision - Unanimous,80,0,0,80
Julian Sanchez,1996-09-20,Mark Coleman,Submission,0,0,0,0
Jordan Radev,2007-12-29,Dean Lister,Decision - Unanimous,0,0,0,0
Jordan Radev,2007-06-12,Drew McFedries,KO/TKO,0,0,0,0
Jocelyn Jones-Lybarger,2016-06-18,Randa Markos,Decision - Unanimous,0,0,0,0
Jocelyn Jones-Lybarger,2017-01-15,Nina Nunes,Submission,0,0,0,0
Jocelyn Jones-Lybarger,2015-12-12,Tecia Pennington,Decision - Unanimous,0,0,0,0
Adrian Yanez,2021-03-20,Gustavo Lopez,KO/TKO,100,18,0,118
Adrian Yanez,2021-11-20,Davey Grant,Decision - Split,70,2,0,72
Adrian Yanez,2020-08-11,Brady Huang,KO/TKO,100,4,0,104
Adrian Yanez,2023-04-08,Rob Font,KO/TKO,0,0,0,0
Adrian Yanez,2024-05-18,Vinicius Salvador,KO/TKO,100,19,0,119
Adrian Yanez,2024-12-14,Daniel Marcos,Decision - Split,0,0,0,0
Adrian Yanez,2020-10-31,Victor Rodriguez,KO/TKO,100,11,0,111
Adrian Yanez,2021-07-24,Randy Costa,KO/TKO,100,0,0,100
Adrian Yanez,2022-06-18,Tony Kelley,KO/TKO,100,15,0,115
Adrian Yanez,2023-10-14,Jonathan Martinez,KO/TKO,0,0,0,0
Justin Ledet,2018-07-22,Aleksandar Rakic,Decision - Unanimous,0,0,0,0
Justin Ledet,2016-11-19,Mark Godbeer,Submission,90,0,0,90
Justin Ledet,2017-09-16,Azunna Anyanwu,Decision - Split,70,0,0,70
Justin Ledet,2020-10-31,Dustin Jacoby,KO/TKO,0,0,0,0
Justin Ledet,2020-01-18,Aleksa Camur,Decision - Unanimous,0,0,0,0
Justin Ledet,2019-02-02,Johnny Walker,KO/TKO,0,0,0,0
Justin Ledet,2016-08-06,Chase Sherman,Decision - Unanimous,80,54,0,134
Jamey Simmons,2021-08-07,Johnny Munoz,Submission,0,0,0,0
Jamey Simmons,2020-11-07,Giga Chikadze,KO/TKO,0,0,0,0
Abdul-Kerim Edilov,2017-09-02,Bojan Mihajlovic,KO/TKO,100,76,0,176
Bojan Mihajlovic,2017-09-02,Abdul-Kerim Edilov,KO/TKO,0,0,0,0
Bojan Mihajlovic,2017-01-15,Joachim Christensen,KO/TKO,0,0,0,0
Bojan Mihajlovic,2016-07-23,Francis Ngannou,KO/TKO,0,0,0,0
Igor Gracie,2011-02-12,John Salgado,Submission,90,7,0,97
John Salgado,2011-02-12,Igor Gracie,Submission,0,0,0,0
Mike Bencic,2003-06-08,Alistair Overeem,KO/TKO,0,0,0,0
Mike Bencic,2004-02-15,Mario Sperry,KO/TKO,0,0,0,0
Lucas Gamaza,2011-01-29,James Terry,KO/TKO,0,2,0,2
Eduardo Garagorri,2019-08-10,Humberto Bandenay,Decision - Unanimous,80,33,0,113
Eduardo Garagorri,2020-11-07,Darren Elkins,Submission,0,4,0,4
Eduardo Garagorri,2019-11-16,Ricardo Ramos,Submission,0,0,0,0
Humberto Bandenay,2019-08-10,Eduardo Garagorri,Decision - Unanimous,0,0,0,0
Humberto Bandenay,2018-11-17,Austin Arnett,Decision - Unanimous,0,0,0,0
Humberto Bandenay,2018-05-19,Gabriel Benitez,KO/TKO,0,0,0,0
Humberto Bandenay,2017-08-05,Martin Bravo,KO/TKO,100,4,0,104
Jose Landi-Jons,2002-02-24,Carlos Newton,Submission,0,2,0,2
Jose Landi-Jons,2001-05-27,Daijiro Matsui,Decision - Unanimous,0,4,0,4
Dashawn Boatwright,2018-06-12,Alonzo Menifield,KO/TKO,0,0,0,0
Jeremy Kimball,2017-06-25,Josh Stansbury,KO/TKO,100,13,0,113
Jeremy Kimball,2017-12-02,Dominick Reyes,Submission,0,0,0,0
Jeremy Kimball,2017-01-28,Marcos Rogerio de Lima,KO/TKO,0,0,0,0
Jeremy Kimball,2018-07-22,Darko Stosic,KO/TKO,0,0,0,0
Zhang Mingyang,2024-02-17,Brendson Ribeiro,KO/TKO,100,3,0,103
Zhang Mingyang,2022-06-09,Tuco Tokkos,KO/TKO,100,13,0,113
Zhang Mingyang,2024-11-23,Ozzy Diaz,KO/TKO,100,8,0,108
Brendson Ribeiro,2024-02-17,Zhang Mingyang,KO/TKO,0,0,0,0
Brendson Ribeiro,2024-11-02,Caio Machado,Decision - Split,70,0,0,70
Brendson Ribeiro,2023-09-05,Bruno Lopes,KO/TKO,100,12,0,112
Brendson Ribeiro,2024-06-22,Magomed Gadzhiyasulov,Decision - Majority,0,0,0,0
Nyamjargal Tumendemberel,2023-08-27,Peter Danesoe,Submission,90,17,0,107
Nyamjargal Tumendemberel,2024-11-23,Carlos Hernandez,Decision - Split,0,0,0,0
Nyamjargal Tumendemberel,2023-05-27,Top Noi Kiwram,Decision - Split,70,0,0,70
Joachim Christensen,2017-01-15,Bojan Mihajlovic,KO/TKO,100,19,0,119
Joachim Christensen,2017-06-25,Dominick Reyes,KO/TKO,0,0,0,0
Joachim Christensen,2016-10-01,Henrique da Silva,Submission,0,6,0,6
Joachim Christensen,2017-05-13,Gadzhimurad Antigulov,Submission,0,0,0,0
Ian Freeman,2000-09-22,Tedd Williams,Decision - Unanimous,80,5,0,85
Ian Freeman,2002-11-22,Andrei Arlovski,KO/TKO,0,0,0,0
Ian Freeman,2000-03-10,Scott Adams,Submission,0,0,0,0
Ian Freeman,2000-06-09,Nate Schroeder,KO/TKO,100,7,0,107
Ian Freeman,2002-07-13,Frank Mir,KO/TKO,100,28,0,128
Tedd Williams,2000-09-22,Ian Freeman,Decision - Unanimous,0,0,0,0
Tedd Williams,2000-03-10,Steve Judson,KO/TKO,100,0,0,100
Cameron Smotherman,2023-08-15,Charalampos Grigoriou,KO/TKO,0,0,0,0
Cameron Smotherman,2024-10-19,Jake Hadley,Decision - Unanimous,80,36,0,116
Chase Beebe,2007-09-05,Rani Yahya,Decision - Unanimous,80,34,25,139
Chase Beebe,2008-02-13,Miguel Torres,Submission,0,0,25,25
Chase Beebe,2007-03-24,Eddie Wineland,Decision - Unanimous,80,24,25,129
Chase Beebe,2008-06-01,Will Ribeiro,Decision - Split,0,0,0,0
Chase Beebe,2009-10-25,Yoshiro Maeda,Submission,0,0,0,0
Chase Beebe,2010-09-25,Hiroyuki Takaya,KO/TKO,0,0,0,0
Chase Beebe,2009-03-08,Joe Warren,TKO - Doctor's Stoppage,0,6,0,6
Justin Lawrence,2013-04-13,Daniel Pineda,Submission,0,0,0,0
Justin Lawrence,2012-06-01,John Cofer,KO/TKO,100,18,0,118
Justin Lawrence,2012-08-11,Max Holloway,KO/TKO,0,3,0,3
Dylan Andrews,2013-04-13,Jimmy Quinlan,KO/TKO,100,13,0,113
Dylan Andrews,2013-12-06,Clint Hester,TKO - Doctor's Stoppage,0,0,0,0
Dylan Andrews,2013-08-28,Papy Abedi,KO/TKO,100,1,0,101
Dylan Andrews,2014-11-07,Sam Alvey,KO/TKO,0,0,0,0
Dylan Andrews,2015-05-09,Brad Scott,Submission,0,0,0,0
Jimmy Quinlan,2013-04-13,Dylan Andrews,KO/TKO,0,0,0,0
JC Cottrell,2016-07-23,Michel Prazeres,Decision - Unanimous,0,0,0,0
JC Cottrell,2017-01-28,Jason Gonzalez,Submission,0,0,0,0
Mizuki,2023-09-23,Hannah Goldy,Decision - Unanimous,80,8,0,88
Mizuki,2019-08-31,Wu Yanan,Decision - Split,70,0,0,70
Mizuki,2020-08-22,Amanda Lemos,Decision - Unanimous,0,0,0,0
Reginaldo Vieira,2017-02-19,Aiemann Zahabi,Decision - Unanimous,0,20,0,20
Reginaldo Vieira,2016-07-07,Marco Beltran,Submission,0,0,0,0
Reginaldo Vieira,2015-08-01,Dileno Lopes,Decision - Unanimous,80,13,0,93
Roybert Echeverria,2022-09-20,Jafel Filho,KO/TKO,0,5,0,5
Zac Pauga,2024-02-10,Bogdan Guskov,KO/TKO,0,7,0,7
Zac Pauga,2023-06-17,Modestas Bukauskas,Decision - Unanimous,0,11,0,11
Zac Pauga,2023-02-18,Jordan Wright,Decision - Unanimous,80,30,0,110
Zac Pauga,2022-08-06,Mohammed Usman,KO/TKO,0,20,0,20
Efrain Escudero,2012-04-21,Mac Danzig,Decision - Unanimous,0,0,0,0
Efrain Escudero,2015-02-14,Rodrigo de Lima,Decision - Unanimous,80,70,0,150
Efrain Escudero,2010-09-15,Charles Oliveira,Submission,0,0,0,0
Efrain Escudero,2008-12-13,Phillipe Nover,Decision - Unanimous,80,7,0,87
Efrain Escudero,2014-09-13,Leonardo Santos,Decision - Unanimous,0,7,0,7
Efrain Escudero,2009-09-19,Cole Miller,KO/TKO,100,4,0,104
Efrain Escudero,2010-01-11,Evan Dunham,Submission,0,4,0,4
Efrain Escudero,2015-11-21,Leandro Silva,Decision - Unanimous,0,0,0,0
Efrain Escudero,2015-06-13,Drew Dober,Submission,90,1,0,91
Efrain Escudero,2011-12-30,Jacob Volkmann,Decision - Unanimous,0,0,0,0
Efrain Escudero,2010-05-29,Dan Lauzon,Decision - Unanimous,80,47,0,127
Efrain Escudero,2016-04-23,Kevin Lee,Decision - Unanimous,0,6,0,6
Tainara Lisboa,2023-05-13,Jessica-Rose Clark,Submission,90,16,0,106
Tainara Lisboa,2023-10-14,Ravena Oliveira,Decision - Unanimous,80,3,0,83
Kyle Prepolec,2019-09-14,Austin Hubbard,Decision - Unanimous,0,0,0,0
Kyle Prepolec,2019-05-04,Nordine Taleb,Decision - Unanimous,0,0,0,0
Daniel Lacerda,2021-10-23,Jeff Molina,KO/TKO,0,0,0,0
Daniel Lacerda,2022-04-30,Francisco Figueiredo,Submission,0,0,0,0
Daniel Lacerda,2024-02-24,Edgar Chairez,Submission,0,0,0,0
Daniel Lacerda,2023-03-25,CJ Vergara,KO/TKO,0,0,0,0
Daniel Lacerda,2022-08-20,Victor Altamirano,KO/TKO,0,0,0,0
Talita Alencar,2023-12-09,Rayanne dos Santos,Decision - Split,70,0,0,70
Talita Alencar,2024-08-10,Stephanie Luciano,Decision - Unanimous,0,0,0,0
Kazunari Murakami,2000-08-27,Masaaki Satake,KO/TKO,0,0,0,0
Kazunari Murakami,1997-10-11,John Dixson,Submission,90,2,0,92
Rubin Williams,2009-10-06,Kazushi Sakuraba,Submission,0,0,0,0
Eddie Gordon,2014-12-06,Josh Samman,KO/TKO,0,0,0,0
Eddie Gordon,2015-04-18,Chris Dempsey,Decision - Split,0,0,0,0
Eddie Gordon,2015-06-27,Antonio Carlos Junior,Submission,0,0,0,0
Eddie Gordon,2014-07-06,Dhiego Lima,KO/TKO,100,17,0,117
Isaac Dulgarian,2024-03-16,Christian Rodriguez,Decision - Split,0,0,0,0
Isaac Dulgarian,2024-09-07,Brendon Marotte,Submission,90,38,0,128
Isaac Dulgarian,2023-08-12,Francis Marshall,KO/TKO,100,33,0,133
Andy Ologun,2008-07-21,Daisuke Nakamura,Submission,0,2,0,2
Andy Ologun,2010-12-31,Katsuaki Furuki,Decision - Unanimous,80,36,0,116
Andy Ologun,2008-12-31,Yukio Sakaguchi,KO/TKO,100,7,0,107
Mackens Semerzier,2010-11-11,Cub Swanson,Decision - Split,0,0,0,0
Mackens Semerzier,2009-10-10,Wagnney Fabiano,Submission,90,0,0,90
Mackens Semerzier,2010-01-10,Deividas Taurosevicius,Decision - Unanimous,0,0,0,0
Mackens Semerzier,2012-03-02,Daniel Pineda,Submission,0,0,0,0
Mackens Semerzier,2010-08-18,Javier Vazquez,Submission,0,0,0,0
Mackens Semerzier,2011-03-26,Alex Caceres,Submission,90,7,0,97
Raquel Pa'aluhi,2011-08-27,Sara McMann,Submission,0,0,0,0
Fabiano Iha,2000-03-10,Dave Menne,Decision - Unanimous,0,0,0,0
Fabiano Iha,2001-09-28,Din Thomas,Decision - Unanimous,0,0,0,0
Fabiano Iha,1999-11-21,Frank Trigg,KO/TKO,0,0,0,0
Fabiano Iha,2001-02-23,Phil Johns,Submission,90,1,0,91
Fabiano Iha,2001-06-29,Caol Uno,KO/TKO,0,0,0,0
Fabiano Iha,2000-12-16,Daiju Takase,KO/TKO,100,8,0,108
Fabiano Iha,1999-05-07,Laverne Clark,TKO - Doctor's Stoppage,0,0,0,0
Fabiano Iha,2000-09-22,Laverne Clark,Submission,90,0,0,90
Paddy Pimblett,2023-12-16,Tony Ferguson,Decision - Unanimous,80,44,0,124
Paddy Pimblett,2021-09-04,Luigi Vendramini,KO/TKO,100,22,0,122
Paddy Pimblett,2022-07-23,Jordan Leavitt,Submission,90,1,0,91
Paddy Pimblett,2024-07-27,Bobby Green,Submission,90,0,0,90
Paddy Pimblett,2022-12-10,Jared Gordon,Decision - Unanimous,80,3,0,83
Paddy Pimblett,2022-03-19,Kazula Vargas,Submission,90,0,0,90
Gerard Gordeau,1993-11-12,Kevin Rosier,KO/TKO,100,11,0,111
Gerard Gordeau,1993-11-12,Royce Gracie,Submission,0,0,0,0
Gerard Gordeau,1993-11-12,Teila Tuli,KO/TKO,100,3,0,103
Kevin Rosier,1993-11-12,Gerard Gordeau,KO/TKO,0,0,0,0
Kevin Rosier,1993-11-12,Zane Frazier,KO/TKO,100,3,0,103
Augusto Montano,2015-06-13,Cathal Pendred,Decision - Unanimous,0,4,0,4
Augusto Montano,2014-11-15,Chris Heatherly,KO/TKO,100,22,0,122
Augusto Montano,2016-09-17,Belal Muhammad,KO/TKO,0,1,0,1
Brendon Marotte,2024-09-07,Isaac Dulgarian,Submission,0,0,0,0
Brendon Marotte,2023-10-14,Terrance McKinney,KO/TKO,0,0,0,0
Jerome Rivera,2021-07-10,Zhalgas Zhumagulov,Submission,0,1,0,1
Jerome Rivera,2020-08-04,Ronaldo Rodriguez,Decision - Unanimous,80,29,0,109
Jerome Rivera,2020-09-19,Tyson Nam,KO/TKO,0,0,0,0
Jerome Rivera,2021-01-20,Francisco Figueiredo,Decision - Unanimous,0,2,0,2
Jerome Rivera,2021-02-06,Ode Osbourne,KO/TKO,0,0,0,0
Lucas Almeida,2023-12-16,Andre Fili,KO/TKO,0,0,0,0
Lucas Almeida,2021-09-28,Daniel Zellhuber,Decision - Unanimous,0,0,0,0
Lucas Almeida,2024-06-15,Timmy Cuamba,Decision - Unanimous,80,11,0,91
Lucas Almeida,2023-06-17,Pat Sabatini,Submission,0,0,0,0
Lucas Almeida,2022-06-04,Michael Trizano,KO/TKO,100,44,0,144
Quinn Mulhern,2014-01-04,Katsunori Kikuno,Decision - Unanimous,0,0,0,0
Quinn Mulhern,2013-03-16,Rick Story,KO/TKO,0,0,0,0
Quinn Mulhern,2012-05-19,Yuri Villefort,Decision - Split,70,0,0,70
Aisling Daly,2015-04-25,Randa Markos,Decision - Unanimous,0,9,0,9
Aisling Daly,2014-12-12,Alex Chambers,Submission,90,4,0,94
Aisling Daly,2015-10-24,Ericka Almeida,Decision - Unanimous,80,40,0,120
Richardson Moreira,2014-05-31,Marcos Rogerio de Lima,KO/TKO,0,0,0,0
Richardson Moreira,2015-01-31,Ildemar Alcantara,Decision - Split,0,0,0,0
Shaheen Santana,2020-11-10,Natan Levy,Submission,0,0,0,0
Luke Flores,2017-08-29,Matt Frevola,Submission,0,0,0,0
Luke Flores,2020-08-04,Jordan Leavitt,Submission,0,0,0,0
Qiu Lun,2021-11-02,Erisson Ferreira,Decision - Unanimous,0,17,0,17
Qiu Lun,2022-10-23,SeungGuk Choi,Decision - Unanimous,0,11,0,11
Qiu Lun,2022-06-09,Wallen Del Rosario,Decision - Unanimous,80,50,0,130
Rin Nakai,2016-03-19,Leslie Smith,Decision - Unanimous,0,0,0,0
Rin Nakai,2014-09-20,Miesha Tate,Decision - Unanimous,0,0,0,0
Dion Staring,2009-05-09,Rogerio Nogueira,Submission,0,0,0,0
Dion Staring,2013-01-12,Daniel Cormier,KO/TKO,0,0,0,0
Marcos Mariano,2019-02-09,Lando Vannata,Submission,0,0,0,0
Marcos Mariano,2019-09-21,Claudio Puelles,Decision - Unanimous,0,0,0,0
Desmond Torres,2019-08-20,Steve Garcia,KO/TKO,0,0,0,0
Crosley Gracie,2004-10-14,Hayato Sakurai,Submission,90,0,0,90
Crosley Gracie,2005-05-22,Akihiro Gono,Decision - Unanimous,0,4,0,4
Theo Rlayang,2021-09-21,Steven Nguyen,Decision - Unanimous,0,0,0,0
Art Santore,2006-07-22,Ivan Salaverry,KO/TKO,0,0,0,0
Simeon Thoresen,2012-09-22,Seth Baczynski,KO/TKO,0,2,0,2
Simeon Thoresen,2013-01-26,David Mitchell,Decision - Unanimous,0,0,0,0
Simeon Thoresen,2012-04-14,Besam Yousef,Submission,90,9,0,99
Jeremiah Constant,2006-12-16,Cain Velasquez,KO/TKO,0,0,0,0
Bryan Pardoe,2004-06-02,Rashad Evans,KO/TKO,0,0,0,0
Bryan Pardoe,2003-03-27,Frank Shamrock,Submission,0,0,25,25
Bryan Pardoe,2002-12-15,Keith Jardine,KO/TKO,0,0,0,0
Ryuta Sakurai,2004-02-15,Yushin Okami,Decision - Unanimous,0,0,0,0
Ryuta Sakurai,2005-04-03,Murilo Bustamante,Decision - Unanimous,0,0,0,0
Ryuta Sakurai,2005-09-25,Paulo Filho,Submission,0,0,0,0
Konstantin Erokhin,2015-12-11,Gabriel Gonzaga,Decision - Unanimous,0,0,0,0
Konstantin Erokhin,2015-01-24,Viktor Pesta,Decision - Unanimous,0,0,0,0
Eli Aronov,2023-08-22,Zachary Reese,Submission,0,3,0,3
Korey Kuppe,2020-09-15,Michael Lombardo,Decision - Unanimous,0,0,0,0
Minoru Toyonaga,1999-04-29,Egan Inoue,KO/TKO,0,0,0,0
Chris Clements,2013-09-21,Stephen Thompson,KO/TKO,0,0,0,0
Chris Clements,2014-11-07,Vik Grujic,KO/TKO,100,18,0,118
Chris Clements,2012-04-21,Keith Wisniewski,Decision - Split,70,40,0,110
Chris Clements,2015-04-25,Nordine Taleb,Decision - Unanimous,0,0,0,0
William Gomis,2023-04-22,Francis Marshall,Decision - Split,70,12,0,82
William Gomis,2022-09-03,Jarno Errens,Decision - Unanimous,80,12,0,92
William Gomis,2023-09-02,Yanis Ghemmouri,KO/TKO,100,24,0,124
William Gomis,2024-09-28,Joanderson Brito,Decision - Split,70,14,0,84
Francis Marshall,2023-04-22,William Gomis,Decision - Split,0,0,0,0
Francis Marshall,2022-08-02,Connor Matthews,Decision - Unanimous,80,36,0,116
Francis Marshall,2023-08-12,Isaac Dulgarian,KO/TKO,0,0,0,0
Francis Marshall,2024-08-24,Dennis Buzukja,Decision - Split,70,0,0,70
Francis Marshall,2022-12-03,Marcelo Rojo,KO/TKO,100,0,0,100
Eduardo Neves,2023-09-12,Jhonata Diniz,KO/TKO,0,0,0,0
Eduardo Neves,2022-08-23,Mick Parkin,Submission,0,9,0,9
Issei Tamura,2012-07-11,Raphael Assuncao,KO/TKO,0,0,0,0
Issei Tamura,2013-03-16,TJ Dillashaw,KO/TKO,0,0,0,0
Issei Tamura,2012-02-25,Zhang Tiequan,KO/TKO,100,9,0,109
Dylan Mantello,2024-09-17,Ahmad Hassanzada,Submission,0,9,0,9
Dylan Mantello,2023-09-19,Kaynan Kruschewsky,Submission,0,0,0,0
Katsuaki Furuki,2010-12-31,Andy Ologun,Decision - Unanimous,0,0,0,0
Yanal Ashmouz,2023-07-22,Chris Duncan,Decision - Unanimous,0,0,0,0
Yanal Ashmouz,2023-03-18,Sam Patterson,KO/TKO,100,13,0,113
Yanal Ashmouz,2024-09-07,Trevor Peek,Decision - Unanimous,80,0,0,80
Julio Paulino,2010-09-25,TJ Grant,Decision - Unanimous,0,0,0,0
Julio Paulino,2010-03-21,Mike Pierce,Decision - Unanimous,0,0,0,0
Phil Cardella,2009-08-09,Ed Ratcliff,Decision - Unanimous,0,15,0,15
Phil Cardella,2009-03-01,Danny Castillo,Decision - Split,0,0,0,0
Cory Devela,2008-02-23,Joe Riggs,KO/TKO,100,2,0,102
Cory Devela,2008-09-20,Terry Martin,KO/TKO,0,18,0,18
Cory Devela,2009-06-19,Luke Rockhold,Submission,0,0,0,0
Maria Silva,2021-10-12,Kathryn Paprocki,Decision - Unanimous,80,49,0,129
Maria Silva,2022-08-30,Viktoriia Dudakova,Decision - Unanimous,0,7,0,7
Kathryn Paprocki,2021-10-12,Maria Silva,Decision - Unanimous,0,0,0,0
Toshiomi Kazama,2023-02-04,Rinya Nakamura,KO/TKO,0,0,0,0
Toshiomi Kazama,2022-06-09,Maimaitituoheti Keremuaili,Decision - Unanimous,80,3,0,83
Toshiomi Kazama,2023-08-26,Garrett Armfield,KO/TKO,0,0,0,0
Toshiomi Kazama,2024-08-10,Charalampos Grigoriou,Submission,90,0,0,90
Jarjis Danho,2016-02-27,Daniel Omielanczuk,Decision - Majority,0,0,0,0
Jarjis Danho,2021-04-10,Yorgan De Castro,KO/TKO,100,8,0,108
Rodolfo Marques Diniz,2011-12-31,Bibiano Fernandes,Decision - Unanimous,0,0,0,0
Rodolfo Marques Diniz,2011-09-24,Yusup Saadulaev,Decision - Unanimous,80,11,0,91
Yoislandy Izquierdo,2012-04-14,Reza Madadi,Submission,0,35,0,35
Yoislandy Izquierdo,2012-07-07,Rafaello Oliveira,Decision - Unanimous,0,0,0,0
Lucio Linhares,2009-12-12,Rousimar Palhares,Submission,0,2,0,2
Lucio Linhares,2010-03-31,Yushin Okami,TKO - Doctor's Stoppage,0,0,0,0
David Mitchell,2013-07-06,Mike Pierce,KO/TKO,0,0,0,0
David Mitchell,2010-09-15,TJ Waldburger,Decision - Unanimous,0,0,0,0
David Mitchell,2011-08-27,Paulo Thiago,Decision - Unanimous,0,4,0,4
David Mitchell,2013-01-26,Simeon Thoresen,Decision - Unanimous,80,11,0,91
David Mitchell,2013-10-09,Yan Cabral,Decision - Unanimous,0,0,0,0
Bruno Lopes,2024-08-13,Mikheil Sazhiniani,KO/TKO,100,7,0,107
Bruno Lopes,2023-09-05,Brendson Ribeiro,KO/TKO,0,0,0,0
Mikheil Sazhiniani,2024-08-13,Bruno Lopes,KO/TKO,0,0,0,0
Kamuela Kirk,2019-07-23,Billy Quarantillo,KO/TKO,0,0,0,0
Kamuela Kirk,2021-06-05,Makwan Amirkhani,Decision - Unanimous,80,8,0,88
Kamuela Kirk,2022-03-12,Damon Jackson,Submission,0,0,0,0
Kamuela Kirk,2023-07-08,Esteban Ribovics,Decision - Unanimous,0,0,0,0
Jerome LeBanner,2010-12-31,Satoshi Ishii,Decision - Unanimous,0,0,0,0
Jerome LeBanner,2005-03-26,Yoshihiro Akiyama,KO/TKO,100,5,0,105
James Mulheron,2017-07-16,Justin Willis,Decision - Unanimous,0,0,0,0
Lucas Fernando,2023-08-08,Cesar Almeida,Decision - Unanimous,0,0,0,0
Zachary Borrego,2022-08-09,Bo Nickal,Submission,0,0,0,0
Rodolfo Vieira,2020-03-07,Saparbeg Safarov,Submission,90,0,0,90
Rodolfo Vieira,2024-02-10,Armen Petrosyan,Submission,90,0,0,90
Rodolfo Vieira,2021-02-13,Anthony Hernandez,Submission,0,0,0,0
Rodolfo Vieira,2019-08-10,Oskar Piechota,Submission,90,0,0,90
Rodolfo Vieira,2021-07-17,Dustin Stoltzfus,Submission,90,0,0,90
Rodolfo Vieira,2022-06-25,Chris Curtis,Decision - Unanimous,0,0,0,0
Rodolfo Vieira,2023-04-29,Cody Brundage,Submission,90,0,0,90
Jason Black,2007-06-12,Thiago Tavares,Submission,0,0,0,0
Jason Black,2007-10-20,Matt Grice,Decision - Split,0,0,0,0
Jason Black,2006-06-04,Won Jin Eoh,KO/TKO,100,0,0,100
Jason Black,2006-08-27,Shinya Aoki,Submission,0,0,0,0
Matt Grice,2012-06-08,Leonard Garcia,Decision - Unanimous,80,59,0,139
Matt Grice,2007-10-20,Jason Black,Decision - Split,70,34,0,104
Matt Grice,2007-04-21,Terry Etim,Submission,0,21,0,21
Matt Grice,2013-02-23,Dennis Bermudez,Decision - Split,0,0,0,0
Matt Grice,2009-02-07,Matt Veach,KO/TKO,0,17,0,17
Matt Grice,2009-07-11,Shannon Gugerty,Submission,0,3,0,3
Matt Grice,2011-06-26,Ricardo Lamas,KO/TKO,0,0,0,0
Nah-Shon Burrell,2013-05-25,Stephen Thompson,Decision - Unanimous,0,0,0,0
Nah-Shon Burrell,2012-01-07,James Terry,Decision - Split,70,25,0,95
Nah-Shon Burrell,2013-02-23,Yuri Villefort,Decision - Unanimous,80,73,0,153
Nah-Shon Burrell,2012-05-19,Chris Spang,KO/TKO,0,0,0,0
Justin Wilcox,2008-09-20,Mitsuhiro Ishida,Submission,0,0,0,0
Justin Wilcox,2012-07-14,Jorge Masvidal,Decision - Split,0,0,0,0
Justin Wilcox,2011-04-01,Rodrigo Damm,TKO - Doctor's Stoppage,0,14,0,14
Justin Wilcox,2010-03-26,Shamar Bailey,Decision - Unanimous,80,55,0,135
Josh Smith,2007-06-03,Alex Karalexis,Decision - Majority,0,0,0,0
Rudy Bears,2009-11-20,Tyron Woodley,Submission,0,0,0,0
Ronaldo Rodriguez,2020-08-04,Jerome Rivera,Decision - Unanimous,0,0,0,0
Ronaldo Rodriguez,2024-09-14,Ode Osbourne,Decision - Unanimous,80,0,0,80
Ronaldo Rodriguez,2024-02-24,Denys Bondar,Submission,90,0,0,90
Piotr Hallmann,2015-11-07,Alex Oliveira,KO/TKO,0,0,0,0
Piotr Hallmann,2014-06-07,Yves Edwards,Submission,90,29,0,119
Piotr Hallmann,2013-09-04,Francisco Trinaldo,Submission,90,20,0,110
Piotr Hallmann,2014-09-13,Gleison Tibau,Decision - Split,0,22,0,22
Piotr Hallmann,2013-10-26,Al Iaquinta,Decision - Unanimous,0,0,0,0
Piotr Hallmann,2015-06-20,Magomed Mustafaev,TKO - Doctor's Stoppage,0,11,0,11
Nathan Coy,2010-05-21,Tyron Woodley,Decision - Split,0,37,0,37
Nathan Coy,2016-02-21,Jonavin Webb,Decision - Unanimous,80,16,0,96
Nathan Coy,2015-12-10,Danny Roberts,Submission,0,5,0,5
Nathan Coy,2017-04-15,Zak Cummings,Submission,0,0,0,0
Nathan Coy,2011-01-29,Nate Moore,KO/TKO,0,7,0,7
Melissa Martinez,2022-09-10,Elise Reed,Decision - Unanimous,0,7,0,7
Melissa Martinez,2024-10-19,Alice Ardelean,Decision - Unanimous,80,0,0,80
Jeremy Lang,2008-06-01,Tim McKenzie,Submission,0,0,0,0
Gabe Ruediger,2010-08-28,Joe Lauzon,Submission,0,0,0,0
Gabe Ruediger,2011-02-05,Paul Taylor,KO/TKO,0,0,0,0
Gabe Ruediger,2006-09-23,Melvin Guillard,KO/TKO,0,0,0,0
Joe Vedepo,2009-04-01,Rob Kimmons,Submission,0,0,0,0
Joe Vedepo,2008-09-17,Alessio Sakara,KO/TKO,0,0,0,0
Mick Parkin,2024-07-27,Lukasz Brzeski,KO/TKO,100,10,0,110
Mick Parkin,2023-07-22,Jamal Pogues,Decision - Unanimous,80,59,0,139
Mick Parkin,2023-11-18,Caio Machado,Decision - Unanimous,80,0,0,80
Mick Parkin,2022-08-23,Eduardo Neves,Submission,90,0,0,90
Mick Parkin,2024-03-23,Mohammed Usman,Decision - Unanimous,80,15,0,95
Fabio Gurgel,1996-09-20,Jerry Bohlander,Decision - Unanimous,0,0,0,0
Danilo Belluardo,2019-06-01,Joel Alvarez,KO/TKO,0,0,0,0
Danilo Belluardo,2019-09-28,Mark Madsen,KO/TKO,0,0,0,0
Michael Lerma,2005-10-12,Yoshihiro Akiyama,KO/TKO,0,0,0,0
TJ Waldburger,2010-09-15,David Mitchell,Decision - Unanimous,80,24,0,104
TJ Waldburger,2011-03-26,Johny Hendricks,KO/TKO,0,0,0,0
TJ Waldburger,2014-02-22,Mike Pyle,KO/TKO,0,0,0,0
TJ Waldburger,2012-12-15,Nick Catone,Submission,90,3,0,93
TJ Waldburger,2012-06-22,Brian Ebersole,Decision - Unanimous,0,0,0,0
TJ Waldburger,2012-03-02,Jake Hecht,Submission,90,1,0,91
TJ Waldburger,2013-10-19,Adlan Amagov,KO/TKO,0,0,0,0
TJ Waldburger,2011-09-17,Mike Stumpf,Submission,90,4,0,94
Rodrigo de Lima,2015-02-14,Efrain Escudero,Decision - Unanimous,0,0,0,0
Rodrigo de Lima,2014-06-28,Neil Magny,KO/TKO,0,0,0,0
Mikey Gonzalez,2020-08-04,Uros Medic,KO/TKO,0,0,0,0
Scott McAfee,2007-09-05,Marcus Hicks,Submission,0,0,0,0
Tateki Matsuda,2015-01-18,Joby Sanchez,Decision - Split,0,0,0,0
Tateki Matsuda,2014-09-05,Chris Beal,Decision - Unanimous,0,0,0,0
Luis Ramos,2012-06-22,Matt Brown,KO/TKO,0,0,0,0
Luis Ramos,2011-08-27,Erick Silva,KO/TKO,0,0,0,0
Greg Nagy,2010-01-30,Herschel Walker,KO/TKO,0,0,0,0
Garett Whiteley,2014-12-13,David Michaud,Decision - Unanimous,0,0,0,0
Garett Whiteley,2013-10-09,Alan Patrick,KO/TKO,0,0,0,0
Garett Whiteley,2014-01-15,Vinc Pichel,Decision - Unanimous,0,0,0,0
Maycee Barber,2022-04-23,Montana De La Rosa,Decision - Unanimous,80,36,0,116
Maycee Barber,2023-03-25,Andrea Lee,Decision - Split,70,9,0,79
Maycee Barber,2021-07-24,Miranda Maverick,Decision - Split,70,0,0,70
Maycee Barber,2020-01-18,Roxanne Modafferi,Decision - Unanimous,0,0,0,0
Maycee Barber,2019-10-18,Gillian Robertson,KO/TKO,100,22,0,122
Maycee Barber,2019-03-23,JJ Aldrich,KO/TKO,100,30,0,130
Maycee Barber,2018-07-17,Jamie Colleen,KO/TKO,100,60,0,160
Maycee Barber,2024-03-09,Katlyn Cerminara,Decision - Unanimous,80,18,0,98
Maycee Barber,2021-02-13,Alexa Grasso,Decision - Unanimous,0,2,0,2
Maycee Barber,2022-07-02,Jessica Eye,Decision - Unanimous,80,28,0,108
Maycee Barber,2018-11-10,Hannah Cifers,KO/TKO,100,27,0,127
Maycee Barber,2023-06-24,Amanda Ribas,KO/TKO,100,46,0,146
Lolohea Mahe,2010-07-23,Shane del Rosario,KO/TKO,0,0,0,0
Lolohea Mahe,2010-03-26,Lavar Johnson,KO/TKO,0,0,0,0
Jiniushiyue,2023-05-27,Billy Pasulatan,KO/TKO,100,14,0,114
Jiniushiyue,2023-08-27,SeungGuk Choi,Decision - Unanimous,80,19,0,99
Jiniushiyue,2024-02-03,Rei Tsuruya,KO/TKO,0,0,0,0
Billy Pasulatan,2023-05-27,Jiniushiyue,KO/TKO,0,0,0,0
Deshaun Johnson,2004-01-16,Yves Edwards,Decision - Unanimous,0,0,0,0
Gary Frazier,2009-09-25,Daniel Cormier,KO/TKO,0,0,0,0
Travis Fulton,1999-05-07,Pete Williams,Submission,0,0,0,0
Travis Fulton,1999-07-16,David Dodd,Decision - Unanimous,80,25,0,105
Tomasz Drwal,2007-09-08,Thiago Silva,KO/TKO,0,0,0,0
Tomasz Drwal,2009-09-19,Drew McFedries,Submission,90,14,0,104
Tomasz Drwal,2010-03-27,Rousimar Palhares,Submission,0,0,0,0
Tomasz Drwal,2009-01-17,Ivan Serati,KO/TKO,100,11,0,111
Tomasz Drwal,2010-09-15,David Branch,Decision - Unanimous,0,0,0,0
Tomasz Drwal,2009-06-20,Mike Ciesnolevicz,KO/TKO,100,24,0,124
Ariane Carnelossi,2021-04-24,Liang Na,KO/TKO,100,5,0,105
Ariane Carnelossi,2022-05-07,Loopy Godinez,Decision - Unanimous,0,0,0,0
Ariane Carnelossi,2021-10-16,Istela Nunes,Submission,90,0,0,90
Ariane Carnelossi,2019-09-21,Angela Hill,TKO - Doctor's Stoppage,0,0,0,0
Ariane Carnelossi,2024-05-18,Piera Rodriguez,DQ,0,0,0,0
Richard Jacobi,2022-09-20,Austen Lane,KO/TKO,0,0,0,0
Jason Thacker,2005-04-09,Chris Leben,KO/TKO,0,0,0,0
Mikey Burnett,1998-03-13,Eugenio Tadeu,KO/TKO,100,36,0,136
Mikey Burnett,1999-01-08,Townsend Saunders,Decision - Unanimous,80,8,0,88
Mikey Burnett,1998-10-16,Pat Miletich,Decision - Split,0,5,0,5
Eugenio Tadeu,1998-03-13,Mikey Burnett,KO/TKO,0,0,0,0
Brad Riddell,2021-12-04,Rafael Fiziev,KO/TKO,0,0,0,0
Brad Riddell,2020-09-26,Alex Da Silva,Decision - Unanimous,80,13,0,93
Brad Riddell,2022-07-02,Jalin Turner,Submission,0,0,0,0
Brad Riddell,2019-10-05,Jamie Mullarkey,Decision - Unanimous,80,55,0,135
Brad Riddell,2021-06-12,Drew Dober,Decision - Unanimous,80,16,0,96
Brad Riddell,2020-02-22,Magomed Mustafaev,Decision - Split,70,10,0,80
Brad Riddell,2022-11-12,Renato Moicano,Submission,0,4,0,4
Joseph Morales,2017-08-05,Robert Sanchez,Submission,90,10,0,100
Joseph Morales,2018-11-10,Eric Shelton,Decision - Split,0,8,0,8
Joseph Morales,2018-02-03,Deiveson Figueiredo,KO/TKO,0,0,0,0
Robert Sanchez,2017-08-05,Joseph Morales,Submission,0,0,0,0
Robert Sanchez,2018-09-08,Jarred Brooks,Decision - Split,0,0,0,0
Robert Sanchez,2018-02-18,Joby Sanchez,Submission,90,1,0,91
Alexander Munoz,2021-04-17,Luis Pena,Decision - Split,0,0,0,0
Alexander Munoz,2023-07-15,Carl Deaton,Decision - Unanimous,80,7,0,87
Alexander Munoz,2018-07-24,Nick Newell,Decision - Unanimous,80,8,0,88
Alexander Munoz,2020-08-08,Nasrat Haqparast,Decision - Unanimous,0,0,0,0
Kwan Ho Kwak,2016-11-19,Brett Johns,Decision - Unanimous,0,4,0,4
Kwan Ho Kwak,2017-06-17,Russell Doane,KO/TKO,0,0,0,0
Matt Veach,2010-04-10,Paul Kelly,Submission,0,0,0,0
Matt Veach,2009-02-07,Matt Grice,KO/TKO,100,0,0,100
Matt Veach,2009-12-05,Frankie Edgar,Submission,0,0,0,0
Justin James,2006-10-14,Clay Guida,Submission,0,0,0,0
Yuki Ishikawa,2001-11-03,Quinton Jackson,KO/TKO,0,0,0,0
Justin Robbins,2007-08-05,Antonio Banuelos,Decision - Unanimous,0,0,0,0
Jack May,2014-04-19,Derrick Lewis,KO/TKO,0,0,0,0
Jack May,2014-08-16,Shawn Jordan,KO/TKO,0,0,0,0
Henrique da Silva,2016-10-01,Joachim Christensen,Submission,90,0,0,90
Henrique da Silva,2017-09-22,Gokhan Saki,KO/TKO,0,0,0,0
Henrique da Silva,2016-06-04,Jonathan Wilson,KO/TKO,100,15,0,115
Henrique da Silva,2017-06-10,Ion Cutelaba,KO/TKO,0,0,0,0
Henrique da Silva,2018-08-11,Johnny Walker,Decision - Unanimous,0,0,0,0
Henrique da Silva,2017-01-28,Jordan Johnson,Decision - Unanimous,0,0,0,0
Henrique da Silva,2016-12-17,Paul Craig,Submission,0,0,0,0
Collin Anglin,2021-11-13,Sean Woodson,KO/TKO,0,0,0,0
Collin Anglin,2020-09-15,Muhammad Naimov,Decision - Unanimous,80,36,0,116
Collin Anglin,2021-07-31,Melsik Baghdasaryan,KO/TKO,0,0,0,0
Kyle Watson,2010-12-04,Sako Chivitchian,Decision - Unanimous,80,36,0,116
Kyle Watson,2011-04-30,John Makdessi,KO/TKO,0,0,0,0
Sako Chivitchian,2010-12-04,Kyle Watson,Decision - Unanimous,0,0,0,0
Jacqueline Cavalcanti,2024-09-28,Nora Cornolle,Decision - Split,70,0,0,70
Jacqueline Cavalcanti,2024-08-24,Josiane Nunes,Decision - Split,70,39,0,109
Jacqueline Cavalcanti,2023-09-02,Zarah Fairn,Decision - Unanimous,80,87,0,167
Kevin Casey,2015-07-15,Ildemar Alcantara,Decision - Unanimous,80,21,0,101
Kevin Casey,2016-01-30,Rafael Natal,KO/TKO,0,0,0,0
Kevin Casey,2016-08-27,Sam Alvey,KO/TKO,0,0,0,0
Kevin Casey,2013-04-13,Josh Samman,KO/TKO,0,0,0,0
Kevin Casey,2010-05-21,Matt Lindland,KO/TKO,0,0,0,0
Luis Pajuelo,2024-03-23,Fernando Padilla,Submission,0,0,0,0
Luis Pajuelo,2023-08-22,Robbie Ring,KO/TKO,100,15,0,115
Sam Patterson,2024-01-20,Yohan Lainesse,Submission,90,4,0,94
Sam Patterson,2023-03-18,Yanal Ashmouz,KO/TKO,0,0,0,0
Sam Patterson,2022-09-27,Vinicius Cenci,Submission,90,0,0,90
Sam Patterson,2024-07-27,Kiefer Crosbie,Submission,90,0,0,90
Yohan Lainesse,2024-01-20,Sam Patterson,Submission,0,0,0,0
Yohan Lainesse,2021-11-02,Justin Burlinson,KO/TKO,100,3,0,103
Yohan Lainesse,2022-09-10,Darian Weeks,Decision - Split,70,0,0,70
Yohan Lainesse,2022-04-30,Gabe Green,KO/TKO,0,0,0,0
Yohan Lainesse,2023-02-25,Mike Malott,Submission,0,0,0,0
Rob McCullough,2011-09-24,Shinya Aoki,Submission,0,0,0,0
Rob McCullough,2008-06-01,Kenneth Alexander,Decision - Split,70,21,0,91
Rob McCullough,2002-11-23,Josh Thomson,Decision - Unanimous,0,0,0,0
Rob McCullough,2008-02-13,Jamie Varner,KO/TKO,0,0,25,25
Rob McCullough,2009-11-18,Karen Darabedyan,Decision - Split,0,0,0,0
Rob McCullough,2009-03-01,Marcus Hicks,Decision - Majority,75,24,0,99
Rob McCullough,2008-11-05,Donald Cerrone,Decision - Unanimous,0,0,0,0
Rob McCullough,2007-09-05,Richard Crunkilton,KO/TKO,100,11,25,136
Rob McCullough,2007-01-20,Kit Cope,Submission,90,6,25,121
Sean Lally,2018-06-12,Chris Curtis,KO/TKO,0,0,0,0
Andreas Michailidis,2022-06-04,Rinat Fakhretdinov,Decision - Unanimous,0,0,0,0
Andreas Michailidis,2021-05-01,KB Bhullar,Decision - Unanimous,80,3,0,83
Andreas Michailidis,2021-11-06,Alex Pereira,KO/TKO,0,0,0,0
Andreas Michailidis,2020-07-15,Modestas Bukauskas,KO/TKO,0,5,0,5
Jesse Juarez,2008-09-20,Luke Stewart,Submission,0,7,0,7
Noah Thomas,2009-06-07,Frank Gomez,Submission,0,0,0,0
Noah Thomas,2009-10-10,Scott Jorgensen,KO/TKO,0,0,0,0
Clint Coronel,2007-09-29,Billy Evangelista,Decision - Split,0,0,0,0
Mike Breeden,2021-10-02,Alexander Hernandez,KO/TKO,0,0,0,0
Mike Breeden,2023-08-12,Terrance McKinney,KO/TKO,0,0,0,0
Mike Breeden,2022-04-30,Natan Levy,Decision - Unanimous,0,12,0,12
Mike Breeden,2023-10-21,Anshul Jubli,KO/TKO,100,0,0,100
Mike Breeden,2020-08-25,Anthony Romero,Decision - Unanimous,0,0,0,0
John Gunther,2018-07-06,Allan Zuniga,Decision - Majority,75,0,0,75
John Gunther,2018-11-10,Davi Ramos,Submission,0,0,0,0
Allan Zuniga,2018-07-06,John Gunther,Decision - Majority,0,32,0,32
John Devine,2010-03-26,Daniel Cormier,KO/TKO,0,0,0,0
Philip Perez,2006-10-07,Brandon Shuey,Submission,90,1,0,91
Brandon Shuey,2006-10-07,Philip Perez,Submission,0,0,0,0
Vagner Rocha,2011-06-11,Donald Cerrone,Decision - Unanimous,0,0,0,0
Vagner Rocha,2011-09-17,Cody McKenzie,Submission,90,3,0,93
Vagner Rocha,2014-11-07,Jake Matthews,Submission,0,0,0,0
Vagner Rocha,2012-02-15,Jonathan Brookins,KO/TKO,0,0,0,0
Romie Aram,2003-04-25,Dave Strasser,Decision - Unanimous,0,0,0,0
Romie Aram,2002-10-19,Joe Stevenson,Decision - Unanimous,80,5,0,85
Allan Goes,2001-03-25,Mark Coleman,KO/TKO,0,0,0,0
Allan Goes,2000-06-04,Vernon White,Decision - Unanimous,80,36,0,116
Allan Goes,1999-11-21,Carl Malenko,Submission,90,3,0,93
Allan Goes,2001-12-23,Alex Stiebling,KO/TKO,0,0,0,0
Allan Goes,1998-05-15,Dan Henderson,Decision - Unanimous,0,5,0,5
Vinicius Queiroz,2010-10-16,Rob Broughton,Submission,0,0,0,0
Nick Aguirre,2023-01-14,Dan Argueta,Decision - Unanimous,0,0,0,0
Nick Aguirre,2023-11-18,Payton Talbott,Submission,0,0,0,0
Larry Cureton,1995-09-08,Marco Ruas,Submission,0,5,0,5
Larry Cureton,1995-04-07,Todd Medina,Submission,0,0,0,0
Chris Spang,2013-04-06,Adlan Amagov,Decision - Unanimous,0,0,0,0
Chris Spang,2012-05-19,Nah-Shon Burrell,KO/TKO,100,22,0,122
Chris Spang,2012-01-07,Ricky Legere Jr.,Decision - Unanimous,0,7,0,7
Mario Miranda,2010-03-31,Gerald Harris,KO/TKO,0,0,0,0
Mario Miranda,2011-03-26,Aaron Simpson,Decision - Unanimous,0,0,0,0
Mario Miranda,2010-08-28,Demian Maia,Decision - Unanimous,0,0,0,0
Mario Miranda,2010-06-12,David Loiseau,KO/TKO,100,40,0,140
Gian Siqueira,2022-10-23,Samandar Murodov,Submission,0,0,0,0
Christian Colombo,2016-11-19,Luis Henrique,Submission,0,0,0,0
Christian Colombo,2017-10-28,Marcelo Golm,Submission,0,0,0,0
Benji Radach,2002-09-27,Sean Sherk,TKO - Doctor's Stoppage,0,1,0,1
Benji Radach,2008-10-04,Murilo Rua,KO/TKO,100,9,0,109
Benji Radach,2009-04-11,Scott Smith,KO/TKO,0,40,0,40
Benji Radach,2010-12-04,Ovince Saint Preux,Decision - Unanimous,0,0,0,0
Benji Radach,2002-06-22,Nick Serra,Decision - Unanimous,80,26,0,106
Billy Vaughan,2011-03-05,Jorge Gurgel,Submission,0,0,0,0
Geraldo de Freitas,2020-11-14,Tony Gravely,Decision - Split,0,27,0,27
Geraldo de Freitas,2019-02-02,Felipe Colares,Decision - Unanimous,80,28,0,108
Geraldo de Freitas,2019-08-10,Chris Gutierrez,Decision - Split,0,0,0,0
Leonardo Morales,2014-11-15,Yair Rodriguez,Decision - Unanimous,0,0,0,0
Leonardo Morales,2015-06-06,Jose Quinonez,Submission,0,1,0,1
Kay Hansen,2022-04-09,Piera Rodriguez,Decision - Unanimous,0,0,0,0
Kay Hansen,2020-11-14,Cory McKenna,Decision - Unanimous,0,10,0,10
Kay Hansen,2020-06-27,Jinh Yu Frey,Submission,90,5,0,95
Kay Hansen,2022-01-22,Jasmine Jasudavicius,Decision - Unanimous,0,0,0,0
Eduarda Moura,2023-11-04,Montserrat Conejo Ruiz,KO/TKO,100,52,0,152
Eduarda Moura,2023-08-15,Janaina Silva,Submission,90,6,0,96
Eduarda Moura,2024-06-08,Denise Gomes,Decision - Split,0,0,0,0
Eduarda Moura,2024-11-16,Veronica Hardy,Decision - Unanimous,80,0,0,80
Cole Smith,2019-09-14,Miles Johns,Decision - Split,0,0,0,0
Cole Smith,2020-09-05,Hunter Azure,Decision - Unanimous,0,0,0,0
Cole Smith,2019-05-04,Mitch Gagnon,Decision - Unanimous,80,23,0,103
Will Kerr,2010-06-20,Karen Darabedyan,Submission,90,2,0,92
Will Kerr,2010-12-16,Danny Castillo,KO/TKO,0,0,0,0
Will Kerr,2009-11-18,Kamal Shalorus,KO/TKO,0,0,0,0
Oban Elliott,2024-02-17,Val Woodburn,Decision - Unanimous,80,47,0,127
Oban Elliott,2024-11-16,Bassil Hafez,KO/TKO,100,41,0,141
Oban Elliott,2023-08-22,Kaik Brito,Decision - Majority,75,16,0,91
Oban Elliott,2024-07-27,Preston Parsons,Decision - Unanimous,80,8,0,88
Val Woodburn,2024-02-17,Oban Elliott,Decision - Unanimous,0,0,0,0
Val Woodburn,2023-07-08,Bo Nickal,KO/TKO,0,0,0,0
Nordine Taleb,2018-05-27,Claudio Silva,Submission,0,0,0,0
Nordine Taleb,2016-03-05,Erick Silva,KO/TKO,100,15,0,115
Nordine Taleb,2015-08-01,Warlley Alves,Submission,0,0,0,0
Nordine Taleb,2017-12-16,Danny Roberts,KO/TKO,100,4,0,104
Nordine Taleb,2018-10-27,Sean Strickland,KO/TKO,0,0,0,0
Nordine Taleb,2014-10-04,Li Jingliang,Decision - Split,70,23,0,93
Nordine Taleb,2019-09-07,Muslim Salikhov,KO/TKO,0,0,0,0
Nordine Taleb,2017-05-28,Oliver Enkamp,Decision - Unanimous,80,23,0,103
Nordine Taleb,2017-02-19,Santiago Ponzinibbio,Decision - Unanimous,0,0,0,0
Nordine Taleb,2015-04-25,Chris Clements,Decision - Unanimous,80,19,0,99
Nordine Taleb,2014-04-16,Vik Grujic,Decision - Unanimous,80,44,0,124
Nordine Taleb,2019-05-04,Kyle Prepolec,Decision - Unanimous,80,38,0,118
Chase Waldon,2017-07-25,Geoff Neal,KO/TKO,0,0,0,0
Caolan Loughran,2024-07-27,Jake Hadley,Decision - Unanimous,0,0,0,0
Caolan Loughran,2023-09-02,Taylor Lapilus,Decision - Unanimous,0,0,0,0
Caolan Loughran,2024-03-30,Angel Pacheco,Decision - Unanimous,80,52,0,132
Armen Petrosyan,2024-02-10,Rodolfo Vieira,Submission,0,3,0,3
Armen Petrosyan,2022-02-26,Gregory Rodrigues,Decision - Split,70,66,0,136
Armen Petrosyan,2022-07-09,Caio Borralho,Decision - Unanimous,0,19,0,19
Armen Petrosyan,2023-06-17,Christian Leroy Duncan,Decision - Unanimous,80,30,0,110
Armen Petrosyan,2021-10-19,Kaloyan Kolev,KO/TKO,100,15,0,115
Armen Petrosyan,2022-10-22,AJ Dobson,Decision - Unanimous,80,60,0,140
Armen Petrosyan,2024-10-26,Shara Magomedov,KO/TKO,0,12,0,12
Don Madge,2018-10-27,Te Edwards,KO/TKO,100,16,0,116
Don Madge,2019-09-07,Fares Ziam,Decision - Unanimous,80,11,0,91
Tereza Bleda,2023-06-17,Gabriella Fernandes,Decision - Unanimous,80,34,0,114
Tereza Bleda,2022-09-06,Nayara Maia,Decision - Unanimous,80,41,0,121
Tereza Bleda,2022-11-19,Natalia Silva,KO/TKO,0,0,0,0
Chalid Arrab,2003-10-05,Rodney Faverus,Decision - Unanimous,80,0,0,80
Chalid Arrab,2004-05-23,Kazuhiro Nakamura,Submission,0,6,0,6
Rodney Faverus,2003-10-05,Chalid Arrab,Decision - Unanimous,0,7,0,7
Jon Madsen,2010-10-23,Gilbert Yvel,KO/TKO,100,18,0,118
Jon Madsen,2011-03-26,Mike Russow,TKO - Doctor's Stoppage,0,13,0,13
Jon Madsen,2010-07-03,Karlos Vemola,Decision - Unanimous,80,21,0,101
Jon Madsen,2009-12-05,Justin Wren,Decision - Split,70,9,0,79
Jon Madsen,2010-04-10,Mostapha Al-Turk,Decision - Unanimous,80,12,0,92
Randall Wallace,2017-08-15,Charles Byrd,Submission,0,0,0,0
Ben Sosoli,2020-02-22,Marcos Rogerio de Lima,KO/TKO,0,0,0,0
Justin Hawes,2006-10-12,Justin Levens,KO/TKO,0,0,0,0
David Baron,2008-10-18,Jim Miller,Submission,0,0,0,0
David Baron,2006-08-27,Takanori Gomi,Submission,0,0,0,0
Bendy Casimir,2010-06-20,Erik Koch,Submission,0,0,0,0
Bendy Casimir,2010-03-06,Ricardo Lamas,KO/TKO,0,0,0,0
Azamat Gashimov,2012-11-17,Ivan Menjivar,Submission,0,0,0,0
Azamat Gashimov,2013-05-18,John Lineker,KO/TKO,0,0,0,0
Takahiro Oba,2005-04-03,Denis Kang,Submission,0,0,0,0
Jinensibieke Asikeerbai,2022-06-10,KyeungPyo Kim,KO/TKO,0,0,0,0
Nate Smith,2020-09-01,Jimmy Flick,Submission,0,0,0,0
Joe Ellenberger,2014-06-28,James Moontasri,Decision - Split,70,0,0,70
Joe Ellenberger,2014-12-13,Bryan Barberena,KO/TKO,0,0,0,0
Lucrezia Ria,2019-08-06,Marilia Santos,Decision - Split,70,0,0,70
Marilia Santos,2019-08-06,Lucrezia Ria,Decision - Split,0,5,0,5
Sanford Alton Meeks,2019-06-18,Yorgan De Castro,KO/TKO,0,0,0,0
Javier Vazquez,2010-03-06,Jens Pulver,Submission,90,0,0,90
Javier Vazquez,2009-10-10,Deividas Taurosevicius,Decision - Split,0,0,0,0
Javier Vazquez,2010-11-11,Chad Mendes,Decision - Unanimous,0,0,0,0
Javier Vazquez,2009-08-09,LC Davis,Decision - Split,0,6,0,6
Javier Vazquez,2010-08-18,Mackens Semerzier,Submission,90,21,0,111
Javier Vazquez,2011-06-26,Joe Stevenson,Decision - Unanimous,80,35,0,115
Keith Wisniewski,2005-01-29,Shinya Aoki,Submission,0,7,0,7
Keith Wisniewski,2005-11-19,Nick Thompson,Decision - Unanimous,0,0,0,0
Keith Wisniewski,2013-09-04,Ivan Jorge,Decision - Unanimous,0,0,0,0
Keith Wisniewski,2011-10-01,Josh Neer,TKO - Doctor's Stoppage,0,0,0,0
Keith Wisniewski,2012-04-21,Chris Clements,Decision - Split,0,0,0,0
Rafael Estevam,2023-11-18,Charles Johnson,Decision - Unanimous,80,0,0,80
Rafael Estevam,2022-09-27,Joao Elias,KO/TKO,100,45,0,145
Thomas Denny,2006-08-17,Alex Karalexis,Decision - Unanimous,0,0,0,0
Thomas Denny,2003-05-16,Joe Stevenson,Submission,0,0,0,0
Thomas Denny,2003-01-25,Georges St-Pierre,KO/TKO,0,0,0,0
Thomas Denny,2008-07-26,Nick Diaz,KO/TKO,0,0,0,0
Rick Roufus,2008-02-23,Maurice Smith,Submission,0,0,0,0
Rami Hamed,2024-08-13,Ding Meng,Decision - Unanimous,80,7,0,87
Ding Meng,2024-08-13,Rami Hamed,Decision - Unanimous,0,0,0,0
Mario Neto,2006-09-23,Eddie Sanchez,KO/TKO,0,0,0,0
Vitor Ribeiro,2009-04-05,Katsuhiko Nagata,TKO - Doctor's Stoppage,0,3,0,3
Vitor Ribeiro,2010-05-15,Lyle Beerbohm,Decision - Split,0,0,0,0
Vitor Ribeiro,2009-07-20,Shinya Aoki,Decision - Unanimous,0,0,0,0
Janaina Silva,2023-08-15,Eduarda Moura,Submission,0,0,0,0
Mu Bae Choi,2004-05-23,Yoshihisa Yamamoto,Decision - Unanimous,80,0,0,80
Mu Bae Choi,2004-12-31,Paulo Cesar Silva,Submission,90,9,0,99
Mu Bae Choi,2005-02-20,Sergei Kharitonov,KO/TKO,0,0,0,0
Mu Bae Choi,2004-02-15,Yusuke Imamura,Submission,90,2,0,92
Mu Bae Choi,2004-10-31,Soa Palelei,Submission,90,0,0,90
HanSeul Kim,2022-06-10,John Adajar,Submission,90,11,0,101
HanSeul Kim,2024-05-18,Bahatebole Batebolati,Decision - Unanimous,0,16,0,16
HanSeul Kim,2023-05-27,Taiyilake Nueraji,KO/TKO,0,0,0,0
John Adajar,2022-06-10,HanSeul Kim,Submission,0,0,0,0
Bobby McAndrews,2004-02-21,Kenny Florian,Submission,0,3,0,3
Philipe Lins,2023-06-03,Maxim Grishin,Decision - Unanimous,80,4,0,84
Philipe Lins,2024-03-09,Ion Cutelaba,Decision - Unanimous,80,20,0,100
Philipe Lins,2020-06-27,Tanner Boser,KO/TKO,0,0,0,0
Philipe Lins,2022-04-23,Marcin Prachnio,Decision - Unanimous,80,0,0,80
Philipe Lins,2023-02-18,Ovince Saint Preux,KO/TKO,100,17,0,117
Philipe Lins,2020-05-13,Andrei Arlovski,Decision - Unanimous,0,0,0,0
Edilberto de Oliveira,2007-09-19,Luke Cummo,KO/TKO,0,0,0,0
Edilberto de Oliveira,2007-04-21,Paul Taylor,KO/TKO,0,0,0,0
Achilles Estremadura,2021-11-02,Maheshate,Decision - Unanimous,0,0,0,0
Scott Lighty,2011-04-01,Lorenz Larkin,KO/TKO,0,0,0,0
Jordan Wright,2022-04-23,Marc-Andre Barriault,Submission,0,0,0,0
Jordan Wright,2021-12-11,Bruno Silva,KO/TKO,0,1,0,1
Jordan Wright,2022-10-15,Dusko Todorovic,KO/TKO,0,0,0,0
Jordan Wright,2020-11-21,Joaquin Buckley,KO/TKO,0,0,0,0
Jordan Wright,2021-05-15,Jamie Pickett,KO/TKO,100,22,0,122
Jordan Wright,2023-02-18,Zac Pauga,Decision - Unanimous,0,0,0,0
Jordan Wright,2020-08-22,Ike Villanueva,TKO - Doctor's Stoppage,0,8,0,8
Robbie Ring,2023-08-22,Luis Pajuelo,KO/TKO,0,0,0,0
Francisco Bueno,1999-11-21,Igor Vovchanchyn,KO/TKO,0,0,0,0
Francisco Bueno,1999-04-29,Satoshi Honma,KO/TKO,100,9,0,109
Baru Harn,2011-09-24,Ikuhisa Minowa,Submission,0,0,0,0
Bob Sapp,2002-04-28,Yoshihisa Yamamoto,KO/TKO,100,14,0,114
Bob Sapp,2008-12-31,Akihito Tanaka,KO/TKO,100,10,0,110
Bob Sapp,2002-08-28,Antonio Rodrigo Nogueira,Submission,0,24,0,24
Bob Sapp,2008-02-23,Jan Nortje,KO/TKO,0,0,0,0
Bob Sapp,2009-10-06,Rameau Thierry Sokoudjou,KO/TKO,0,0,0,0
Bob Sapp,2002-06-23,Kiyoshi Tamura,KO/TKO,100,1,0,101
Bob Sapp,2009-05-26,Ikuhisa Minowa,Submission,0,3,0,3
Masanori Suda,2005-09-25,Murilo Bustamante,Submission,0,2,0,2
Sangwook Kim,2023-05-28,Kazuma Maruyama,Submission,90,0,0,90
Sangwook Kim,2023-08-27,Rongzhu,Decision - Unanimous,0,0,0,0
Kazuma Maruyama,2023-05-28,Sangwook Kim,Submission,0,5,0,5
Mario Piazzon,2023-09-26,Alexander Soldatkin,DQ,0,2,0,2
Alexander Soldatkin,2023-09-26,Mario Piazzon,DQ,0,0,0,0
Chad Hanekom,2023-09-05,Dylan Budka,Decision - Unanimous,0,0,0,0
Amilcar Alves,2011-01-22,Charlie Brenneman,Decision - Unanimous,0,0,0,0
Amilcar Alves,2010-08-28,Mike Pierce,Submission,0,0,0,0
Nikolas Motta,2023-06-17,Manuel Torres,KO/TKO,0,0,0,0
Nikolas Motta,2022-02-19,Jim Miller,KO/TKO,0,0,0,0
Nikolas Motta,2022-09-17,Cameron VanCamp,KO/TKO,100,9,0,109
Nikolas Motta,2024-11-23,Maheshate,Decision - Unanimous,80,22,0,102
Nikolas Motta,2020-11-10,Joe Lowry,Decision - Unanimous,80,0,0,80
Nikolas Motta,2024-01-13,Tom Nolan,KO/TKO,100,9,0,109
Stephen Bass,2011-12-03,Marcus Brimage,Decision - Unanimous,0,0,0,0
SeungGuk Choi,2023-02-04,HyunSung Park,Submission,0,0,0,0
SeungGuk Choi,2023-08-27,Jiniushiyue,Decision - Unanimous,0,0,0,0
SeungGuk Choi,2022-10-23,Qiu Lun,Decision - Unanimous,80,0,0,80
SeungGuk Choi,2023-05-27,Sumit Kumar,Decision - Unanimous,80,28,0,108
SeungGuk Choi,2022-06-09,Rama Supandhi,Decision - Unanimous,80,20,0,100
Luis Saldana,2022-03-26,Bruno Souza,Decision - Unanimous,80,18,0,98
Luis Saldana,2021-04-10,Jordan Griffin,Decision - Unanimous,80,3,0,83
Luis Saldana,2020-11-04,Vince Murdock,KO/TKO,100,64,0,164
Luis Saldana,2021-08-21,Austin Lingo,Decision - Unanimous,0,4,0,4
Bruno Souza,2022-03-26,Luis Saldana,Decision - Unanimous,0,0,0,0
Bruno Souza,2021-11-06,Melsik Baghdasaryan,Decision - Unanimous,0,0,0,0
Ben Askren,2019-03-02,Robbie Lawler,Submission,90,0,0,90
Ben Askren,2019-07-06,Jorge Masvidal,KO/TKO,0,0,0,0
Ben Askren,2019-10-26,Demian Maia,Submission,0,0,25,25
Carlos Barreto,2000-06-04,Tra Telligman,Decision - Unanimous,80,7,0,87
Carlos Barreto,1999-07-04,Igor Vovchanchyn,Decision - Unanimous,0,0,0,0
Carlos Barreto,1997-10-17,Dave Beneteau,Decision - Unanimous,0,0,0,0
Joey Gilbert,2001-05-04,BJ Penn,KO/TKO,0,0,0,0
Mark Madsen,2019-09-28,Danilo Belluardo,KO/TKO,100,22,0,122
Mark Madsen,2020-03-07,Austin Hubbard,Decision - Unanimous,80,0,0,80
Mark Madsen,2023-11-11,Jared Gordon,KO/TKO,0,0,0,0
Mark Madsen,2021-08-21,Clay Guida,Decision - Split,70,26,0,96
Mark Madsen,2022-04-09,Vinc Pichel,Decision - Unanimous,80,0,0,80
Mark Madsen,2022-11-05,Grant Dawson,Submission,0,0,0,0
Igor Borisov,2000-08-27,Mark Kerr,Submission,0,0,0,0
Brady Huang,2020-08-11,Adrian Yanez,KO/TKO,0,0,0,0
Viktor Pesta,2015-01-24,Konstantin Erokhin,Decision - Unanimous,80,18,0,98
Viktor Pesta,2016-08-06,Marcin Tybura,KO/TKO,0,0,0,0
Viktor Pesta,2014-05-31,Ruslan Magomedov,Decision - Unanimous,0,0,0,0
Viktor Pesta,2015-10-03,Derrick Lewis,KO/TKO,0,0,0,0
Viktor Pesta,2017-01-15,Aleksei Oleinik,Submission,0,0,0,0
Adam Milstead,2016-05-29,Chris de la Rocha,KO/TKO,100,19,0,119
Adam Milstead,2018-03-03,Jordan Johnson,Decision - Split,0,0,0,0
Adam Milstead,2018-12-15,Mike Rodriguez,KO/TKO,0,0,0,0
Lowell Anderson,1999-09-24,John Lewis,KO/TKO,0,0,0,0
Juan Mott,1998-03-05,Akira Shoji,Submission,0,0,0,0
Rob Yundt,2008-02-02,Ricardo Almeida,Submission,0,0,0,0
Rob Yundt,2008-06-21,Rob Kimmons,Submission,0,0,0,0
Tuco Tokkos,2022-06-09,Zhang Mingyang,KO/TKO,0,0,0,0
Tuco Tokkos,2024-05-18,Oumar Sy,Submission,0,3,0,3
Tuco Tokkos,2024-12-14,Navajo Stirling,Decision - Unanimous,0,0,0,0
Damian Stasiak,2017-05-28,Pedro Munhoz,Decision - Unanimous,0,0,0,0
Damian Stasiak,2017-10-21,Brian Kelleher,KO/TKO,0,0,0,0
Damian Stasiak,2018-07-22,Pingyuan Liu,Decision - Unanimous,0,0,0,0
Damian Stasiak,2015-04-11,Yaotzin Meza,Decision - Unanimous,0,0,0,0
Damian Stasiak,2016-10-08,Davey Grant,Submission,90,0,0,90
Damian Stasiak,2016-04-10,Filip Pejic,Submission,90,2,0,92
Bassil Hafez,2024-11-16,Oban Elliott,KO/TKO,0,0,0,0
Bassil Hafez,2024-06-01,Mickey Gall,Decision - Unanimous,80,12,0,92
Bassil Hafez,2023-07-15,Jack Della Maddalena,Decision - Split,0,0,0,0
Willie Gates,2015-07-12,Darrell Montague,KO/TKO,100,15,0,115
Willie Gates,2015-08-08,Dustin Ortiz,KO/TKO,0,0,0,0
Willie Gates,2014-12-13,John Moraga,Submission,0,0,0,0
Willie Gates,2016-05-08,Yuta Sasaki,Submission,0,6,0,6
Brett Rogers,2010-05-15,Alistair Overeem,KO/TKO,0,0,25,25
Brett Rogers,2011-06-18,Josh Barnett,Submission,0,0,0,0
Brett Rogers,2009-11-07,Fedor Emelianenko,KO/TKO,0,1,0,1
Brett Rogers,2009-06-06,Andrei Arlovski,KO/TKO,100,1,0,101
Brett Rogers,2009-04-11,Abongo Humphrey,KO/TKO,100,32,0,132
Brett Rogers,2008-05-31,Jon Murphy,KO/TKO,100,5,0,105
Brett Rogers,2008-02-16,James Thompson,KO/TKO,100,6,0,106
Cam Teague,2024-09-24,Kevin Vallejos,KO/TKO,0,0,0,0
Ho Bae Myeon,2009-10-25,Marius Zaromskis,KO/TKO,0,0,0,0
Milco Voorn,2005-10-09,Mark Coleman,Submission,0,0,0,0
Tony Sims,2015-08-23,Olivier Aubin-Mercier,Decision - Unanimous,0,20,0,20
Tony Sims,2015-06-27,Steve Montgomery,KO/TKO,100,1,0,101
Tony Sims,2016-01-02,Abel Trujillo,Submission,0,1,0,1
Yuri Villefort,2013-09-04,Sean Spencer,Decision - Split,0,0,0,0
Yuri Villefort,2013-02-23,Nah-Shon Burrell,Decision - Unanimous,0,0,0,0
Yuri Villefort,2012-05-19,Quinn Mulhern,Decision - Split,0,2,0,2
Damien Brown,2016-03-19,Alan Patrick,Decision - Unanimous,0,0,0,0
Damien Brown,2017-11-18,Frank Camacho,Decision - Split,0,0,0,0
Damien Brown,2018-02-10,Dong Hyun Ma,Decision - Split,0,0,0,0
Damien Brown,2016-11-26,Jon Tuck,Decision - Split,70,0,0,70
Damien Brown,2017-06-10,Vinc Pichel,KO/TKO,0,2,0,2
Damien Brown,2016-07-30,Cesar Arzamendia,KO/TKO,100,5,0,105
Tony Sylvester,2009-10-17,Alistair Overeem,Submission,0,0,0,0
Dileno Lopes,2016-07-07,Anthony Birchak,Decision - Split,0,0,0,0
Dileno Lopes,2015-08-01,Reginaldo Vieira,Decision - Unanimous,0,0,0,0
Curtis Millender,2018-07-07,Max Griffin,Decision - Unanimous,80,0,0,80
Curtis Millender,2019-03-09,Elizeu Zaleski dos Santos,Submission,0,0,0,0
Curtis Millender,2018-12-29,Siyar Bahadurzada,Decision - Unanimous,80,49,0,129
Curtis Millender,2018-02-18,Thiago Alves,KO/TKO,100,14,0,114
Curtis Millender,2019-04-13,Belal Muhammad,Decision - Unanimous,0,1,0,1
Julia Budd,2011-01-07,Amanda Nunes,KO/TKO,0,0,0,0
Julia Budd,2011-06-24,Germaine de Randamie,Decision - Unanimous,80,0,0,80
Julia Budd,2011-11-18,Ronda Rousey,Submission,0,1,0,1
Jorge Ortiz,2006-03-10,Eugene Jackson,Decision - Unanimous,0,11,0,11
Mike Joy,2006-07-28,Robert Densley,Submission,90,0,0,90
Mike Joy,2007-01-20,Richard Crunkilton,Submission,0,0,0,0
Robert Densley,2006-07-28,Mike Joy,Submission,0,7,0,7
Carlos Huachin,2019-09-21,Jose Quinonez,Decision - Unanimous,0,0,0,0
Carlos Huachin,2019-05-11,Raoni Barcelos,KO/TKO,0,0,0,0
Joe Cason,2011-07-22,Ovince Saint Preux,KO/TKO,0,0,0,0
Osamu Tachihikari,2000-01-30,Gary Goodridge,Submission,0,0,0,0
Jonavin Webb,2016-02-21,Nathan Coy,Decision - Unanimous,0,0,0,0
Jonavin Webb,2015-05-09,Kyle Noke,Decision - Split,0,0,0,0
Tae Hyun Lee,2008-06-15,Alistair Overeem,KO/TKO,0,0,0,0
Tae Hyun Lee,2006-09-10,Ricardo Morais,KO/TKO,0,0,0,0
Dan Lauzon,2006-10-14,Spencer Fisher,KO/TKO,0,0,0,0
Dan Lauzon,2009-01-24,Bobby Green,Submission,90,0,0,90
Dan Lauzon,2010-01-02,Cole Miller,Submission,0,0,0,0
Dan Lauzon,2010-05-29,Efrain Escudero,Decision - Unanimous,0,0,0,0
Dequan Townsend,2020-02-15,Devin Clark,Decision - Unanimous,0,0,0,0
Dequan Townsend,2019-06-29,Dalcha Lungiambula,KO/TKO,0,0,0,0
Dequan Townsend,2020-01-25,Bevon Lewis,Decision - Unanimous,0,0,0,0
Dequan Townsend,2020-10-03,Dusko Todorovic,KO/TKO,0,0,0,0
Carlton Minus,2020-08-22,Matthew Semelsberger,Decision - Unanimous,0,0,0,0
Carlton Minus,2020-12-19,Christos Giagos,Decision - Unanimous,0,0,0,0
Ernesta Kareckaite,2023-09-26,Carli Judice,Decision - Split,70,16,0,86
Ernesta Kareckaite,2024-05-04,Dione Barbosa,Decision - Unanimous,0,14,0,14
Carli Judice,2023-09-26,Ernesta Kareckaite,Decision - Split,0,0,0,0
Carli Judice,2024-06-15,Gabriella Fernandes,Decision - Split,0,50,0,50
Brian Houston,2014-01-15,Trevor Smith,Decision - Split,0,0,0,0
Brian Houston,2013-11-06,Derek Brunson,Submission,0,0,0,0
Nayara Maia,2022-09-06,Tereza Bleda,Decision - Unanimous,0,0,0,0
Dennis Reed,2000-06-29,Rich Franklin,Submission,0,1,0,1
Leon Aliu,2022-09-20,Brunno Ferreira,KO/TKO,0,0,0,0
Shelton Graves,2017-08-08,Everett Sims,KO/TKO,100,17,0,117
Everett Sims,2017-08-08,Shelton Graves,KO/TKO,0,0,0,0
Kenneth Alexander,2008-06-01,Rob McCullough,Decision - Split,0,0,0,0
Felipe dos Santos,2024-02-24,Victor Altamirano,Decision - Split,70,0,0,70
Felipe dos Santos,2024-09-07,Andre Lima,Decision - Unanimous,0,20,0,20
Felipe dos Santos,2023-09-09,Manel Kape,Decision - Unanimous,0,0,0,0
Victor Altamirano,2024-02-24,Felipe dos Santos,Decision - Split,0,3,0,3
Victor Altamirano,2021-08-31,Carlos Candelario,Decision - Split,70,27,0,97
Victor Altamirano,2023-06-03,Tim Elliott,Decision - Unanimous,0,0,0,0
Victor Altamirano,2023-03-25,Vinicius Salvador,Decision - Unanimous,80,15,0,95
Victor Altamirano,2024-09-28,Daniel Barez,Decision - Unanimous,0,4,0,4
Victor Altamirano,2022-02-26,Carlos Hernandez,Decision - Split,0,0,0,0
Victor Altamirano,2022-08-20,Daniel Lacerda,KO/TKO,100,36,0,136
Abel Cullum,2009-05-26,Hideo Tokoro,Submission,0,0,0,0
Abel Cullum,2009-03-08,Akiyo Nishiura,Decision - Unanimous,80,9,0,89
Abel Cullum,2011-09-24,Masakazu Imanari,Submission,0,18,0,18
Askar Mozharov,2022-06-04,Alonzo Menifield,KO/TKO,0,0,0,0
Rory Markham,2009-02-21,Dan Hardy,KO/TKO,0,0,0,0
Rory Markham,2008-07-19,Brodie Farber,KO/TKO,100,0,0,100
Rory Markham,2010-03-27,Nate Diaz,KO/TKO,0,0,0,0
Joe Slick,2000-04-14,Ikuhisa Minowa,TKO - Doctor's Stoppage,0,5,0,5
Joe Slick,1999-11-19,Jason DeLucia,KO/TKO,100,1,0,101
Michael Kuiper,2012-08-11,Jared Hamman,KO/TKO,100,0,0,100
Michael Kuiper,2012-02-04,Rafael Natal,Decision - Unanimous,0,0,0,0
Michael Kuiper,2013-10-26,Brad Scott,Submission,0,0,0,0
Michael Kuiper,2013-04-06,Tom Lawlor,Submission,0,7,0,7
Shannon Gugerty,2010-03-21,Clay Guida,Submission,0,0,0,0
Shannon Gugerty,2008-07-19,Dale Hartt,Submission,90,2,0,92
Shannon Gugerty,2008-10-25,Spencer Fisher,Submission,0,0,0,0
Shannon Gugerty,2009-07-11,Matt Grice,Submission,90,0,0,90
Shannon Gugerty,2009-11-14,Terry Etim,Submission,0,0,0,0
Rostem Akman,2019-06-01,Sergey Khandozhko,Decision - Unanimous,0,0,0,0
Rostem Akman,2019-10-05,Jake Matthews,Decision - Unanimous,0,0,0,0
Mike Hayes,2008-02-23,Matt Kovacs,Decision - Unanimous,80,51,0,131
Matt Kovacs,2008-02-23,Mike Hayes,Decision - Unanimous,0,0,0,0
Danny Chavez,2021-02-20,Jared Gordon,Decision - Unanimous,0,0,0,0
Danny Chavez,2020-08-15,TJ Brown,Decision - Unanimous,80,6,0,86
Danny Chavez,2022-06-18,Ricardo Ramos,KO/TKO,0,0,0,0
Dave Dalgliesh,2006-09-27,Thiago Silva,Submission,0,0,0,0
Paul Creighton,2002-05-10,BJ Penn,KO/TKO,0,0,0,0
Nate James,2011-11-18,Derek Brunson,Decision - Unanimous,0,0,0,0
Angelo Antonio,2003-05-16,Mauricio Rua,KO/TKO,0,0,0,0
Eric Schambari,2007-12-12,Bryan Baker,Decision - Split,0,0,0,0
Eric Schambari,2007-08-05,Logan Clark,Decision - Unanimous,80,14,0,94
Cody East,2016-04-23,Walt Harris,KO/TKO,0,0,0,0
Cody East,2016-10-01,Curtis Blaydes,KO/TKO,0,0,0,0
Ibo Aslan,2023-08-15,Paulo Renato Junior,KO/TKO,100,13,0,113
Ibo Aslan,2024-10-26,Rafael Cerqueira,KO/TKO,100,27,0,127
Ibo Aslan,2024-03-30,Anton Turkalj,KO/TKO,100,19,0,119
Mike Rio,2013-05-18,Francisco Trinaldo,Submission,0,0,0,0
Mike Rio,2012-12-15,John Cofer,Submission,90,0,0,90
Mike Rio,2013-10-19,Tony Ferguson,Submission,0,0,0,0
Mike Rio,2014-01-25,Daron Cruickshank,KO/TKO,0,0,0,0
Aaron Brink,2000-11-17,Andrei Arlovski,Submission,0,0,0,0
Sasha Palatnikov,2020-11-21,Louis Cosce,KO/TKO,100,26,0,126
Sasha Palatnikov,2021-08-21,Ramiz Brahimaj,Submission,0,0,0,0
Sasha Palatnikov,2021-04-10,Impa Kasanganay,Submission,0,0,0,0
Jon Manley,2013-02-23,Neil Magny,Decision - Unanimous,0,0,0,0
Akihito Tanaka,2008-12-31,Bob Sapp,KO/TKO,0,0,0,0
Max Mustaki,2018-07-10,Jalin Turner,TKO - Doctor's Stoppage,0,0,0,0
Sarah D'alelio,2011-08-12,Ronda Rousey,Submission,0,1,0,1
Akitoshi Tamura,2008-12-03,Wagnney Fabiano,Submission,0,0,0,0
Akitoshi Tamura,2009-04-05,Manny Tapia,Decision - Unanimous,80,100,0,180
Akitoshi Tamura,2010-01-10,Charlie Valencia,Decision - Split,0,0,0,0
Sam Adkins,1996-02-16,Don Frye,TKO - Doctor's Stoppage,0,0,0,0
Sam Adkins,1996-09-20,David Abbott,Submission,0,0,0,0
Mateo Vogel,2023-08-29,Timmy Cuamba,Decision - Unanimous,0,24,0,24
Royce Alger,1997-05-30,Enson Inoue,Submission,0,3,0,3
Royce Alger,1999-07-16,Eugene Jackson,KO/TKO,0,0,0,0
Khama Worthy,2020-06-27,Luis Pena,Submission,90,17,0,107
Khama Worthy,2021-10-23,Jai Herbert,KO/TKO,0,0,0,0
Khama Worthy,2021-03-27,Jamie Mullarkey,KO/TKO,0,0,0,0
Khama Worthy,2019-08-17,Devonte Smith,KO/TKO,100,6,0,106
Khama Worthy,2020-09-12,Ottman Azaitar,KO/TKO,0,0,0,0
Jason Fairn,1994-12-16,Guy Mezger,KO/TKO,0,0,0,0
Anthony Torres,2007-09-08,Jess Liaudin,KO/TKO,0,0,0,0
Anthony Torres,2006-08-17,Pat Healy,Submission,90,0,0,90
Noad Lahat,2014-03-23,Godofredo Pepey,KO/TKO,0,6,0,6
Noad Lahat,2015-06-20,Niklas Backstrom,Decision - Majority,75,51,0,126
Noad Lahat,2014-07-26,Steven Siler,Decision - Unanimous,80,0,0,80
Noad Lahat,2016-02-06,Diego Rivas,KO/TKO,0,2,0,2
Scott Morris,1994-03-11,Patrick Smith,KO/TKO,0,0,0,0
Scott Morris,1994-03-11,Sean Daugherty,Submission,90,1,0,91
Mark Godbeer,2016-11-19,Justin Ledet,Submission,0,2,0,2
Mark Godbeer,2017-11-04,Walt Harris,DQ,0,0,0,0
Mark Godbeer,2018-03-17,Dmitry Sosnovskiy,Submission,0,0,0,0
Mark Godbeer,2017-03-04,Daniel Spitz,Decision - Unanimous,80,41,0,121
Shane Nelson,2009-12-12,Matt Wiman,Decision - Unanimous,0,0,0,0
Shane Nelson,2009-08-08,Aaron Riley,Decision - Unanimous,0,0,0,0
Shane Nelson,2008-12-13,George Roop,Decision - Split,70,0,0,70
Shane Nelson,2009-03-07,Aaron Riley,KO/TKO,100,1,0,101
Denys Bondar,2023-06-17,Carlos Hernandez,Decision - Unanimous,0,0,0,0
Denys Bondar,2024-02-24,Ronaldo Rodriguez,Submission,0,10,0,10
Denys Bondar,2022-02-05,Malcolm Gordon,KO/TKO,0,1,0,1
Kazuhisa Watanabe,2010-12-31,Hideo Tokoro,Submission,0,0,0,0
Anthony Macias,1999-09-12,Kazushi Sakuraba,Submission,0,0,0,0
Anthony Macias,1995-07-14,Oleg Taktarov,Submission,0,0,0,0
Anthony Macias,1994-12-16,Dan Severn,Submission,0,8,0,8
Yuma Horiuchi,2022-06-10,Top Noi Kiwram,Decision - Unanimous,0,0,0,0
Keith Berry,2012-08-18,Adlan Amagov,KO/TKO,0,0,0,0
Keith Berry,2006-10-12,Terry Martin,KO/TKO,0,0,0,0
Michael Graves,2016-04-16,Randy Brown,Submission,90,1,0,91
Michael Graves,2015-07-12,Vicente Luque,Decision - Unanimous,80,0,0,80
Ramazan Kuramagomedov,2019-07-23,Jordan Williams,Decision - Split,70,38,0,108
Jordan Williams,2019-07-23,Ramazan Kuramagomedov,Decision - Split,0,0,0,0
Jordan Williams,2021-11-06,Ian Machado Garry,KO/TKO,0,4,0,4
Jordan Williams,2020-09-15,Gregory Rodrigues,KO/TKO,100,4,0,104
Jordan Williams,2021-07-24,Mickey Gall,Submission,0,2,0,2
Jordan Williams,2020-10-03,Nassourdine Imavov,Decision - Unanimous,0,0,0,0
Bob Gilstrap,1998-05-15,Carlos Newton,Submission,0,0,0,0
Anton Turkalj,2023-03-11,Vitor Petrino,Decision - Unanimous,0,0,0,0
Anton Turkalj,2024-03-30,Ibo Aslan,KO/TKO,0,0,0,0
Anton Turkalj,2023-09-09,Tyson Pedro,KO/TKO,0,0,0,0
Anton Turkalj,2022-09-10,Jailton Almeida,Submission,0,0,0,0
Anton Turkalj,2022-07-26,Acacio Dos Santos,Decision - Unanimous,80,2,0,82
Justin McElfresh,2007-05-12,Doug Marshall,KO/TKO,0,0,25,25
Justin McElfresh,2007-08-05,Steve Cantwell,KO/TKO,0,0,0,0
Gabe Lemley,2008-03-29,Gilbert Melendez,KO/TKO,0,0,25,25
Logan Clark,2006-12-13,Steve Byrnes,Decision - Unanimous,80,22,0,102
Logan Clark,2007-08-05,Eric Schambari,Decision - Unanimous,0,0,0,0
Logan Clark,2008-03-26,Scott Harper,KO/TKO,100,17,0,117
Logan Clark,2007-01-20,Blas Avena,KO/TKO,100,10,0,110
Steve Byrnes,2006-12-13,Logan Clark,Decision - Unanimous,0,0,0,0
Lee Kwan Bum,2008-03-15,Ikuhisa Minowa,Submission,0,1,0,1
Eric Esch,2007-04-08,Wagner da Conceicao Martins,Submission,90,9,0,99
Eric Esch,2006-08-27,Ikuhisa Minowa,Submission,0,0,0,0
Eric Esch,2006-10-21,Sean O'Haire,KO/TKO,100,7,0,107
Richard Crunkilton,2008-03-26,Sergio Gomez,Decision - Unanimous,80,0,0,80
Richard Crunkilton,2009-10-10,Dave Jansen,Decision - Unanimous,0,13,0,13
Richard Crunkilton,2003-04-25,Hermes Franca,Decision - Unanimous,0,2,0,2
Richard Crunkilton,2007-01-20,Mike Joy,Submission,90,15,0,105
Richard Crunkilton,2007-09-05,Rob McCullough,KO/TKO,0,0,25,25
Richard Crunkilton,2006-01-13,Nick Ertl,KO/TKO,100,0,0,100
Sergio Gomez,2008-03-26,Richard Crunkilton,Decision - Unanimous,0,0,0,0
Sergio Gomez,2007-05-12,Marcus Hicks,Submission,0,8,0,8
Thanh Le,2017-07-18,Lazar Stojadinovic,KO/TKO,100,1,0,101
Lazar Stojadinovic,2017-07-18,Thanh Le,KO/TKO,0,0,0,0
Luke Barnatt,2013-04-13,Collin Hart,Decision - Unanimous,80,18,0,98
Luke Barnatt,2013-10-26,Andrew Craig,Submission,90,13,0,103
Luke Barnatt,2014-11-22,Roger Narvaez,Decision - Split,0,0,0,0
Luke Barnatt,2014-03-08,Mats Nilsson,KO/TKO,100,20,0,120
Luke Barnatt,2015-05-16,Mark Munoz,Decision - Unanimous,0,7,0,7
Luke Barnatt,2014-05-31,Sean Strickland,Decision - Split,0,0,0,0
Collin Hart,2013-04-13,Luke Barnatt,Decision - Unanimous,0,0,0,0
Matt Van Buren,2014-07-06,Corey Anderson,KO/TKO,0,0,0,0
Matt Van Buren,2015-01-18,Sean O'Connell,KO/TKO,0,34,0,34
Daniel Sarafian,2013-06-08,Eddie Mendez,Submission,90,4,0,94
Daniel Sarafian,2014-06-14,Kiichi Kunimoto,Submission,0,0,0,0
Daniel Sarafian,2013-01-19,CB Dollaway,Decision - Split,0,0,0,0
Daniel Sarafian,2014-12-20,Antonio Dos Santos,KO/TKO,100,0,0,100
Daniel Sarafian,2013-11-09,Cezar Ferreira,Decision - Split,0,6,0,6
Daniel Sarafian,2016-02-21,Oluwale Bamgbose,KO/TKO,0,0,0,0
Eddie Mendez,2013-06-08,Daniel Sarafian,Submission,0,0,0,0
Mark Cherico,2017-08-22,Mike Santiago,KO/TKO,0,0,0,0
Mohammed Usman,2023-04-22,Junior Tafa,Decision - Unanimous,80,0,0,80
Mohammed Usman,2024-07-20,Thomas Petersen,Decision - Unanimous,0,0,0,0
Mohammed Usman,2023-09-23,Jake Collier,Decision - Unanimous,80,0,0,80
Mohammed Usman,2022-08-06,Zac Pauga,KO/TKO,100,0,0,100
Mohammed Usman,2024-03-23,Mick Parkin,Decision - Unanimous,0,0,0,0
Joseph Sandoval,2011-10-01,Walel Watson,KO/TKO,0,0,0,0
Joseph Sandoval,2012-01-20,Nick Denis,KO/TKO,0,0,0,0
Randy Costa,2021-12-11,Tony Kelley,KO/TKO,0,0,0,0
Randy Costa,2019-04-13,Brandon Davis,Submission,0,11,0,11
Randy Costa,2022-10-01,Guido Cannetti,Submission,0,0,0,0
Randy Costa,2021-07-24,Adrian Yanez,KO/TKO,0,5,0,5
Randy Costa,2020-09-19,Journey Newson,KO/TKO,100,3,0,103
Randy Costa,2019-10-18,Boston Salmon,KO/TKO,100,10,0,110
Rei Tsuruya,2023-05-27,Ronal Siahaan,Submission,90,35,0,125
Rei Tsuruya,2024-06-29,Carlos Hernandez,Decision - Unanimous,80,1,0,81
Rei Tsuruya,2024-02-03,Jiniushiyue,KO/TKO,100,12,0,112
Rei Tsuruya,2023-08-27,Mark Climaco,Decision - Unanimous,80,0,0,80
Ronal Siahaan,2023-05-27,Rei Tsuruya,Submission,0,0,0,0
Jason Saggo,2016-12-10,Rustam Khabilov,Decision - Unanimous,0,0,0,0
Jason Saggo,2016-03-05,Justin Salas,KO/TKO,100,19,0,119
Jason Saggo,2014-10-04,Paul Felder,Decision - Split,0,0,0,0
Jason Saggo,2014-06-14,Josh Shockley,KO/TKO,100,4,0,104
Jason Saggo,2017-09-16,Gilbert Burns,KO/TKO,0,0,0,0
Jason Saggo,2016-06-18,Leandro Silva,Decision - Split,70,1,0,71
Mike Lullo,2010-11-20,Edson Barboza,KO/TKO,0,0,0,0
Mike Lullo,2011-09-17,Robert Peralta,Decision - Unanimous,0,0,0,0
Manny Vazquez,2017-07-11,Joby Sanchez,Decision - Unanimous,0,0,0,0
Karine Gevorgyan,2017-12-01,Rachael Ostovich,Submission,0,0,0,0
Hector Sandoval,2016-07-30,Wilson Reis,Submission,0,1,0,1
Hector Sandoval,2016-12-17,Fredy Serrano,Decision - Unanimous,80,11,0,91
Hector Sandoval,2017-04-22,Matt Schnell,KO/TKO,100,16,0,116
Hector Sandoval,2017-08-05,Dustin Ortiz,KO/TKO,0,0,0,0
Jack Morrison,2006-07-28,Glover Teixeira,Submission,0,0,0,0
Kaleio Romero,2022-07-26,Dennis Buzukja,Decision - Unanimous,0,0,0,0
Deividas Taurosevicius,2009-10-10,Javier Vazquez,Decision - Split,70,2,0,72
Deividas Taurosevicius,2010-01-10,Mackens Semerzier,Decision - Unanimous,80,6,0,86
Deividas Taurosevicius,2010-03-06,LC Davis,Decision - Majority,0,6,0,6
Carlos Prates,2024-06-08,Charles Radtke,KO/TKO,100,1,0,101
Carlos Prates,2024-11-09,Neil Magny,KO/TKO,100,2,25,127
Carlos Prates,2024-08-17,Li Jingliang,KO/TKO,100,14,0,114
Carlos Prates,2024-02-10,Trevin Giles,KO/TKO,100,0,0,100
Carlos Prates,2023-08-29,Mitch Ramirez,KO/TKO,100,7,0,107
Charles Radtke,2024-06-08,Carlos Prates,KO/TKO,0,0,0,0
Charles Radtke,2024-11-09,Matthew Semelsberger,KO/TKO,100,5,0,105
Charles Radtke,2023-09-09,Blood Diamond,Decision - Unanimous,80,0,0,80
Charles Radtke,2024-02-03,Gilbert Urbina,KO/TKO,100,14,0,114
Rex Holman,2007-03-03,Matt Hamill,KO/TKO,0,0,0,0
Taneisha Tennant,2020-09-15,Danyelle Wolf,Decision - Unanimous,0,34,0,34
Jose Henrique,2022-08-30,Yusaku Kinoshita,KO/TKO,0,0,0,0
Dan Evensen,2008-12-27,Pat Barry,KO/TKO,0,0,0,0
Dan Evensen,2008-08-09,Cheick Kongo,KO/TKO,0,0,0,0
Bob Schrijber,2000-01-30,Wanderlei Silva,Submission,0,0,0,0
Bob Schrijber,1999-09-12,Daijiro Matsui,DQ,0,6,0,6
Ivan Lopez,2009-04-05,Dominick Cruz,Decision - Unanimous,0,0,0,0
Amar Suloev,2006-08-27,Denis Kang,Submission,0,0,0,0
Amar Suloev,2002-05-10,Phil Baroni,KO/TKO,0,0,0,0
Amar Suloev,2004-07-19,Dean Lister,Decision - Split,70,8,0,78
Amar Suloev,2006-06-04,Murilo Bustamante,Decision - Unanimous,80,15,0,95
Amar Suloev,2002-01-11,Chuck Liddell,Decision - Unanimous,0,0,0,0
Amar Suloev,2005-04-03,Paulo Filho,Submission,0,0,0,0
Marcos Brigagao,2019-08-20,Jamal Pogues,Decision - Unanimous,0,0,0,0
Craig Zellner,2007-06-03,Brian Stann,KO/TKO,0,0,0,0
Alexandre Dantas,2000-09-22,Yuki Kondo,KO/TKO,0,0,0,0
Alexandre Dantas,2003-02-28,Gan McGee,KO/TKO,0,0,0,0
Koyomi Matsushima,2022-10-23,Yizha,Decision - Split,0,0,0,0
Koyomi Matsushima,2022-06-09,JunYoung Hong,Decision - Split,70,0,0,70
Kaitlin Young,2008-05-31,Gina Carano,TKO - Doctor's Stoppage,0,0,0,0
Cameron VanCamp,2022-09-17,Nikolas Motta,KO/TKO,0,0,0,0
Cameron VanCamp,2022-05-07,Andre Fialho,KO/TKO,0,2,0,2
Ivan Erslan,2024-09-28,Ion Cutelaba,Decision - Split,0,0,0,0
Pedro Falcao,2021-10-19,James Barnes,KO/TKO,100,34,0,134
Pedro Falcao,2024-04-06,Victor Hugo,Decision - Unanimous,0,0,0,0
James Barnes,2021-10-19,Pedro Falcao,KO/TKO,0,0,0,0
John Cofer,2012-12-15,Mike Rio,Submission,0,1,0,1
John Cofer,2012-06-01,Justin Lawrence,KO/TKO,0,0,0,0
Ralph Dillon,2004-07-14,Rich Franklin,Submission,0,0,0,0
Anton Berzin,2017-08-22,Kennedy Nzechukwu,Decision - Split,0,0,0,0
Jeremiah Billington,2007-09-05,Brian Stann,KO/TKO,0,0,0,0
Malik Lewis,2023-09-12,James Llontop,Decision - Unanimous,0,0,0,0
Malik Lewis,2022-09-13,Trevor Peek,KO/TKO,0,11,0,11
Raphael Pessoa,2020-07-25,Tanner Boser,KO/TKO,0,0,0,0
Raphael Pessoa,2019-10-26,Jeff Hughes,Decision - Unanimous,80,5,0,85
Raphael Pessoa,2019-08-10,Ciryl Gane,Submission,0,0,0,0
John Allan,2021-11-06,Dustin Jacoby,Decision - Unanimous,0,0,0,0
John Allan,2018-08-12,Vinicius Moreira,Submission,0,0,0,0
John Allan,2020-12-05,Roman Dolidze,Decision - Split,0,0,0,0
Marcus McGhee,2023-04-29,Journey Newson,Submission,90,12,0,102
Marcus McGhee,2023-08-12,JP Buys,KO/TKO,100,3,0,103
Marcus McGhee,2024-11-16,Jonathan Martinez,Decision - Unanimous,80,54,0,134
Marcus McGhee,2024-01-13,Gaston Bolanos,KO/TKO,100,37,0,137
John Matua,1995-07-14,David Abbott,KO/TKO,0,0,0,0
Emmanuel Yarborough,1994-09-09,Keith Hackney,KO/TKO,0,0,0,0
Emmanuel Yarborough,1998-06-24,Daiju Takase,KO/TKO,0,0,0,0
Chris Mickle,2009-03-01,Jose Aldo,KO/TKO,0,0,0,0
Yokthai Sithoar,2010-10-24,Shinya Aoki,Submission,0,0,0,0
Claudionor Fontinelle,2000-12-16,Anderson Silva,KO/TKO,0,0,0,0
Justin Burlinson,2021-11-02,Yohan Lainesse,KO/TKO,0,0,0,0
Darian Weeks,2022-09-10,Yohan Lainesse,Decision - Split,0,21,0,21
Darian Weeks,2021-12-04,Bryan Barberena,Decision - Unanimous,0,10,0,10
Darian Weeks,2022-04-09,Ian Machado Garry,Decision - Unanimous,0,0,0,0
Daniel Puder,2006-12-08,Mike Cook,Submission,90,5,0,95
Daniel Puder,2006-03-10,Jesse Fujarczyk,Submission,90,3,0,93
Daniel Puder,2006-06-09,Tom Tuggle,Submission,90,1,0,91
Daniel Puder,2007-09-29,Richard Dalton,Decision - Unanimous,80,31,0,111
John Hosman,2009-08-09,Rani Yahya,Submission,0,0,0,0
John Hosman,2009-12-19,Chad George,Decision - Unanimous,0,0,0,0
Ron Stallings,2015-09-05,Joe Riggs,DQ,0,0,0,0
Ron Stallings,2015-01-18,Uriah Hall,TKO - Doctor's Stoppage,0,0,0,0
Ron Stallings,2015-04-04,Justin Jones,Decision - Unanimous,80,27,0,107
Gerry Harris,1995-09-08,Paul Varelans,KO/TKO,0,0,0,0
Justin Gonzales,2019-06-25,Zach Zane,Decision - Unanimous,80,87,0,167
Zach Zane,2019-06-25,Justin Gonzales,Decision - Unanimous,0,0,0,0
Matej Penaz,2022-08-30,Sedriques Dumas,Submission,0,0,0,0
Jose Torres,2018-08-04,Alex Perez,KO/TKO,0,0,0,0
Jose Torres,2018-06-01,Jarred Brooks,KO/TKO,100,0,0,100
Michel Batista,2018-11-30,Maurice Greene,Submission,0,0,0,0
Adrian Serrano,2000-06-09,Shonie Carter,Decision - Unanimous,0,0,0,0
Brandon Jenkins,2021-09-18,Rongzhu,KO/TKO,0,0,0,0
Brandon Jenkins,2022-04-16,Drakkar Klose,KO/TKO,0,0,0,0
Jason Gilliam,2007-03-03,Jamie Varner,Submission,0,0,0,0
Jason Gilliam,2007-07-07,Chris Lytle,Submission,0,0,0,0
Chibwikem Onyenegecha,2018-07-17,Anthony Adams,Decision - Split,70,33,0,103
Anthony Adams,2018-07-17,Chibwikem Onyenegecha,Decision - Split,0,0,0,0
Anthony Adams,2020-08-11,Impa Kasanganay,Decision - Unanimous,0,0,0,0
Sean Sharaf,2024-10-12,Junior Tafa,KO/TKO,0,0,0,0
Mike Stumpf,2013-01-26,Pascal Krauss,Decision - Unanimous,0,0,0,0
Mike Stumpf,2011-09-17,TJ Waldburger,Submission,0,0,0,0
Themba Gorimbo,2023-05-20,Takashi Sato,Decision - Unanimous,80,3,0,83
Themba Gorimbo,2024-10-12,Niko Price,Decision - Unanimous,80,52,0,132
Themba Gorimbo,2024-02-03,Pete Rodriguez,KO/TKO,100,12,0,112
Themba Gorimbo,2024-12-07,Vicente Luque,Submission,0,3,0,3
Themba Gorimbo,2023-02-18,AJ Fletcher,Submission,0,0,0,0
Themba Gorimbo,2024-05-18,Ramiz Brahimaj,Decision - Unanimous,80,40,0,120
Rocky Lee,2015-04-11,Taylor Lapilus,Decision - Unanimous,0,0,0,0
Daniel Santos,2023-06-03,Johnny Munoz,Decision - Unanimous,80,32,0,112
Daniel Santos,2022-10-01,John Castaneda,KO/TKO,100,12,0,112
Daniel Santos,2022-04-09,Julio Arce,Decision - Unanimous,0,0,0,0
Roman Zentsov,2006-05-05,Gilbert Yvel,KO/TKO,100,5,0,105
Roman Zentsov,2005-08-28,Fabricio Werdum,Submission,0,1,0,1
Roman Zentsov,2006-02-26,Pedro Rizzo,KO/TKO,100,0,0,100
Michael Trizano,2022-02-05,Hakeem Dawodu,Decision - Unanimous,0,0,0,0
Michael Trizano,2022-11-12,SeungWoo Choi,KO/TKO,100,6,0,106
Michael Trizano,2021-05-08,Ludovit Klein,Decision - Unanimous,80,11,0,91
Michael Trizano,2019-05-18,Grant Dawson,Submission,0,0,0,0
Michael Trizano,2022-06-04,Lucas Almeida,KO/TKO,0,0,0,0
Michael Trizano,2018-11-10,Luis Pena,Decision - Split,70,28,0,98
Michael Trizano,2018-07-06,Joe Giannetti,Decision - Split,70,13,0,83
Cesar Arzamendia,2015-11-21,Marco Polo Reyes,KO/TKO,0,6,0,6
Cesar Arzamendia,2016-07-30,Damien Brown,KO/TKO,0,0,0,0
Jeff Newton,2005-11-19,Sam Hoger,Submission,0,0,0,0
Pete Rodriguez,2022-10-15,Mike Jackson,KO/TKO,100,12,0,112
Pete Rodriguez,2024-02-03,Themba Gorimbo,KO/TKO,0,0,0,0
Pete Rodriguez,2022-01-22,Jack Della Maddalena,KO/TKO,0,0,0,0
Damian Grabowski,2016-07-30,Anthony Hamilton,KO/TKO,0,0,0,0
Damian Grabowski,2016-02-06,Derrick Lewis,KO/TKO,0,0,0,0
Damian Grabowski,2017-07-22,Chase Sherman,Decision - Unanimous,0,0,0,0
Scott Graham,2006-06-09,Jared Hamman,KO/TKO,0,0,0,0
Ken Kaneko,2005-12-31,Charles Bennett,Submission,0,0,0,0
Joao Roque,2000-06-09,Jens Pulver,Decision - Unanimous,0,1,0,1
Stefan Klever,2005-10-09,Gegard Mousasi,KO/TKO,0,0,0,0
Siala Siliga,2010-03-22,Josh Barnett,Submission,0,0,0,0
Siala Siliga,2008-12-31,Semmy Schilt,Submission,0,0,0,0
Bahatebole Batebolati,2024-05-18,HanSeul Kim,Decision - Unanimous,80,0,0,80
Bahatebole Batebolati,2023-05-28,WonBin Ki,DQ,0,0,0,0
Mike Seal,2006-06-09,Eugene Jackson,KO/TKO,0,17,0,17
Julius Anglickas,2019-08-13,Karl Reed,Submission,90,37,0,127
Karl Reed,2019-08-13,Julius Anglickas,Submission,0,0,0,0
Karl Reed,2017-08-15,Cameron Olson,Decision - Unanimous,0,0,0,0
Kazuki Okubo,2005-07-17,Ryuichi Murata,Submission,90,10,0,100
Kazuki Okubo,2002-12-23,Daijiro Matsui,Decision - Unanimous,0,0,0,0
Ryuichi Murata,2005-07-17,Kazuki Okubo,Submission,0,0,0,0
Lumumba Sayers,2012-03-03,Scott Smith,Submission,90,8,0,98
Lumumba Sayers,2011-11-18,Antwain Britt,KO/TKO,100,4,0,104
Lumumba Sayers,2012-08-18,Anthony Smith,Submission,0,0,0,0
Magomed Gadzhiyasulov,2023-10-03,Jose Daniel Medina,Decision - Unanimous,80,49,0,129
Magomed Gadzhiyasulov,2024-06-22,Brendson Ribeiro,Decision - Majority,75,9,0,84
Mando Gutierrez,2022-09-20,Raul Rosas Jr.,Decision - Unanimous,0,0,0,0
Ryan Stonitsch,2008-03-26,Alex Serdyukov,Submission,0,0,0,0
Nik Theotikos,2008-11-21,Luke Rockhold,Submission,0,0,0,0
Rico DiSciullo,2018-06-12,Montel Jackson,KO/TKO,0,0,0,0
Marcelo Guimaraes,2012-07-11,Dan Stittgen,Decision - Split,70,14,0,84
Marcelo Guimaraes,2013-03-02,Hyun Gyu Lim,KO/TKO,0,0,0,0
Marcelo Guimaraes,2016-03-05,Vitor Miranda,KO/TKO,0,0,0,0
Marcelo Guimaraes,2014-06-28,Andy Enz,Decision - Split,70,36,0,106
Dan Stittgen,2012-07-11,Marcelo Guimaraes,Decision - Split,0,0,0,0
Dan Stittgen,2012-02-04,Stephen Thompson,KO/TKO,0,0,0,0
Stephen Regman,2019-07-16,Antonio Arroyo,Submission,0,0,0,0
Paul Herrera,1996-02-16,Gary Goodridge,KO/TKO,0,0,0,0
Rafael Alves,2021-05-22,Damir Ismagulov,Decision - Unanimous,0,0,0,0
Rafael Alves,2022-07-30,Drew Dober,KO/TKO,0,0,0,0
Rafael Alves,2021-11-13,Marc Diakiese,Submission,90,3,0,93
Rafael Alves,2020-08-25,Alejandro Flores,Submission,90,0,0,90
Rafael Alves,2023-02-25,Nurullo Aliev,Decision - Majority,0,0,0,0
Achmed Labasanov,2002-06-23,Gary Goodridge,Decision - Split,0,0,0,0
Tom Murphy,2006-03-04,Icho Larenas,KO/TKO,100,28,0,128
Icho Larenas,2006-03-04,Tom Murphy,KO/TKO,0,0,0,0
Edson Drago,2007-04-08,Yoshihiro Nakao,Submission,0,0,0,0
Edson Drago,2006-07-01,Pawel Nastula,Submission,0,0,0,0
Renato Verissimo,2004-01-31,Carlos Newton,Decision - Unanimous,80,18,0,98
Renato Verissimo,2004-06-19,Matt Hughes,Decision - Unanimous,0,0,0,0
Renato Verissimo,2004-10-22,Frank Trigg,KO/TKO,0,0,0,0
Renato Verissimo,2007-09-15,Jake Shields,KO/TKO,0,0,0,0
Lisa Kyriacou,2024-05-19,Yan Qihui,Decision - Split,0,4,0,4
Caros Fodor,2012-03-03,Pat Healy,Submission,0,0,0,0
Caros Fodor,2013-02-23,Sam Stout,Decision - Split,0,1,0,1
Masuto Kawana,2024-08-23,Xie Bin,KO/TKO,0,0,0,0
Nick Agallar,2003-11-21,Yves Edwards,KO/TKO,0,0,0,0
Yan Pellerin,2002-06-15,Rich Franklin,Submission,0,0,0,0
Gabe Green,2023-05-13,Bryan Battle,KO/TKO,0,3,0,3
Gabe Green,2020-05-30,Daniel Rodriguez,Decision - Unanimous,0,0,0,0
Gabe Green,2022-04-30,Yohan Lainesse,KO/TKO,100,7,0,107
Gabe Green,2022-07-02,Ian Machado Garry,Decision - Unanimous,0,0,0,0
Gabe Green,2021-02-13,Phil Rowe,Decision - Unanimous,80,28,0,108
Scott Adams,2000-03-10,Ian Freeman,Submission,90,0,0,90
Lee Higgins,2011-02-18,Ryan Couture,Submission,0,0,0,0
Jason Dent,2007-03-03,Gleison Tibau,Decision - Unanimous,0,0,0,0
Jason Dent,2009-11-21,George Sotiropoulos,Submission,0,0,0,0
Jason Dent,2006-09-23,Roger Huerta,Decision - Unanimous,0,0,0,0
Jason Dent,2009-06-20,Cameron Dollar,Submission,90,0,0,90
Guangyou Ning,2015-05-16,Royston Wee,KO/TKO,100,28,0,128
Guangyou Ning,2015-11-28,Marco Beltran,Decision - Split,0,0,0,0
Guangyou Ning,2016-11-26,Marlon Vera,Decision - Unanimous,0,10,0,10
Guangyou Ning,2014-08-23,Jianping Yang,Decision - Unanimous,80,10,0,90
Asbel Cancio,1995-04-07,Dave Beneteau,KO/TKO,0,0,0,0
Luke Zachrich,2014-04-19,Caio Magalhaes,KO/TKO,0,0,0,0
Luke Zachrich,2014-07-05,Guilherme Vasconcelos,Decision - Unanimous,80,17,0,97
Luke Zachrich,2014-11-07,Daniel Kelly,Submission,0,0,0,0
Ricky Palacios,2018-07-10,Toby Misech,Decision - Unanimous,80,67,0,147
Toby Misech,2018-07-10,Ricky Palacios,Decision - Unanimous,0,0,0,0
Casey Olson,2006-10-07,Bobby Sanchez,Submission,90,0,0,90
Casey Olson,2006-08-17,Chris Solomon,Decision - Unanimous,80,42,0,122
Bobby Sanchez,2006-10-07,Casey Olson,Submission,0,0,0,0
Dan Barrera,2007-12-08,Ben Saunders,Decision - Unanimous,0,0,0,0
Joe Brammer,2009-12-05,Mark Bocek,Submission,0,0,0,0
Joe Brammer,2010-05-29,Aaron Riley,Decision - Unanimous,0,0,0,0
Justin Jaynes,2020-06-20,Frank Camacho,KO/TKO,100,12,0,112
Justin Jaynes,2021-06-26,Charles Rosa,Decision - Split,0,0,0,0
Justin Jaynes,2020-12-05,Gabriel Benitez,KO/TKO,0,0,0,0
Justin Jaynes,2021-02-06,Devonte Smith,TKO - Doctor's Stoppage,0,0,0,0
Justin Jaynes,2020-08-08,Gavin Tucker,Submission,0,0,0,0
SangWon Kim,2023-05-27,Keisuke Sasu,KO/TKO,100,7,0,107
SangWon Kim,2023-08-27,Yizha,Decision - Unanimous,0,0,0,0
Chuck Grigsby,2008-06-01,Mark Munoz,KO/TKO,0,0,0,0
Caio Machado,2024-11-02,Brendson Ribeiro,Decision - Split,0,27,0,27
Caio Machado,2024-04-27,Don'Tale Mayes,Decision - Unanimous,0,9,0,9
Caio Machado,2023-11-18,Mick Parkin,Decision - Unanimous,0,37,0,37
Caio Machado,2023-08-08,Kevin Szaflarski,Decision - Unanimous,80,104,0,184
Nate Schroeder,2000-06-09,Ian Freeman,KO/TKO,0,0,0,0
Koji Kitao,1997-10-11,Nathan Jones,Submission,90,0,0,90
Koji Kitao,1996-05-17,Mark Hall,TKO - Doctor's Stoppage,0,0,0,0
Nathan Jones,1997-10-11,Koji Kitao,Submission,0,1,0,1
Homer Moore,2001-11-02,Evan Tanner,Submission,0,0,0,0
Mickael Lebout,2015-07-18,Teemu Packalen,Decision - Unanimous,80,8,0,88
Mickael Lebout,2015-04-11,Sergio Moraes,Decision - Unanimous,0,0,0,0
Mickael Lebout,2015-10-24,Stevie Ray,Decision - Unanimous,0,0,0,0
Steve Jennum,1994-12-16,Melton Bowen,Submission,90,12,0,102
Steve Jennum,1995-12-16,David Abbott,Submission,0,0,0,0
Steve Jennum,1994-09-09,Harold Howard,KO/TKO,100,4,0,104
Melton Bowen,1994-12-16,Steve Jennum,Submission,0,0,0,0
Galore Bofando,2017-07-16,Charlie Ward,KO/TKO,100,7,0,107
Galore Bofando,2017-12-16,Chad Laprise,KO/TKO,0,0,0,0
Mack Brewer,2002-10-18,Tim Kennedy,KO/TKO,0,0,0,0
Francisco Figueiredo,2022-04-30,Daniel Lacerda,Submission,90,1,0,91
Francisco Figueiredo,2022-08-20,Amir Albazi,Submission,0,0,0,0
Francisco Figueiredo,2021-01-20,Jerome Rivera,Decision - Unanimous,80,0,0,80
Francisco Figueiredo,2021-07-17,Malcolm Gordon,Decision - Unanimous,0,0,0,0
Ron Keslar,2011-01-29,Eric Lawson,Submission,90,0,0,90
Eric Lawson,2011-01-29,Ron Keslar,Submission,0,4,0,4
Eric Lawson,2008-09-20,Kenneth Seegrist,Submission,90,0,0,90
Bruno Santos,2014-10-04,Elias Theodorou,Decision - Unanimous,0,0,0,0
Bruno Santos,2013-12-06,Krzysztof Jotko,Decision - Unanimous,0,0,0,0
Bruno Santos,2014-07-05,Chris Camozzi,Decision - Split,70,0,0,70
Takashi Sugiura,2004-07-19,Paulo Cesar Silva,KO/TKO,100,12,0,112
Takashi Sugiura,2002-06-23,Daniel Gracie,Decision - Split,0,0,0,0
Hyder Amil,2023-08-15,Emrah Sonmez,Decision - Unanimous,80,4,0,84
Hyder Amil,2024-07-20,JeongYeong Lee,KO/TKO,100,38,0,138
Hyder Amil,2024-02-10,Fernie Garcia,KO/TKO,100,53,0,153
Emrah Sonmez,2023-08-15,Hyder Amil,Decision - Unanimous,0,0,0,0
Gilbert Urbina,2023-05-20,Orion Cosce,KO/TKO,100,35,0,135
Gilbert Urbina,2021-08-28,Bryan Battle,Submission,0,0,0,0
Gilbert Urbina,2024-02-03,Charles Radtke,KO/TKO,0,0,0,0
Luciano Azevedo,2006-08-27,Hayato Sakurai,TKO - Doctor's Stoppage,0,0,0,0
Antonio Braga Neto,2014-06-28,Clint Hester,Decision - Split,0,0,0,0
Antonio Braga Neto,2017-12-09,Trevin Giles,KO/TKO,0,0,0,0
Antonio Braga Neto,2013-06-08,Anthony Smith,Submission,90,1,0,91
Takayuki Okada,2000-08-27,Ricco Rodriguez,Submission,0,0,0,0
Brady Fink,2004-07-19,Hayato Sakurai,Submission,0,0,0,0
Dean Barry,2022-04-23,Mike Jackson,DQ,0,18,0,18
Roger Bowling,2012-08-18,Tarec Saffiedine,Decision - Unanimous,0,0,0,0
Roger Bowling,2012-03-03,Brandon Saling,KO/TKO,100,20,0,120
Roger Bowling,2011-07-22,Bobby Voelker,KO/TKO,0,8,0,8
Roger Bowling,2013-04-20,Anthony Njokuani,KO/TKO,0,1,0,1
Roger Bowling,2013-12-14,Abel Trujillo,KO/TKO,0,0,0,0
Roger Bowling,2011-03-05,Josh Thornburg,Decision - Unanimous,80,29,0,109
Roman Bogatov,2020-07-11,Leonardo Santos,Decision - Unanimous,0,0,0,0
Wes Combs,2006-08-26,Wilson Gouveia,Submission,0,1,0,1
Wes Combs,2006-06-24,Mike Nickels,Submission,0,0,0,0
KB Bhullar,2020-10-10,Tom Breese,KO/TKO,0,0,0,0
KB Bhullar,2021-05-01,Andreas Michailidis,Decision - Unanimous,0,0,0,0
Seth Kleinbeck,2007-06-22,Sam Spengler,KO/TKO,100,11,0,111
Seth Kleinbeck,2007-11-10,Kyle Noke,TKO - Doctor's Stoppage,0,0,0,0
Cameron Church,2020-09-08,Sherrard Blackledge,Decision - Unanimous,0,0,0,0
Amir Rahnavardi,1998-06-24,Gary Goodridge,KO/TKO,0,0,0,0
Amir Rahnavardi,2001-08-19,Keith Jardine,Submission,0,1,0,1
Nick Gonzalez,2007-06-22,Josh Thomson,Submission,0,0,0,0
Maia Stevenson,2018-02-03,Polyana Viana,Submission,0,0,0,0
SeongChan Hong,2023-05-28,Rongzhu,KO/TKO,0,0,0,0
Azunna Anyanwu,2017-09-16,Justin Ledet,Decision - Split,0,1,0,1
Azunna Anyanwu,2017-07-11,Greg Rebello,KO/TKO,100,0,0,100
Ednaldo Oliveira,2013-08-03,Francimar Barroso,Decision - Unanimous,0,0,0,0
Ednaldo Oliveira,2012-01-14,Gabriel Gonzaga,Submission,0,0,0,0
Vince Murdock,2020-11-04,Luis Saldana,KO/TKO,0,0,0,0
Nikolay Veretennikov,2024-08-10,Danny Barlow,Decision - Split,0,3,0,3
Nikolay Veretennikov,2021-09-21,Michael Morales,Decision - Unanimous,0,0,0,0
Ricky Johnson,2008-10-03,Tyler Toner,KO/TKO,0,0,0,0
Darrius Flowers,2023-07-29,Jake Matthews,Submission,0,0,0,0
Darrius Flowers,2022-08-23,Amiran Gogoladze,Submission,90,0,0,90
Darrius Flowers,2024-02-10,Michael Johnson,Decision - Unanimous,0,0,0,0
Darrius Flowers,2024-07-13,Evan Elder,Submission,0,0,0,0
Shin Haraguchi,2024-02-03,Rongzhu,Submission,0,0,0,0
Shin Haraguchi,2023-05-28,Windri Patilima,KO/TKO,100,47,0,147
Shin Haraguchi,2024-05-18,JunYoung Hong,Decision - Unanimous,80,10,0,90
Shin Haraguchi,2023-08-27,Jae Hyun Park,Decision - Unanimous,80,3,0,83
Shin Haraguchi,2024-08-23,Zhu Kangjie,Decision - Split,0,0,0,0
Chris Condo,1999-05-07,Ron Waterman,KO/TKO,0,0,0,0
Brandon Wolff,2008-12-10,Ben Saunders,KO/TKO,0,0,0,0
Brandon Wolff,2009-05-23,Yoshiyuki Yoshida,Submission,0,0,0,0
Oscar Cota,2020-11-17,Nick Maximov,Decision - Unanimous,0,0,0,0
Marcel Fortuna,2017-11-11,Jake Collier,Decision - Unanimous,0,0,0,0
Marcel Fortuna,2017-02-04,Anthony Hamilton,KO/TKO,100,1,0,101
Marcel Fortuna,2017-07-07,Jordan Johnson,Decision - Unanimous,0,11,0,11
Cain Carrizosa,2014-08-30,Chris Wade,Submission,0,0,0,0
Cain Carrizosa,2015-03-21,Leonardo Mafra,Decision - Unanimous,0,0,0,0
Masakatsu Okuda,2005-11-05,Yoshihiro Akiyama,KO/TKO,0,0,0,0
Dennis Bryant,2018-08-07,Kennedy Nzechukwu,KO/TKO,0,0,0,0
Rodolfo Rubio Perez,2014-11-08,Diego Rivas,Decision - Unanimous,0,2,0,2
Rafael Cerqueira,2024-10-26,Ibo Aslan,KO/TKO,0,0,0,0
Rafael Rebello,2010-06-20,Chris Cariaso,Decision - Unanimous,0,0,0,0
Rafael Rebello,2009-06-07,Kyle Dietz,Submission,90,0,0,90
Rafael Rebello,2009-03-01,Kenji Osawa,Decision - Split,0,15,0,15
Brad Gumm,2000-03-10,Shonie Carter,Decision - Unanimous,0,0,0,0
Jordan Vucenic,2024-08-03,Guram Kutateladze,Decision - Unanimous,0,4,0,4
Kiichi Kunimoto,2014-06-14,Daniel Sarafian,Submission,90,2,0,92
Kiichi Kunimoto,2014-01-04,Luiz Dutra,DQ,0,2,0,2
Kiichi Kunimoto,2014-09-20,Richard Walsh,Decision - Split,70,0,0,70
Kiichi Kunimoto,2017-06-10,Zak Ottow,Decision - Split,0,0,0,0
Kiichi Kunimoto,2015-02-14,Neil Magny,Submission,0,0,0,0
Keith Berish,2016-12-09,Ryan Janes,Decision - Unanimous,0,0,0,0
Emiliano Sordi,2018-06-19,Ryan Spann,Submission,0,1,0,1
John Gunderson,2010-06-19,Mark Holst,Decision - Unanimous,80,29,0,109
John Gunderson,2010-09-15,Yves Edwards,Decision - Unanimous,0,0,0,0
John Gunderson,2010-01-02,Rafaello Oliveira,Decision - Unanimous,0,0,0,0
Mark Holst,2010-06-19,John Gunderson,Decision - Unanimous,0,0,0,0
Mark Holst,2010-10-16,Paul Sass,Submission,0,1,0,1
Vince Cachero,2020-08-01,Jamall Emmers,Decision - Unanimous,0,0,0,0
Vince Cachero,2021-02-27,Ronnie Lawrence,KO/TKO,0,0,0,0
Stephanie Frausto,2020-11-10,Luana Pinheiro,KO/TKO,0,0,0,0
Marnic Mann,2022-09-13,Bruna Brasil,KO/TKO,0,0,0,0
Marnic Mann,2024-04-27,Ketlen Souza,Decision - Unanimous,0,0,0,0
Marnic Mann,2023-09-16,Josefine Knutsson,Decision - Unanimous,0,0,0,0
Brandon Visher,2010-11-11,Yves Jabouin,Decision - Unanimous,0,0,0,0
Brandon Visher,2010-04-24,Tyler Toner,KO/TKO,0,0,0,0
Brandon Visher,2009-12-19,Courtney Buck,KO/TKO,100,13,0,113
Chad Reiner,2007-06-12,Anthony Johnson,KO/TKO,0,0,0,0
Chad Reiner,2007-01-25,Joshua Burkman,Decision - Unanimous,0,0,0,0
Sumit Kumar,2023-05-27,SeungGuk Choi,Decision - Unanimous,0,0,0,0
Austin Vanderford,2018-07-17,Angelo Trevino,Submission,90,0,0,90
Angelo Trevino,2018-07-17,Austin Vanderford,Submission,0,10,0,10
Jesse Fujarczyk,2006-03-10,Daniel Puder,Submission,0,0,0,0
Jesse Fujarczyk,2006-10-07,Cain Velasquez,KO/TKO,0,0,0,0
Rubens Xavier,2005-09-10,Thiago Silva,KO/TKO,0,0,0,0
Tony Halme,1997-05-30,Randy Couture,Submission,0,0,0,0
Bu-Kyung Jung,2007-12-31,Shinya Aoki,Decision - Unanimous,0,0,0,0
Bu-Kyung Jung,2008-05-11,Daisuke Nakamura,KO/TKO,0,0,0,0
Bu-Kyung Jung,2008-03-15,Mitsuhiro Ishida,Decision - Unanimous,0,0,0,0
Rob Wilkinson,2017-09-02,Siyar Bahadurzada,KO/TKO,0,0,0,0
Rob Wilkinson,2018-02-10,Israel Adesanya,KO/TKO,0,0,0,0
Ernest Chavez,2014-10-04,Zubaira Tukhugov,KO/TKO,0,0,0,0
Ernest Chavez,2014-05-31,Elias Silverio,Submission,0,0,0,0
Ernest Chavez,2014-02-22,Yosdenis Cedeno,Decision - Split,70,2,0,72
Roman Mitichyan,2007-12-08,Dorian Price,Submission,90,0,0,90
Roman Mitichyan,2008-04-02,George Sotiropoulos,KO/TKO,0,0,0,0
Dorian Price,2007-12-08,Roman Mitichyan,Submission,0,0,0,0
Ray Rodriguez,2020-09-05,Brian Kelleher,Submission,0,0,0,0
Ray Rodriguez,2019-08-13,Tony Gravely,KO/TKO,0,0,0,0
Ray Rodriguez,2021-03-13,Rani Yahya,Submission,0,0,0,0
Oli Thompson,2012-08-04,Philip De Fries,Submission,0,0,0,0
Oli Thompson,2012-03-02,Shawn Jordan,KO/TKO,0,0,0,0
Dashon Johnson,2014-09-13,Godofredo Pepey,Submission,0,0,0,0
Dashon Johnson,2014-06-28,Jake Matthews,Submission,0,0,0,0
Hitomi Akano,2012-01-21,Sara McMann,Decision - Unanimous,0,0,0,0
Hitomi Akano,2010-08-13,Miesha Tate,Decision - Unanimous,0,0,0,0
Hitomi Akano,2009-04-11,Cristiane Justino,KO/TKO,0,0,0,0
Rama Supandhi,2022-06-09,SeungGuk Choi,Decision - Unanimous,0,0,0,0
Ryan Healy,2008-02-23,Jorge Masvidal,Decision - Unanimous,0,0,0,0
Alex Schoenauer,2005-04-09,Mike Swick,KO/TKO,0,0,0,0
Alex Schoenauer,2007-11-03,Vladimir Matyushenko,Decision - Unanimous,0,0,0,0
Luiz Dutra,2014-01-04,Kiichi Kunimoto,DQ,0,0,0,0
Luiz Dutra,2015-05-30,Tom Breese,KO/TKO,0,0,0,0
Roger Zapata,2015-09-26,Shinsho Anzai,TKO - Doctor's Stoppage,0,5,0,5
Mike van Arsdale,1998-05-15,Joe Pardo,Submission,90,23,0,113
Mike van Arsdale,2005-04-16,John Marsh,Decision - Unanimous,80,16,0,96
Mike van Arsdale,2006-02-04,Renato Sobral,Submission,0,0,0,0
Mike van Arsdale,2005-08-20,Randy Couture,Submission,0,0,0,0
Joe Pardo,1998-05-15,Mike van Arsdale,Submission,0,0,0,0
Phil Johns,2001-02-23,Fabiano Iha,Submission,0,0,0,0
Micah Miller,2008-08-03,Josh Grispi,KO/TKO,0,0,0,0
Micah Miller,2008-02-13,Chance Farrar,KO/TKO,100,6,0,106
Micah Miller,2007-06-03,Cub Swanson,Decision - Unanimous,0,0,0,0
Micah Miller,2009-03-08,Yoshiro Maeda,Decision - Unanimous,0,0,0,0
Micah Miller,2007-03-24,Jesse Moreng,Submission,90,11,0,101
Livinha Souza,2020-08-15,Ashley Yoder,Decision - Unanimous,80,14,0,94
Livinha Souza,2021-10-23,Randa Markos,Decision - Unanimous,0,0,0,0
Livinha Souza,2019-02-02,Sarah Frota,Decision - Split,70,0,0,70
Livinha Souza,2021-03-06,Amanda Lemos,KO/TKO,0,0,0,0
Livinha Souza,2018-09-22,Alex Chambers,Submission,90,6,0,96
Livinha Souza,2019-07-13,Brianna Fortino,Decision - Unanimous,0,0,0,0
Aleksa Camur,2021-06-19,Nicolae Negumereanu,Decision - Split,0,31,0,31
Aleksa Camur,2020-01-18,Justin Ledet,Decision - Unanimous,80,36,0,116
Aleksa Camur,2020-09-26,William Knight,Decision - Unanimous,0,0,0,0
Aleksa Camur,2019-07-30,Fabio Cherant,KO/TKO,100,37,0,137
Aleksa Camur,2023-08-05,Tanner Boser,Decision - Unanimous,0,0,0,0
Hernani Perpetuo,2014-04-19,Jordan Mein,Decision - Split,0,0,0,0
Hernani Perpetuo,2014-07-26,Tim Means,Decision - Unanimous,0,0,0,0
Martin Sano,2021-09-25,Matthew Semelsberger,KO/TKO,0,0,0,0
Bas Rutten,1999-05-07,Kevin Randleman,Decision - Split,70,0,0,70
Bas Rutten,2006-07-22,Ruben Villareal,KO/TKO,100,12,0,112
Bas Rutten,1999-01-08,Tsuyoshi Kohsaka,KO/TKO,100,8,0,108
WonBin Ki,2022-10-23,Jeka Saragih,KO/TKO,0,0,0,0
WonBin Ki,2024-05-19,Tatsuya Saika,KO/TKO,100,19,0,119
WonBin Ki,2022-06-09,Jinnosuke Kashimura,KO/TKO,100,34,0,134
WonBin Ki,2023-05-28,Bahatebole Batebolati,DQ,0,2,0,2
Che Mills,2011-11-05,Chris Cope,KO/TKO,100,10,0,110
Che Mills,2012-09-29,Duane Ludwig,KO/TKO,100,6,0,106
Che Mills,2012-04-21,Rory MacDonald,KO/TKO,0,0,0,0
Michael Patt,2009-03-07,Brandon Vera,KO/TKO,0,0,0,0
Michael Patt,2008-09-06,Tim Boetsch,KO/TKO,0,0,0,0
Jim Mullen,1997-02-07,Scott Ferrozzo,KO/TKO,0,0,0,0
Levan Makashvili,2015-06-27,Hacran Dias,Decision - Split,0,20,0,20
Levan Makashvili,2015-05-16,Mark Eddiva,Decision - Split,70,0,0,70
Luan Lacerda,2023-06-03,Da'Mon Blackshear,KO/TKO,0,0,0,0
Luan Lacerda,2023-01-21,Cody Stamann,Decision - Unanimous,0,0,0,0
Lucasz Sudolski,2021-09-28,Ihor Potieria,KO/TKO,0,3,0,3
Thomas Gifford,2019-04-27,Roosevelt Roberts,Decision - Unanimous,0,0,0,0
Thomas Gifford,2019-10-12,Mike Davis,KO/TKO,0,0,0,0
Hector Ramirez,2006-11-18,James Irvin,KO/TKO,0,16,0,16
Hector Ramirez,2007-06-16,Forrest Griffin,Decision - Unanimous,0,0,0,0
Hector Ramirez,2004-06-03,Rashad Evans,Decision - Unanimous,0,1,0,1
Daniel McWilliams,2007-09-29,Eddy Millis,Submission,90,7,0,97
Eddy Millis,2007-09-29,Daniel McWilliams,Submission,0,0,0,0
Zviad Lazishvili,2021-10-23,Jonathan Martinez,Decision - Unanimous,0,0,0,0
Jason Reinhardt,2007-11-17,Joe Lauzon,Submission,0,0,0,0
Jason Reinhardt,2011-02-26,Zhang Tiequan,Submission,0,0,0,0
Jason Reinhardt,2011-08-14,Edwin Figueroa,KO/TKO,0,0,0,0
Reza Nasri,1996-09-20,Brian Johnston,KO/TKO,0,0,0,0
Akiyo Nishiura,2009-03-08,Abel Cullum,Decision - Unanimous,0,0,0,0
Akiyo Nishiura,2010-05-29,Hideo Tokoro,KO/TKO,100,13,0,113
Akiyo Nishiura,2011-05-29,Caol Uno,Decision - Unanimous,0,5,0,5
Akiyo Nishiura,2010-09-25,Mitsuhiro Ishida,Decision - Split,0,5,0,5
Rafael Freitas,2002-11-08,Mauricio Rua,KO/TKO,0,0,0,0
Charlie Campbell,2022-08-02,Chris Duncan,KO/TKO,0,1,0,1
Charlie Campbell,2023-09-16,Alex Reyes,KO/TKO,100,29,0,129
Charlie Campbell,2024-04-06,Trevor Peek,Decision - Unanimous,80,7,0,87
Frank Lester,2009-06-20,Nick Osipczak,Submission,0,0,0,0
Adam Cella,2013-04-06,Tor Troeng,Submission,0,0,0,0
Niklas Backstrom,2015-06-20,Noad Lahat,Decision - Majority,0,0,0,0
Niklas Backstrom,2014-10-04,Mike Wilkinson,KO/TKO,0,1,0,1
Niklas Backstrom,2014-05-31,Tom Niinimaki,Submission,90,0,0,90
Arjan Bhullar,2017-09-09,Luis Henrique,Decision - Unanimous,80,0,0,80
Arjan Bhullar,2018-10-27,Marcelo Golm,Decision - Unanimous,80,4,0,84
Arjan Bhullar,2018-04-14,Adam Wieczorek,Submission,0,0,0,0
Arjan Bhullar,2019-05-04,Juan Adams,Decision - Unanimous,80,0,0,80
Wayne Cole,2008-03-29,Mike Kyle,Submission,90,0,0,90
Wayne Cole,2008-06-14,Rafael Cavalcante,KO/TKO,0,0,0,0
Amiran Gogoladze,2022-08-23,Darrius Flowers,Submission,0,1,0,1
Brandon Saling,2012-03-03,Roger Bowling,KO/TKO,0,0,0,0
JJ Ambrose,2008-07-19,Mike Pyle,Submission,0,0,0,0
Johnny Bedford,2014-09-13,Rani Yahya,Submission,0,0,0,0
Johnny Bedford,2014-06-28,Cody Gibson,KO/TKO,0,4,0,4
Johnny Bedford,2012-12-15,Marcos Vinicius,KO/TKO,100,30,0,130
Johnny Bedford,2013-04-27,Bryan Caraway,Submission,0,7,0,7
Johnny Bedford,2011-12-03,Louis Gaudinot,KO/TKO,100,76,0,176
Windri Patilima,2023-05-28,Shin Haraguchi,KO/TKO,0,0,0,0
Kyle Sturgeon,1998-06-24,Nobuhiko Takada,Submission,0,2,0,2
Daiki Hata,2009-10-06,Kazuyuki Miyata,Decision - Unanimous,0,0,0,0
Daiki Hata,2009-04-05,Hideo Tokoro,Decision - Unanimous,80,30,0,110
Daiki Hata,2010-07-10,Mitsuhiro Ishida,Decision - Unanimous,0,0,0,0
Jason Gonzalez,2017-01-28,JC Cottrell,Submission,90,3,0,93
Jason Gonzalez,2016-09-10,Drew Dober,KO/TKO,0,0,0,0
Jason Gonzalez,2019-04-27,Jim Miller,Submission,0,4,0,4
Jason Gonzalez,2017-09-16,Gregor Gillespie,Submission,0,2,0,2
Hashem Arkhagha,2021-09-21,AJ Dobson,Submission,0,0,0,0
Suman Mokhtarian,2019-12-21,SeungWoo Choi,Decision - Unanimous,0,0,0,0
Suman Mokhtarian,2018-12-01,Sodiq Yusuff,KO/TKO,0,0,0,0
Gabriel Santos,2024-09-07,Yizha,Decision - Unanimous,80,35,0,115
Gabriel Santos,2023-06-24,David Onama,KO/TKO,0,0,0,0
Gabriel Santos,2023-03-18,Lerone Murphy,Decision - Split,0,0,0,0
Izabela Badurek,2015-04-11,Aleksandra Albu,Submission,0,0,0,0
Clay French,2006-11-05,Shinya Aoki,Submission,0,1,0,1
Fabiano Scherner,2005-10-03,Brandon Vera,KO/TKO,0,0,0,0
Fabiano Scherner,2006-05-27,Gabriel Gonzaga,KO/TKO,0,0,0,0
Taiei Kin,2008-06-15,Zelg Galesic,KO/TKO,0,0,0,0
Taiei Kin,2006-08-05,Yoshihiro Akiyama,Submission,0,2,0,2
Taiei Kin,2008-04-29,Ikuhisa Minowa,Decision - Unanimous,80,26,0,106
Takeshi Inoue,2011-09-24,Caol Uno,KO/TKO,100,7,0,107
Takeshi Inoue,2011-12-31,Hiroyuki Takaya,Decision - Unanimous,0,0,25,25
Takeshi Inoue,2010-09-25,Kazuyuki Miyata,Decision - Unanimous,0,13,0,13
Takeshi Inoue,2011-05-29,Koichiro Matsumoto,KO/TKO,100,11,0,111
Alberto Crane,2007-08-25,Roger Huerta,KO/TKO,0,0,0,0
Alberto Crane,2008-01-23,Kurt Pellegrino,KO/TKO,0,0,0,0
SangHoon Yoo,2019-08-27,Peter Barrett,Decision - Unanimous,0,0,0,0
SangHoon Yoo,2023-05-28,Chris Hofmann,KO/TKO,100,0,0,100
Jeff Bedard,2007-06-03,Mike French,Decision - Unanimous,80,11,0,91
Jeff Bedard,2007-09-05,Miguel Torres,Submission,0,3,0,3
Dan Moret,2019-03-09,Alex White,Decision - Unanimous,0,0,0,0
Dan Moret,2018-04-14,Gilbert Burns,KO/TKO,0,0,0,0
Dan Moret,2019-06-29,Jared Gordon,Decision - Unanimous,0,0,0,0
Ryan Roberts,2008-04-02,Marcus Aurelio,Submission,0,0,0,0
Ruben Villareal,2006-07-22,Bas Rutten,KO/TKO,0,0,0,0
Ruben Villareal,2006-12-08,Paul Buentello,KO/TKO,0,16,0,16
Matheus Scheffel,2021-08-31,Azamat Murzakanov,KO/TKO,0,0,0,0
Bertrand Amoussou,2004-05-23,Raou Raou,KO/TKO,100,26,0,126
Raou Raou,2004-05-23,Bertrand Amoussou,KO/TKO,0,0,0,0
Sam Greco,2004-05-22,Lyoto Machida,Decision - Split,0,16,0,16
Marcelo Mello,1999-05-07,David Roberts,KO/TKO,100,7,0,107
David Roberts,1999-05-07,Marcelo Mello,KO/TKO,0,0,0,0
Elizabeth Phillips,2016-08-20,Raquel Pennington,Decision - Unanimous,0,0,0,0
Elizabeth Phillips,2014-08-23,Milana Dudieva,Decision - Split,0,14,0,14
Elizabeth Phillips,2014-06-14,Valerie Letourneau,Decision - Split,0,0,0,0
Elizabeth Phillips,2015-07-25,Jessamyn Duke,Decision - Unanimous,80,13,0,93
Oluwale Bamgbose,2017-06-03,Paulo Costa,KO/TKO,0,0,0,0
Oluwale Bamgbose,2015-08-08,Uriah Hall,KO/TKO,0,0,0,0
Oluwale Bamgbose,2016-04-16,Cezar Ferreira,Decision - Unanimous,0,0,0,0
Oluwale Bamgbose,2017-12-16,Alessio Di Chirico,KO/TKO,0,4,0,4
Oluwale Bamgbose,2016-02-21,Daniel Sarafian,KO/TKO,100,8,0,108
Shavkat Rakhmonov,2022-02-05,Carlston Harris,KO/TKO,100,3,0,103
Shavkat Rakhmonov,2020-10-24,Alex Oliveira,Submission,90,4,0,94
Shavkat Rakhmonov,2022-06-25,Neil Magny,Submission,90,8,0,98
Shavkat Rakhmonov,2023-03-04,Geoff Neal,Submission,90,44,0,134
Shavkat Rakhmonov,2023-12-16,Stephen Thompson,Submission,90,12,0,102
Shavkat Rakhmonov,2024-12-07,Ian Machado Garry,Decision - Unanimous,80,0,25,105
Shavkat Rakhmonov,2021-06-26,Michel Prazeres,Submission,90,15,0,105
Curt Warburton,2011-06-26,Joe Lauzon,Submission,0,0,0,0
Curt Warburton,2010-10-16,Spencer Fisher,Decision - Unanimous,0,0,0,0
Curt Warburton,2011-02-26,Maciej Jewtuszko,Decision - Unanimous,80,0,0,80
Chris Tuchscherer,2011-02-26,Mark Hunt,KO/TKO,0,0,0,0
Chris Tuchscherer,2009-08-29,Gabriel Gonzaga,KO/TKO,0,0,0,0
Chris Tuchscherer,2010-02-06,Tim Hague,Decision - Majority,75,0,0,75
Chris Tuchscherer,2010-07-03,Brendan Schaub,KO/TKO,0,0,0,0
Paul Sass,2011-10-01,Michael Johnson,Submission,90,0,0,90
Paul Sass,2010-10-16,Mark Holst,Submission,90,0,0,90
Paul Sass,2013-02-16,Danny Castillo,Decision - Unanimous,0,0,0,0
Paul Sass,2012-05-26,Jacob Volkmann,Submission,90,0,0,90
Paul Sass,2012-09-29,Matt Wiman,Submission,0,3,0,3
Tresean Gore,2022-10-29,Josh Fremd,Submission,90,0,0,90
Tresean Gore,2024-11-09,Antonio Trocoli,Submission,90,1,0,91
Tresean Gore,2022-07-09,Cody Brundage,KO/TKO,0,0,0,0
Tresean Gore,2022-02-05,Bryan Battle,Decision - Unanimous,0,0,0,0
Henry Miller,2004-10-14,Mal Foki,KO/TKO,100,4,0,104
Henry Miller,2004-12-31,Makoto Takimoto,Decision - Unanimous,0,0,0,0
Henry Miller,2005-10-23,Wagner da Conceicao Martins,KO/TKO,0,0,0,0
Henry Miller,2005-07-17,James Thompson,KO/TKO,0,0,0,0
Henry Miller,2004-04-25,Paulo Cesar Silva,Submission,0,2,0,2
Mal Foki,2004-10-14,Henry Miller,KO/TKO,0,0,0,0
Greg McIntyre,2009-03-01,Alex Karalexis,KO/TKO,0,0,0,0
Greg McIntyre,2008-08-03,Mike Budnik,Submission,0,0,0,0
Anna Elmose,2016-05-08,Germaine de Randamie,KO/TKO,0,0,0,0
Anna Elmose,2016-11-19,Amanda Cooper,Decision - Unanimous,0,0,0,0
Gokhan Saki,2017-09-22,Henrique da Silva,KO/TKO,100,20,0,120
Gokhan Saki,2018-07-07,Khalil Rountree Jr.,KO/TKO,0,0,0,0
Oumar Sy,2024-05-18,Tuco Tokkos,Submission,90,0,0,90
Oumar Sy,2024-09-28,Da Woon Jung,Decision - Unanimous,80,61,0,141
Yasuhito Namekawa,2004-10-14,Mauricio Rua,KO/TKO,0,0,0,0
Yasuhito Namekawa,2004-02-15,Egidijus Valavicius,Submission,90,0,0,90
Greg Rebello,2017-07-11,Azunna Anyanwu,KO/TKO,0,1,0,1
Greg Rebello,2018-06-26,Josh Parisian,KO/TKO,0,0,0,0
Joao Elias,2022-09-27,Rafael Estevam,KO/TKO,0,0,0,0
Pearl Gonzalez,2017-04-08,Cynthia Calvillo,Submission,0,0,0,0
Pearl Gonzalez,2017-10-07,Poliana Botelho,Decision - Unanimous,0,0,0,0
Federico Lopez,2010-05-29,Norifumi Yamamoto,KO/TKO,0,0,0,0
Lemont Davis,2007-11-16,Brian Schwartz,Decision - Unanimous,80,0,0,80
Brian Schwartz,2007-11-16,Lemont Davis,Decision - Unanimous,0,6,0,6
Ansar Chalangov,2005-11-19,Thiago Alves,KO/TKO,0,0,0,0
Ansar Chalangov,2006-04-06,Josh Koscheck,Submission,0,0,0,0
Derrick Krantz,2019-08-31,Song Kenan,Decision - Unanimous,0,0,0,0
Derrick Krantz,2019-05-18,Vicente Luque,KO/TKO,0,0,0,0
Martin Bravo,2018-07-06,Alex Caceres,Decision - Split,0,0,0,0
Martin Bravo,2019-09-21,Steven Peterson,KO/TKO,0,37,0,37
Martin Bravo,2016-11-05,Claudio Puelles,KO/TKO,100,27,0,127
Martin Bravo,2017-08-05,Humberto Bandenay,KO/TKO,0,0,0,0
Philip Preece,2002-06-19,Keith Jardine,Decision - Unanimous,0,1,0,1
Blood Diamond,2022-07-30,Orion Cosce,Decision - Unanimous,0,38,0,38
Blood Diamond,2023-09-09,Charles Radtke,Decision - Unanimous,0,9,0,9
Blood Diamond,2022-02-12,Jeremiah Wells,Submission,0,0,0,0
Scott Harper,2008-03-26,Logan Clark,KO/TKO,0,0,0,0
Magomed Sultanakhmedov,2008-04-29,Zelg Galesic,Submission,0,0,0,0
Greg Stott,1997-10-17,Mark Kerr,KO/TKO,0,0,0,0
Yosuke Nishijima,2006-10-21,Phil Baroni,Submission,0,0,0,0
Yosuke Nishijima,2006-05-05,Hidehiko Yoshida,Submission,0,0,0,0
Yosuke Nishijima,2006-02-26,Mark Hunt,KO/TKO,0,0,0,0
Yosuke Nishijima,2006-09-10,Evangelista Santos,Submission,0,0,0,0
Paul Rodriguez,2006-04-02,Mitsuhiro Ishida,Submission,0,0,0,0
Paul Rodriguez,2001-06-29,Tony DeSouza,Submission,0,1,0,1
Kevin Jousset,2023-09-09,Kiefer Crosbie,Submission,90,0,0,90
Kevin Jousset,2024-09-28,Bryan Battle,KO/TKO,0,0,0,0
Kevin Jousset,2023-12-09,Song Kenan,Decision - Unanimous,80,72,0,152
Kiefer Crosbie,2023-09-09,Kevin Jousset,Submission,0,10,0,10
Kiefer Crosbie,2024-07-27,Sam Patterson,Submission,0,0,0,0
Jesse Bongfeldt,2011-06-11,Chris Weidman,Submission,0,0,0,0
Michal Martinek,2019-07-30,Rodrigo Nascimento,Submission,0,0,0,0
Elvis Mutapcic,2016-01-17,Francimar Barroso,Decision - Unanimous,0,0,0,0
Elvis Mutapcic,2016-12-03,Anthony Smith,KO/TKO,0,0,0,0
Tony Juarez,2006-03-10,Nate Diaz,KO/TKO,0,0,0,0
Andy Enz,2015-01-31,Thiago Santos,KO/TKO,0,0,0,0
Andy Enz,2014-06-28,Marcelo Guimaraes,Decision - Split,0,0,0,0
Andy Enz,2014-02-01,Clint Hester,Decision - Unanimous,0,0,0,0
Guilherme Vasconcelos,2014-07-05,Luke Zachrich,Decision - Unanimous,0,0,0,0
Dave Phillips,2007-08-02,Dan Miller,Submission,0,0,0,0
Chance Farrar,2008-02-13,Micah Miller,KO/TKO,0,0,0,0
Chance Farrar,2007-06-03,Urijah Faber,Submission,0,0,25,25
Brandon Cash,2009-11-06,Shane del Rosario,Submission,0,14,0,14
Abdellah Er-Ramy,2024-10-01,Torrez Finney,KO/TKO,0,0,0,0
Dwight Joseph,2019-08-06,Jay Perrin,Decision - Unanimous,80,0,0,80
Xavier Foupa-Pokam,2009-05-23,Drew McFedries,KO/TKO,0,0,0,0
Xavier Foupa-Pokam,2009-04-18,Denis Kang,Decision - Unanimous,0,0,0,0
James Giboo,2008-07-19,Brad Blackburn,KO/TKO,0,0,0,0
Wang Guan,2017-11-25,Alex Caceres,Decision - Split,70,22,0,92
Christian Wellisch,2008-05-24,Shane Carwin,KO/TKO,0,0,0,0
Christian Wellisch,2006-12-30,Anthony Perosh,Decision - Unanimous,80,13,0,93
Christian Wellisch,2007-09-22,Scott Junk,Submission,90,0,0,90
Christian Wellisch,2006-08-26,Cheick Kongo,KO/TKO,0,0,0,0
Christian Wellisch,2009-01-31,Jake O'Brien,Decision - Split,0,21,0,21
Taiyilake Nueraji,2023-05-27,HanSeul Kim,KO/TKO,100,24,0,124
JunYoung Hong,2024-05-18,Shin Haraguchi,Decision - Unanimous,0,0,0,0
JunYoung Hong,2022-06-09,Koyomi Matsushima,Decision - Split,0,4,0,4
Brian Geraghty,2007-06-23,Matt Wiman,KO/TKO,0,0,0,0
Stevie Lynch,2007-06-16,Dustin Hazelett,Submission,0,0,0,0
Dante Rivera,2008-06-21,Matthew Riddle,Decision - Unanimous,0,0,0,0
Keith Rockel,2003-11-21,Chris Liguori,Submission,90,4,0,94
Keith Rockel,2002-01-11,Eugene Jackson,Submission,0,5,0,5
Chris Liguori,2003-11-21,Keith Rockel,Submission,0,0,0,0
Wendell Oliveira Marques,2015-05-30,Darren Till,KO/TKO,0,0,0,0
Wendell Oliveira Marques,2014-09-13,Santiago Ponzinibbio,KO/TKO,0,0,0,0
Chris Sanford,2005-04-09,Josh Koscheck,KO/TKO,0,0,0,0
Joe Moreira,1997-07-27,Yuri Vaulin,Decision - Unanimous,80,6,0,86
Joe Moreira,1996-02-16,Paul Varelans,Decision - Unanimous,0,3,0,3
Yuri Vaulin,1997-07-27,Joe Moreira,Decision - Unanimous,0,0,0,0
Ron Fields,2007-09-29,Falaniko Vitale,KO/TKO,0,0,0,0
Carlos Leal,2024-10-26,Rinat Fakhretdinov,Decision - Unanimous,0,0,0,0
Tyrone Roberts,2000-06-09,David Dodd,Decision - Unanimous,80,6,0,86
David Dodd,2000-06-09,Tyrone Roberts,Decision - Unanimous,0,0,0,0
David Dodd,1999-07-16,Travis Fulton,Decision - Unanimous,0,0,0,0
Michel Quinones,2017-11-11,Sage Northcutt,Decision - Unanimous,0,0,0,0
Michel Quinones,2017-06-25,Jared Gordon,KO/TKO,0,0,0,0
Nicco Montano,2019-07-13,Julianna Pena,Decision - Unanimous,0,0,0,0
Nicco Montano,2017-12-01,Roxanne Modafferi,Decision - Unanimous,80,54,25,159
TJ Cook,2012-08-18,Ovince Saint Preux,KO/TKO,0,0,0,0
TJ Cook,2011-11-18,Trevor Smith,Submission,0,0,0,0
Patrick Walsh,2015-02-14,Daniel Kelly,Decision - Unanimous,0,0,0,0
Patrick Walsh,2014-07-06,Daniel Spohn,Decision - Unanimous,80,0,0,80
Masio Fullen,2016-01-30,Alex Caceres,Decision - Unanimous,0,0,0,0
Masio Fullen,2015-02-28,Alex Torres,Decision - Split,70,4,0,74
Masio Fullen,2015-06-20,Makwan Amirkhani,Submission,0,1,0,1
Kazunori Yokota,2009-12-31,Tatsuya Kawajiri,Decision - Unanimous,0,0,0,0
Maimaitituoheti Keremuaili,2022-06-09,Toshiomi Kazama,Decision - Unanimous,0,0,0,0
Justin Jones,2014-12-06,Corey Anderson,Decision - Unanimous,0,0,0,0
Justin Jones,2015-04-04,Ron Stallings,Decision - Unanimous,0,0,0,0
Rainn Guerrero,2023-09-05,Dione Barbosa,Submission,0,0,0,0
Jose Maria,2013-08-03,John Lineker,KO/TKO,0,0,0,0
Jose Maria,2013-11-09,Dustin Ortiz,KO/TKO,0,0,0,0
Yanis Ghemmouri,2024-06-29,Payton Talbott,KO/TKO,0,0,0,0
Yanis Ghemmouri,2023-09-02,William Gomis,KO/TKO,0,0,0,0
Iouri Kotchkine,2002-09-29,Heath Herring,KO/TKO,0,0,0,0
Will Santiago,2018-06-12,Kevin Holland,Decision - Unanimous,0,0,0,0
Gaetano Pirrello,2021-10-02,Douglas Silva de Andrade,KO/TKO,0,0,0,0
Gaetano Pirrello,2021-01-20,Ricky Simon,Submission,0,0,0,0
Iliarde Santos,2013-08-03,Ian McCall,Decision - Unanimous,0,0,0,0
Iliarde Santos,2013-10-09,Chris Cariaso,KO/TKO,0,0,0,0
Iliarde Santos,2013-05-18,Iuri Alcantara,KO/TKO,0,0,0,0
Kanako Murata,2023-10-07,Vanessa Demopoulos,Decision - Unanimous,0,3,0,3
Kanako Murata,2021-06-19,Virna Jandiroba,TKO - Doctor's Stoppage,0,0,0,0
Kanako Murata,2020-11-14,Randa Markos,Decision - Unanimous,80,0,0,80
Jeremy  Freitag,2006-08-17,Anthony Ruiz,KO/TKO,0,0,0,0
Fabio Cherant,2021-08-21,William Knight,KO/TKO,0,1,0,1
Fabio Cherant,2019-07-30,Aleksa Camur,KO/TKO,0,0,0,0
Fabio Cherant,2021-03-27,Alonzo Menifield,Submission,0,0,0,0
Fabio Cherant,2022-02-12,Carlos Ulberg,Decision - Unanimous,0,0,0,0
John Marsh,2005-04-16,Mike van Arsdale,Decision - Unanimous,0,0,0,0
John Marsh,2000-12-09,Ricco Rodriguez,Decision - Unanimous,0,0,0,0
Mehdi Baghdad,2016-07-07,John Makdessi,Decision - Split,0,0,0,0
Mehdi Baghdad,2016-01-17,Chris Wade,Submission,0,0,0,0
Anthony Figueroa,2007-06-22,Chris Cariaso,Decision - Unanimous,0,0,0,0
Anthony Figueroa,2008-06-27,Chris Cariaso,Submission,0,0,0,0
Anthony Figueroa,2007-09-29,Miguel Linares,KO/TKO,100,5,0,105
Genaro Valdez,2022-01-22,Matt Frevola,KO/TKO,0,0,0,0
Genaro Valdez,2023-07-15,Evan Elder,Decision - Unanimous,0,0,0,0
Genaro Valdez,2022-12-03,Natan Levy,Decision - Unanimous,0,0,0,0
Genaro Valdez,2021-10-05,Patrik White,KO/TKO,100,0,0,100
Andreas Stahl,2014-07-26,Gilbert Burns,Decision - Unanimous,0,0,0,0
Andreas Stahl,2015-12-10,Santiago Ponzinibbio,KO/TKO,0,0,0,0
Jan Nortje,2008-02-23,Bob Sapp,KO/TKO,100,12,0,112
Jan Nortje,2001-12-23,Yoshihisa Yamamoto,Submission,0,0,0,0
Jan Nortje,2009-05-26,Rameau Thierry Sokoudjou,KO/TKO,0,0,0,0
Seth Dikun,2009-01-25,Charlie Valencia,Decision - Unanimous,0,0,0,0
Seth Dikun,2009-06-07,Rolando Perez,Submission,90,3,0,93
Seth Dikun,2009-11-18,Frank Gomez,Decision - Unanimous,0,0,0,0
Mark Climaco,2023-05-27,JungHyun Lee,Decision - Unanimous,80,29,0,109
Mark Climaco,2023-08-27,Rei Tsuruya,Decision - Unanimous,0,8,0,8
JungHyun Lee,2023-05-27,Mark Climaco,Decision - Unanimous,0,0,0,0
Leon Shahbazyan,2019-08-20,Phil Rowe,KO/TKO,0,0,0,0
Jason Suttie,2003-10-05,Sergei Kharitonov,Submission,0,0,0,0
Alex Torres,2015-02-28,Masio Fullen,Decision - Split,0,0,0,0
Joe Charles,1997-12-21,Vitor Belfort,Submission,0,1,0,1
Joe Charles,1995-04-07,Dan Severn,Submission,0,0,0,0
Tina Lahdemaki,2014-07-16,Claudia Gadelha,Decision - Unanimous,0,0,0,0
Yusuke Imamura,2002-07-20,Alistair Overeem,KO/TKO,0,0,0,0
Yusuke Imamura,2002-04-28,Rogerio Nogueira,Submission,0,0,0,0
Yusuke Imamura,2004-02-15,Mu Bae Choi,Submission,0,0,0,0
Solomon Hutcherson,2006-06-24,Luigi Fioravanti,KO/TKO,0,0,0,0
Steven Koslow,2022-12-10,Cameron Saaiman,KO/TKO,0,0,0,0
Ravena Oliveira,2023-10-14,Tainara Lisboa,Decision - Unanimous,0,0,0,0
Kailan Hill,2019-08-27,Impa Kasanganay,Decision - Unanimous,0,0,0,0
Brandon Melendez,2007-06-23,Joe Lauzon,Submission,0,2,0,2
Ivan Serati,2009-01-17,Tomasz Drwal,KO/TKO,0,0,0,0
Ivan Serati,2007-04-21,Vitor Belfort,KO/TKO,0,0,0,0
Tommy Speer,2007-05-12,Sidney Silva,KO/TKO,100,2,0,102
Tommy Speer,2008-04-02,Anthony Johnson,KO/TKO,0,0,0,0
Tommy Speer,2007-12-08,Mac Danzig,Submission,0,0,0,0
Sidney Silva,2007-05-12,Tommy Speer,KO/TKO,0,0,0,0
Tetsuji Kato,2001-03-02,Anderson Silva,Decision - Unanimous,0,0,0,0
Tetsuji Kato,2007-09-29,Gilbert Melendez,Decision - Unanimous,0,0,0,0
Mike Wessel,2008-12-27,Antoni Hardonk,KO/TKO,0,0,0,0
Jules Bruchez,2008-12-13,Eliot Marshall,Submission,0,0,0,0
Alvin Cacdac,2008-06-27,Bryan Caraway,Submission,0,1,0,1
Pedro Otavio,1998-06-24,Mark Kerr,Submission,0,0,0,0
Tsuyoshi Kurihara,2005-12-02,Gegard Mousasi,KO/TKO,0,0,0,0
Lu Kai,2022-10-23,JeongYeong Lee,KO/TKO,0,0,0,0
Lu Kai,2023-05-27,Kaiwen,KO/TKO,0,0,0,0
Lu Kai,2022-06-10,Angga,KO/TKO,100,2,0,102
Hector Urbina,2016-09-24,Vicente Luque,KO/TKO,0,0,0,0
Hector Urbina,2015-11-21,Bartosz Fabinski,Decision - Unanimous,0,0,0,0
Hector Urbina,2014-11-15,Edgar Garcia,Submission,90,0,0,90
Johil de Oliveira,2001-05-27,Antonio Schembri,Submission,0,0,0,0
Johil de Oliveira,2000-12-09,Carlos Newton,Decision - Unanimous,0,0,0,0
Anthony Ivy,2020-06-13,Christian Aguilera,KO/TKO,0,0,0,0
Anthony Ivy,2020-09-12,Bryan Barberena,Decision - Unanimous,0,0,0,0
Naho Sugiyuma,2012-10-06,Jessica Penne,Submission,0,1,25,26
Leo Sylvest,2004-04-16,Rich Franklin,KO/TKO,0,0,0,0
Roberto Traven,2001-11-02,Frank Mir,Submission,0,0,0,0
Fatima Kline,2024-07-13,Jasmine Jasudavicius,Decision - Unanimous,0,0,0,0
Kaiwen,2023-08-27,Koya Kanda,Decision - Unanimous,80,0,0,80
Kaiwen,2023-05-27,Lu Kai,KO/TKO,100,21,0,121
Callan Potter,2019-10-05,Maki Pitolo,Decision - Unanimous,80,0,0,80
Callan Potter,2019-02-09,Jalin Turner,KO/TKO,0,0,0,0
Callan Potter,2020-02-22,Song Kenan,KO/TKO,0,0,0,0
Carl Deaton,2023-07-15,Alexander Munoz,Decision - Unanimous,0,0,0,0
Carl Deaton,2023-02-25,Joe Solecki,Submission,0,0,0,0
Jeff Joslin,2005-07-09,Jon Fitch,Decision - Split,0,14,0,14
Jeff Joslin,2006-12-13,Josh Koscheck,Decision - Unanimous,0,4,0,4
Ozzy Diaz,2024-11-23,Zhang Mingyang,KO/TKO,0,0,0,0
Ozzy Diaz,2022-07-26,Joe Pyfer,KO/TKO,0,0,0,0
Teila Tuli,1993-11-12,Gerard Gordeau,KO/TKO,0,0,0,0
Joao Pierini,2002-06-22,Yves Edwards,KO/TKO,0,0,0,0
Christophe Leninger,1994-09-09,Ken Shamrock,KO/TKO,0,0,0,0
Christophe Leninger,1997-05-30,Guy Mezger,Decision - Unanimous,0,0,0,0
Joe Camacho,2004-02-20,Joe Stevenson,Submission,0,0,0,0
Roger Narvaez,2014-11-22,Luke Barnatt,Decision - Split,70,14,0,84
Roger Narvaez,2015-03-14,Elias Theodorou,KO/TKO,0,0,0,0
Roger Narvaez,2014-06-07,Patrick Cummins,KO/TKO,0,0,0,0
Neil Wain,2008-10-18,Shane Carwin,KO/TKO,0,0,0,0
Bobby Lashley,2010-08-21,Chad Griggs,KO/TKO,0,7,0,7
Bobby Lashley,2010-01-30,Wes Sims,KO/TKO,100,12,0,112
Fabio Silva,2008-11-01,Muhammed Lawal,KO/TKO,0,0,0,0
Thomas Paull,2022-08-16,Esteban Ribovics,KO/TKO,0,0,0,0
Yoko Takahashi,2008-10-04,Cristiane Justino,Decision - Unanimous,0,0,0,0
Nurullo Aliev,2022-09-20,Josh Wick,KO/TKO,100,27,0,127
Nurullo Aliev,2023-02-25,Rafael Alves,Decision - Majority,75,13,0,88
Josh Wick,2022-09-20,Nurullo Aliev,KO/TKO,0,0,0,0
Danny Mitchell,2014-03-08,Igor Araujo,Decision - Unanimous,0,6,0,6
Danny Mitchell,2014-08-23,Sai Wang,Decision - Unanimous,0,0,0,0
Justin Bruckmann,2002-06-15,Georges St-Pierre,Submission,0,0,0,0
Victor Dias,2023-08-08,Kevin Borjas,Decision - Unanimous,0,0,0,0
Jae Hyun Park,2023-08-27,Shin Haraguchi,Decision - Unanimous,0,0,0,0
Reese Andy,2008-12-27,Matt Hamill,KO/TKO,0,0,0,0
Reese Andy,2008-07-19,Brandon Vera,Decision - Unanimous,0,0,0,0
Miika Mehmet,2005-07-16,Michael Bisping,KO/TKO,0,0,25,25
Mitch Ramirez,2024-03-16,Thiago Moises,KO/TKO,0,0,0,0
Mitch Ramirez,2023-08-29,Carlos Prates,KO/TKO,0,0,0,0
Rosi Sexton,2013-10-26,Jessica Andrade,Decision - Unanimous,0,0,0,0
Rosi Sexton,2013-06-15,Alexis Davis,Decision - Unanimous,0,0,0,0
Rosi Sexton,2006-09-15,Gina Carano,KO/TKO,0,0,0,0
Nick Rossborough,2011-09-23,Lorenz Larkin,Decision - Unanimous,0,0,0,0
Leiticia Pestova,2006-06-10,Gina Carano,KO/TKO,0,0,0,0
Adam Wieczorek,2017-11-18,Anthony Hamilton,Decision - Unanimous,80,10,0,90
Adam Wieczorek,2018-04-14,Arjan Bhullar,Submission,90,4,0,94
Adam Wieczorek,2018-11-03,Marcos Rogerio de Lima,Decision - Unanimous,0,0,0,0
Alberto Montes,2024-10-01,Carlos Calderon,Submission,90,1,0,91
Carlos Calderon,2024-10-01,Alberto Montes,Submission,0,0,0,0
Yukio Sakaguchi,2008-12-31,Andy Ologun,KO/TKO,0,0,0,0
Scott Junk,2007-09-22,Christian Wellisch,Submission,0,11,0,11
Felix Lee Mitchell,1994-09-09,Ken Shamrock,Submission,0,0,0,0
Rizvan Kuniev,2024-08-20,Hugo Cunha,KO/TKO,100,12,0,112
Rizvan Kuniev,2021-09-28,Edivan Santos,KO/TKO,100,61,0,161
Hugo Cunha,2024-08-20,Rizvan Kuniev,KO/TKO,0,0,0,0
Aurelijus Kerpe,2009-03-29,Paul Daley,KO/TKO,0,0,0,0
Hiroyuki Abe,2004-07-19,Luiz Firmino,Submission,0,0,0,0
Roman Salazar,2015-08-08,Marlon Vera,Submission,0,0,0,0
Roman Salazar,2014-10-04,Mitch Gagnon,Submission,0,0,0,0
Poppies Martinez,2006-08-17,Gigo Jara,Submission,90,4,0,94
Poppies Martinez,2006-10-12,Robert Breslin,Submission,90,3,0,93
Gigo Jara,2006-08-17,Poppies Martinez,Submission,0,0,0,0
Tyra Parker,2008-10-03,Michelle Waterson-Gomez,Submission,0,0,0,0
Marcelo Golm,2017-10-28,Christian Colombo,Submission,90,33,0,123
Marcelo Golm,2018-10-27,Arjan Bhullar,Decision - Unanimous,0,0,0,0
Marcelo Golm,2019-04-20,Sergei Pavlovich,KO/TKO,0,0,0,0
Marcelo Golm,2018-02-03,Timothy Johnson,Decision - Unanimous,0,0,0,0
Yazan Hajeh,2018-06-19,Matt Sayles,KO/TKO,0,0,0,0
Liudvik Sholinian,2021-09-04,Jack Shore,Decision - Unanimous,0,0,0,0
Liudvik Sholinian,2022-11-05,Johnny Munoz,Decision - Unanimous,0,0,0,0
Bristol Marunde,2013-08-03,Viscardi Andrade,KO/TKO,0,0,0,0
Bristol Marunde,2012-03-03,Jacare Souza,Submission,0,0,0,0
Bristol Marunde,2013-04-13,Clint Hester,KO/TKO,0,0,0,0
Ryuki Ueyama,2004-02-15,Sean Sherk,Decision - Unanimous,0,0,0,0
Ryuki Ueyama,2004-10-14,Ikuhisa Minowa,Decision - Split,0,0,0,0
Kultar Gill,2008-07-21,Joachim Hansen,Submission,0,4,0,4
Kultar Gill,2008-03-15,Tatsuya Kawajiri,Decision - Unanimous,0,9,0,9
Angel Pacheco,2023-09-26,Danny Silva,Decision - Unanimous,0,0,0,0
Angel Pacheco,2024-03-30,Caolan Loughran,Decision - Unanimous,0,0,0,0
Brian Lo-A-Njoe,2007-04-08,Shinya Aoki,Submission,0,6,0,6
Masanori Tonooka,2008-09-23,Yoshihiro Akiyama,Submission,0,0,0,0
Sean Alvarez,2003-04-25,Wesley Correira,KO/TKO,0,0,0,0
Will Ribeiro,2008-06-01,Chase Beebe,Decision - Split,70,1,0,71
Will Ribeiro,2008-12-03,Brian Bowles,Submission,0,4,0,4
Anying Wang,2014-08-23,Colby Covington,KO/TKO,0,0,0,0
Anying Wang,2014-03-01,Albert Cheng,TKO - Doctor's Stoppage,0,8,0,8
Matt Bessette,2018-07-06,Steven Peterson,Decision - Split,0,0,0,0
Matt Bessette,2018-01-20,Enrique Barzola,Decision - Unanimous,0,0,0,0
Richie Smullen,2018-07-06,Luis Pena,Submission,0,0,0,0
Nick Newell,2018-07-24,Alexander Munoz,Decision - Unanimous,0,0,0,0
Bruno Oliveira,2020-11-04,Carlos Ulberg,KO/TKO,0,0,0,0
Nicdali Rivera-Calanoc,2013-07-13,Jessica Penne,Submission,0,0,0,0
Wallen Del Rosario,2022-06-09,Qiu Lun,Decision - Unanimous,0,0,0,0
Ray Wizard,1994-03-11,Patrick Smith,Submission,0,0,0,0
Kestutis Smirnovas,2006-08-05,Kazushi Sakuraba,Submission,0,7,0,7
Kestutis Smirnovas,2006-10-09,Yoshihiro Akiyama,KO/TKO,0,0,0,0
Junya Kudo,2008-07-21,Joseph Benavidez,Submission,0,0,0,0
Will Chope,2014-01-04,Max Holloway,KO/TKO,0,0,0,0
Ruslan Magomedov,2015-10-03,Shawn Jordan,Decision - Unanimous,80,51,0,131
Ruslan Magomedov,2014-05-31,Viktor Pesta,Decision - Unanimous,80,21,0,101
Ruslan Magomedov,2014-11-22,Josh Copeland,Decision - Unanimous,80,43,0,123
Ben Earwood,2000-11-17,Chris Lytle,Decision - Unanimous,80,3,0,83
Sean Daugherty,1994-03-11,Scott Morris,Submission,0,0,0,0
Hu Yaozong,2021-10-30,Andre Petroski,Submission,0,0,0,0
Hu Yaozong,2018-11-24,Rashad Coulter,Decision - Unanimous,0,0,0,0
Hu Yaozong,2017-11-25,Cyril Asker,Submission,0,0,0,0
Denis Sobolev,2001-03-25,Heath Herring,Submission,0,0,0,0
Donald Sanchez,2012-03-31,Tatsuya Kawajiri,Submission,0,0,0,0
Herdem Alacabek,2019-08-13,William Knight,KO/TKO,0,0,0,0
Won Jin Eoh,2006-06-04,Jason Black,KO/TKO,0,1,0,1
Roldan Sangcha'an,2015-05-16,Jon Delos Reyes,Submission,0,4,0,4
Roldan Sangcha'an,2014-06-28,Richie Vaculik,Decision - Unanimous,0,9,0,9
Steve Berger,2001-05-04,Tony DeSouza,Decision - Unanimous,0,0,0,0
Steve Berger,2002-06-22,Robbie Lawler,KO/TKO,0,0,0,0
Steve Berger,2008-02-23,Eddy Ellis,Decision - Unanimous,0,0,0,0
Townsend Saunders,1999-01-08,Mikey Burnett,Decision - Unanimous,0,0,0,0
Townsend Saunders,1998-03-13,Pat Miletich,Decision - Split,0,0,0,0
Matt Lucas,2011-11-12,Aaron Rosa,Decision - Majority,0,0,0,0
Mike Bourke,2000-10-31,Alexander Otsuka,Submission,0,0,0,0
Jesse Sanders,2009-04-01,Brock Larson,Submission,0,0,0,0
Ericka Almeida,2015-10-24,Aisling Daly,Decision - Unanimous,0,0,0,0
Ericka Almeida,2015-05-30,Juliana Lima,Decision - Unanimous,0,0,0,0
Min Soo Kim,2007-06-02,Brock Lesnar,KO/TKO,0,0,0,0
Oron Kahlon,2021-10-26,Javid Basharat,Submission,0,0,0,0
Micol Di Segni,2019-08-20,Mallory Martin,Decision - Unanimous,0,24,0,24
Jhonata Silva,2023-09-19,Igor Severino,KO/TKO,0,0,0,0
Olivier Murad,2021-10-26,Xie Bin,Decision - Split,70,6,0,76
David Lee,2007-04-21,Junior Assuncao,Submission,0,0,0,0
David Lee,2006-09-23,Tyson Griffin,Submission,0,1,0,1
Alex Nicholson,2016-02-06,Misha Cirkunov,Submission,0,0,0,0
Alex Nicholson,2016-11-05,Sam Alvey,Decision - Unanimous,0,19,0,19
Alex Nicholson,2017-05-28,Jack Hermansson,KO/TKO,0,0,0,0
Alex Nicholson,2016-07-13,Devin Clark,KO/TKO,100,4,0,104
Khadzhi Bestaev,2020-09-08,Phil Hawes,KO/TKO,0,0,0,0
J.T Taylor,2006-07-28,Drew Dimanlig,Submission,90,0,0,90
Drew Dimanlig,2006-07-28,J.T Taylor,Submission,0,2,0,2
Balajin,2022-10-23,Keisuke Sasu,Decision - Unanimous,0,0,0,0
Helio Dipp,2007-03-10,Rousimar Palhares,Submission,0,0,0,0
Dan Molina,2006-08-17,Rafael  Del Real,Submission,90,0,0,90
Rafael  Del Real,2006-08-17,Dan Molina,Submission,0,4,0,4
Gugun Gusman,2022-06-10,Rinya Nakamura,Submission,0,0,0,0
Alex Gorgees,2018-12-01,Damir Ismagulov,Decision - Unanimous,0,0,0,0
Devin Smyth,2019-08-13,Brok Weaver,Decision - Unanimous,0,0,0,0
Carlos Mota,2022-10-29,Cody Durden,Decision - Unanimous,0,0,0,0
Vernon Ramos Ho,2015-11-21,Alvaro Herrera Mendoza,KO/TKO,0,0,0,0
Denis Stojnic,2009-06-13,Stefan Struve,Submission,0,12,0,12
Denis Stojnic,2009-02-07,Cain Velasquez,KO/TKO,0,0,0,0
Khusein Askhabov,2023-02-18,Jamall Emmers,Decision - Unanimous,0,0,0,0
Mike Nickels,2006-06-24,Wes Combs,Submission,90,18,0,108
Mike Nickels,2007-07-07,Stephan Bonnar,Submission,0,0,0,0
Abu Azaitar,2023-10-21,Sedriques Dumas,Decision - Unanimous,0,7,0,7
Abu Azaitar,2021-03-27,Marc-Andre Barriault,KO/TKO,0,0,0,0
Abu Azaitar,2018-07-22,Vitor Miranda,Decision - Unanimous,80,29,0,109
Cameron Dollar,2009-06-20,Jason Dent,Submission,0,10,0,10
Bubba Bush,2015-10-24,Garreth McLellan,KO/TKO,0,0,0,0
Brian Camozzi,2018-02-18,Geoff Neal,Submission,0,0,0,0
Brian Camozzi,2017-07-08,Chad Laprise,KO/TKO,0,0,0,0
Brian Camozzi,2016-12-09,Randy Brown,KO/TKO,0,0,0,0
Mike Aina,2007-09-15,Nick Diaz,Decision - Split,0,0,0,0
Fernando Bruno,2015-08-01,Glaico Franca Moreira,Submission,0,0,0,0
Fernando Bruno,2016-07-08,Gray Maynard,Decision - Unanimous,0,2,0,2
Edivan Santos,2021-09-28,Rizvan Kuniev,KO/TKO,0,0,0,0
Colleen Schneider,2010-08-13,Liz Carmouche,Decision - Unanimous,0,0,0,0
Andre Mussi,2005-01-22,Brandon Vera,KO/TKO,0,0,0,0
Craig White,2018-05-27,Neil Magny,KO/TKO,0,0,0,0
Craig White,2018-09-08,Diego Sanchez,Decision - Unanimous,0,0,0,0
Sam Oropeza,2011-02-12,Don Carlo-Clauss,KO/TKO,100,26,0,126
Don Carlo-Clauss,2011-02-12,Sam Oropeza,KO/TKO,0,0,0,0
Alberto Uda,2016-08-20,Marvin Vettori,Submission,0,0,0,0
Alberto Uda,2016-05-29,Jake Collier,KO/TKO,0,0,0,0
Harvey Park,2019-08-06,Omar Morales,KO/TKO,0,0,0,0
Andy Wang,2007-06-23,Cole Miller,KO/TKO,0,0,0,0
Justin Wren,2009-12-05,Jon Madsen,Decision - Split,0,0,0,0
Melchor Manibusan,2009-10-06,Tatsuya Kawajiri,KO/TKO,0,0,0,0
Humberto Brown Morrison,2014-11-15,Gabriel Benitez,Submission,0,0,0,0
Chris Mierzwiak,2011-09-10,Dominique Steele,Decision - Unanimous,0,0,0,0
Sherman Pendergarst,2006-11-18,Antoni Hardonk,KO/TKO,0,0,0,0
Kenneth Seegrist,2008-09-20,Eric Lawson,Submission,0,6,0,6
Nick Ertl,2004-08-20,Nam Phan,Decision - Split,70,0,0,70
Nick Ertl,2006-01-13,Richard Crunkilton,KO/TKO,0,0,0,0
Kevin Knabjian,2007-06-03,Brock Larson,KO/TKO,0,0,0,0
Mike Polchlopek,2006-11-05,Ikuhisa Minowa,Decision - Unanimous,0,10,0,10
David Gardner,2009-03-08,Shinya Aoki,Submission,0,0,0,0
Tim Lajcik,1999-07-16,Tsuyoshi Kohsaka,KO/TKO,0,1,0,1
Tim Lajcik,2000-09-22,Jeff Monson,Decision - Unanimous,0,0,0,0
Shonte Barnes,2021-10-05,Joseph Holmes,Submission,0,6,0,6
Johnny Sampaio,2007-05-12,Ed Ratcliff,KO/TKO,0,0,0,0
Bobby Stack,2008-06-27,Jose Palacios,Decision - Unanimous,80,0,0,80
Bobby Stack,2011-01-29,Isaiah Hill,Submission,0,0,0,0
Jose Palacios,2008-06-27,Bobby Stack,Decision - Unanimous,0,15,0,15
Antony Rea,2002-09-17,Rich Franklin,KO/TKO,0,0,0,0
Chad Johnson,2020-08-18,Josh Parisian,KO/TKO,0,0,0,0
Melinda Fabian,2018-06-23,Ji Yeon Kim,Decision - Split,0,0,0,0
Maka Watson,2011-09-23,Ryan Couture,Decision - Majority,0,0,0,0
Joe Benoit,2007-09-05,Blas Avena,Submission,0,0,0,0
Thomas Ramirez,1996-02-16,Don Frye,KO/TKO,0,0,0,0
Todd Brown,2011-03-03,Igor Pokrajac,KO/TKO,0,0,0,0
Todd Brown,2010-08-07,Tim Boetsch,Decision - Unanimous,0,0,0,0
Gerald Strebendt,2003-09-26,Josh Thomson,KO/TKO,0,0,0,0
Ricky Legere Jr.,2012-01-07,Chris Spang,Decision - Unanimous,80,0,0,80
Ty Flores,2020-08-04,Dustin Jacoby,Decision - Unanimous,0,0,0,0
Mohammad Yahya,2023-10-21,Trevor Peek,Decision - Unanimous,0,0,0,0
Mohammad Yahya,2024-08-03,Kaue Fernandes,KO/TKO,0,0,0,0
Kaue Fernandes,2023-11-04,Marc Diakiese,Decision - Split,0,10,0,10
Kaue Fernandes,2024-08-03,Mohammad Yahya,KO/TKO,100,33,0,133
Zach Light,2002-06-22,Pete Spratt,Submission,0,0,0,0
Zach Light,2009-09-25,Tyron Woodley,Submission,0,0,0,0
Rolando Perez,2009-01-25,Jose Aldo,KO/TKO,0,0,0,0
Rolando Perez,2009-06-07,Seth Dikun,Submission,0,0,0,0
Gilbert Rael,2006-05-05,Nate Diaz,KO/TKO,0,0,0,0
Filip Pejic,2016-04-10,Damian Stasiak,Submission,0,0,0,0
Shannon Ritch,2000-10-31,Kazushi Sakuraba,Submission,0,0,0,0
Shannon Ritch,2002-12-15,Diego Sanchez,Submission,0,0,0,0
Robert Lucarelli,1994-03-11,Orlando Wiet,KO/TKO,0,0,0,0
Willie Peeters,2000-06-04,Heath Herring,Submission,0,0,0,0
Kerry Schall,2005-11-05,Keith Jardine,KO/TKO,0,0,0,0
Young Sam Jung,2010-07-10,Michihiro Omigawa,Submission,0,0,0,0
Estefani Almeida,2018-08-11,Taila Santos,Decision - Unanimous,0,0,0,0
Lucas Stark,2010-08-13,Ryan Couture,Submission,0,0,0,0
Mo Miller,2021-09-14,Brandon Lewis,Decision - Unanimous,80,8,0,88
Rico Farrington,2019-07-30,Daniel Rodriguez,Decision - Unanimous,0,0,0,0
Boston Salmon,2019-10-18,Randy Costa,KO/TKO,0,0,0,0
Boston Salmon,2017-07-11,Ricky Turcios,Decision - Unanimous,80,0,0,80
Boston Salmon,2019-04-13,Khalid Taha,KO/TKO,0,0,0,0
Danny Abbadi,2006-06-24,Kalib Starnes,Submission,0,0,0,0
Danny Abbadi,2006-09-23,Jorge Gurgel,Decision - Split,0,0,0,0
Eun Soo Lee,2006-07-01,Yoshihiro Nakao,TKO - Doctor's Stoppage,0,0,0,0
Tommy Hayden,2012-01-20,Fabricio Camoes,Submission,0,1,0,1
Tommy Hayden,2012-08-11,Dennis Bermudez,Submission,0,0,0,0
Luis Santos,2008-06-01,Alex Serdyukov,KO/TKO,0,2,0,2
Ronaldo Candido,2017-08-01,Carlos Candelario,Decision - Unanimous,0,0,0,0
Sergey Ignatov,2004-10-31,Ricardo Arona,Submission,0,0,0,0
Yusuke Kasuya,2015-09-26,Nick Hein,Decision - Unanimous,0,0,0,0
Yusuke Kasuya,2016-11-26,Alexander Volkanovski,KO/TKO,0,0,0,0
Albert Cheng,2014-03-01,Anying Wang,TKO - Doctor's Stoppage,0,0,0,0
Keiichiro Yamamiya,1999-11-19,Eugene Jackson,KO/TKO,0,0,0,0
Derrick Mehmen,2012-05-19,Gian Villante,Decision - Unanimous,0,0,0,0
Josh Bryant,2010-06-19,Kyle Noke,KO/TKO,0,0,0,0
Israel Albuquerque,2001-06-09,Anderson Silva,KO/TKO,0,0,0,0
Donny Walker,2011-09-17,Ken Stone,Submission,0,0,0,0
Donny Walker,2011-07-02,Jeff Hougland,Decision - Unanimous,0,0,0,0
Tulio Palhares,1998-10-16,Adriano Santos,KO/TKO,100,20,0,120
Adriano Santos,1998-10-16,Tulio Palhares,KO/TKO,0,0,0,0
Jenna Castillo,2011-01-29,Charlene Gellner,KO/TKO,100,11,0,111
Charlene Gellner,2011-01-29,Jenna Castillo,KO/TKO,0,0,0,0
Katsuya Inoue,2008-05-11,Nick Diaz,KO/TKO,0,0,0,0
Horacio Gutierrez,2016-08-06,Teruto Ishihara,KO/TKO,0,0,0,0
Horacio Gutierrez,2015-11-21,Enrique Barzola,Decision - Unanimous,0,0,0,0
Vinicius Cenci,2022-09-27,Sam Patterson,Submission,0,2,0,2
Ibragim Magomedov,2005-06-26,Mirko Filipovic,KO/TKO,0,0,0,0
George Allen,2003-06-14,Keith Jardine,Decision - Unanimous,0,0,0,0
Eric Wray,2006-10-07,Jason Von Flue,Submission,0,0,0,0
Oliver Enkamp,2017-05-28,Nordine Taleb,Decision - Unanimous,0,0,0,0
Oliver Enkamp,2018-03-17,Danny Roberts,KO/TKO,0,3,0,3
Alexandru Lungu,2005-10-23,James Thompson,KO/TKO,0,0,0,0
Melissa Mullins,2024-11-09,Klaudia Sygula,KO/TKO,100,26,0,126
Melissa Mullins,2023-10-14,Irina Alekseeva,Decision - Unanimous,80,4,0,84
Melissa Mullins,2024-04-06,Nora Cornolle,KO/TKO,0,0,0,0
Klaudia Sygula,2024-11-09,Melissa Mullins,KO/TKO,0,0,0,0
Marcelo Brito,2007-09-05,John Alessio,Decision - Unanimous,0,0,0,0
Leonardo Damiani,2021-08-31,AJ Fletcher,KO/TKO,0,0,0,0
Miguel Linares,2007-09-29,Anthony Figueroa,KO/TKO,0,0,0,0
Zane Frazier,1996-05-17,Cal Worsham,KO/TKO,0,0,0,0
Zane Frazier,1993-11-12,Kevin Rosier,KO/TKO,0,0,0,0
Hiroko Yamanaka,2012-08-18,Germaine de Randamie,Decision - Unanimous,0,0,0,0
Felipe Olivieri,2016-01-30,Anthony Rocco Martin,Submission,0,27,0,27
Jonathan Meunier,2016-06-18,Colby Covington,Submission,0,0,0,0
Jonathan Meunier,2016-11-26,Richard Walsh,Decision - Unanimous,80,56,0,136
Ryan Madigan,2009-03-07,Tamdan McCrory,KO/TKO,0,0,0,0
Jon Murphy,2008-05-31,Brett Rogers,KO/TKO,0,0,0,0
Lorenzo Hood,2021-10-12,Martin Buday,KO/TKO,0,0,0,0
Erick Montano,2016-09-17,Randy Brown,Submission,0,9,0,9
Erick Montano,2016-11-05,Max Griffin,KO/TKO,0,0,0,0
Erick Montano,2015-11-21,Enrique Marin,Decision - Split,70,22,0,92
Chelsea Hackett,2020-11-17,Victoria Leonardo,KO/TKO,0,0,0,0
Roger Hollett,2012-09-22,Matt Hamill,Decision - Unanimous,0,0,0,0
Roger Hollett,2013-05-18,Fabio Maldonado,Decision - Unanimous,0,0,0,0
Courtney Buck,2010-03-06,Fredson Paixao,Submission,0,0,0,0
Courtney Buck,2009-12-19,Brandon Visher,KO/TKO,0,0,0,0
Ricardo Barros,2008-12-03,Mark Munoz,KO/TKO,0,0,0,0
Dmitry Sosnovskiy,2018-03-17,Mark Godbeer,Submission,90,4,0,94
Juan Manuel Puig,2014-07-06,Adriano Martins,KO/TKO,0,4,0,4
Juan Manuel Puig,2014-11-22,Dooho Choi,KO/TKO,0,0,0,0
Joe Hurley,2006-06-15,Nate Diaz,Submission,0,0,0,0
Joe Hurley,2003-03-27,Nick Diaz,Submission,0,0,25,25
Zhu Kangjie,2024-08-23,Shin Haraguchi,Decision - Split,70,14,0,84
Zhu Kangjie,2024-05-18,Tatsuya Ando,Decision - Unanimous,80,60,0,140
Nasrudin Nasrudinov,2021-09-14,Jailton Almeida,Submission,0,5,0,5
Jerrel Venetiaan,2002-11-24,Hirotaka Yokoi,Submission,0,0,0,0
Jerrel Venetiaan,2002-08-28,Daijiro Matsui,Decision - Split,70,18,0,88
Chris Price,2006-10-10,Kendall Grove,KO/TKO,0,0,0,0
Chris Price,2007-01-25,Ed Herman,Submission,0,0,0,0
Josh Diekmann,2006-10-12,Justin Eilers,KO/TKO,0,0,0,0
Tony Bonello,2008-06-14,Murilo Rua,KO/TKO,0,0,0,0
Mark Striegl,2022-02-19,Chas Skelly,KO/TKO,0,0,0,0
Mark Striegl,2020-10-17,Said Nurmagomedov,KO/TKO,0,0,0,0
Jose Barreto,2000-08-12,Anderson Silva,KO/TKO,0,0,0,0
Brianna Fortino,2019-07-13,Livinha Souza,Decision - Unanimous,80,49,0,129
Brianna Fortino,2020-06-20,Tecia Pennington,Decision - Unanimous,0,0,0,0
Brock Jardine,2012-06-22,Rick Story,Decision - Unanimous,0,0,0,0
Brock Jardine,2013-02-23,Kenny Robertson,Submission,0,0,0,0
Sai Wang,2014-08-23,Danny Mitchell,Decision - Unanimous,80,6,0,86
Sai Wang,2014-03-01,Zhang Lipeng,Decision - Split,0,21,0,21
Cristina Stanciu,2016-07-13,Cortney Casey,KO/TKO,0,0,0,0
Cristina Stanciu,2016-04-10,Maryna Moroz,Decision - Unanimous,0,4,0,4
Claudio Mattos,2006-11-25,Rousimar Palhares,Submission,0,0,0,0
Won Sik Park,2009-10-25,Kuniyoshi Hironaka,KO/TKO,0,2,0,2
Jianping Yang,2014-08-23,Guangyou Ning,Decision - Unanimous,0,0,0,0
Egidijus Valavicius,2004-02-15,Yasuhito Namekawa,Submission,0,0,0,0
Ben Wall,2014-05-10,Justin Salas,KO/TKO,0,0,0,0
Ben Wall,2013-12-06,Alex Garcia,KO/TKO,0,0,0,0
Navajo Stirling,2024-12-14,Tuco Tokkos,Decision - Unanimous,80,46,0,126
Brogan Walker,2022-08-06,Juliana Miller,KO/TKO,0,0,0,0
Brogan Walker,2023-04-22,Iasmin Lucindo,Decision - Unanimous,0,0,0,0
Kaloyan Kolev,2021-10-19,Armen Petrosyan,KO/TKO,0,0,0,0
Jeremia Siregar,2022-06-10,HyunSung Park,KO/TKO,0,0,0,0
Alexandre Ferreira,2010-11-13,Vladimir Matyushenko,KO/TKO,0,0,0,0
Tebaris Gordon,2018-08-07,Greg Hardy,KO/TKO,0,0,0,0
Chris Saunders,2012-06-01,Myles Jury,Submission,0,0,0,0
Tatsuya Iwasaki,2002-08-28,Wanderlei Silva,KO/TKO,0,0,0,0
Manny Bermudez,2019-08-17,Casey Kenney,Decision - Unanimous,0,0,0,0
Manny Bermudez,2018-07-22,Davey Grant,Submission,90,0,0,90
Manny Bermudez,2019-02-17,Benito Lopez,Submission,90,0,0,90
Manny Bermudez,2019-10-18,Charles Rosa,Submission,0,21,0,21
Manny Bermudez,2018-02-24,Albert Morales,Submission,90,0,0,90
Nick Sanzo,1997-02-07,Jerry Bohlander,Submission,0,0,0,0
Kyle Dietz,2009-06-07,Rafael Rebello,Submission,0,3,0,3
Kyle Dietz,2009-12-19,Brad Pickett,Submission,0,0,0,0
Don Shainis,2023-02-11,Jack Jenkins,Decision - Unanimous,0,0,0,0
Don Shainis,2022-10-01,Sodiq Yusuff,Submission,0,0,0,0
Kristian Rothaermel,2006-06-28,Rob MacDonald,Submission,0,0,0,0
Vitor Vianna,2006-11-30,Thiago Silva,KO/TKO,0,0,0,0
Raymond Daniels,2008-06-27,Jeremiah Metcalf,Submission,0,0,0,0
Geronimo dos Santos,2010-07-10,Josh Barnett,KO/TKO,0,0,0,0
Larissa Pacheco,2014-09-13,Jessica Andrade,Submission,0,0,0,0
Larissa Pacheco,2015-03-14,Germaine de Randamie,KO/TKO,0,0,0,0
Stephanie Webber,2011-01-29,Germaine de Randamie,KO/TKO,0,0,0,0
Nick Denis,2012-01-20,Joseph Sandoval,KO/TKO,100,8,0,108
Nick Denis,2012-05-05,Roland Delorme,Submission,0,0,0,0
CM Punk,2016-09-10,Mickey Gall,Submission,0,0,0,0
Derek Downey,2009-02-07,Nick Catone,Submission,0,0,0,0
Rick Davis,2006-05-27,Melvin Guillard,KO/TKO,0,0,0,0
Jamie Yager,2010-06-19,Rich Attonito,KO/TKO,0,5,0,5
Maiquel Falcao,2010-11-20,Gerald Harris,Decision - Unanimous,80,17,0,97
Nick Serra,2002-06-22,Benji Radach,Decision - Unanimous,0,0,0,0
Sean O'Haire,2006-10-21,Eric Esch,KO/TKO,0,0,0,0
Robert Breslin,2006-10-12,Poppies Martinez,Submission,0,0,0,0
Kaik Brito,2023-08-22,Oban Elliott,Decision - Majority,0,0,0,0
Ryan MacDonald,2019-09-14,Louis Smolka,KO/TKO,0,0,0,0
Ryan MacDonald,2019-03-23,Chris Gutierrez,Decision - Unanimous,0,0,0,0
Braxton Smith,2023-05-06,Parker Porter,KO/TKO,0,0,0,0
Bryson Kamaka,2007-11-16,Luke Stewart,KO/TKO,0,0,0,0
Taylor Johnson,2019-08-06,Andre Muniz,Submission,0,7,0,7
Tatsuya Saika,2024-05-19,WonBin Ki,KO/TKO,0,0,0,0
Rene Kronvold,2003-06-14,Diego Sanchez,Submission,0,0,0,0
Bob Cook,2000-03-10,Tiki Ghosn,Submission,90,0,0,90
Shunichi Shimizu,2014-01-04,Kyung Ho Kang,Submission,0,0,0,0
Fiona Muxlow,2012-12-31,Marloes Coenen,Submission,0,0,0,0
Larry Parker,1999-09-12,Akira Shoji,Decision - Unanimous,0,0,0,0
Taiga Iwasaki,2024-09-10,Yousri Belgaroui,KO/TKO,0,0,0,0
Bill Duvall,2006-06-09,Luke Stewart,Submission,0,0,0,0
Daniel Spohn,2017-07-18,Angel De Anda,Submission,90,2,0,92
Daniel Spohn,2014-07-06,Patrick Walsh,Decision - Unanimous,0,13,0,13
Angel De Anda,2017-07-18,Daniel Spohn,Submission,0,0,0,0
Garrett Gross,2018-07-31,Roosevelt Roberts,Submission,0,0,0,0
Tom Egan,2009-01-17,John Hathaway,KO/TKO,0,0,0,0
John Dixson,1997-10-11,Kazunari Murakami,Submission,0,0,0,0
Tatsuya Ando,2024-05-18,Zhu Kangjie,Decision - Unanimous,0,0,0,0
Fabio Nascimento,2008-07-19,Matt Lindland,Decision - Unanimous,0,0,0,0
Fabio Nascimento,2007-12-06,Rousimar Palhares,Submission,0,0,0,0
Andrei Kopylov,2002-09-29,Mario Sperry,TKO - Doctor's Stoppage,0,0,0,0
Mychal Clark,2008-02-23,Josh Bennett,TKO - Doctor's Stoppage,0,29,0,29
Josh Bennett,2008-02-23,Mychal Clark,TKO - Doctor's Stoppage,0,0,0,0
Jorge Lopez,2011-09-17,Justin Edwards,Decision - Unanimous,0,1,0,1
Jorge Lopez,2012-05-15,Amir Sadollah,Decision - Split,0,0,0,0
Jinnosuke Kashimura,2022-06-09,WonBin Ki,KO/TKO,0,0,0,0
Nikolajus Cilkinas,2006-03-18,Alistair Overeem,Submission,0,0,0,0
Megumi Fujii,2011-12-31,Karla Benitez,Submission,90,3,0,93
Karla Benitez,2011-12-31,Megumi Fujii,Submission,0,0,0,0
Patrik White,2021-10-05,Genaro Valdez,KO/TKO,0,20,0,20
Spike Carlyle,2020-05-30,Billy Quarantillo,Decision - Unanimous,0,0,0,0
Spike Carlyle,2020-11-28,Bill Algeo,Decision - Unanimous,0,0,0,0
Spike Carlyle,2020-02-29,Aalon Cruz,KO/TKO,100,18,0,118
Davi Bittencourt,2023-10-10,Lucas Rocha,KO/TKO,0,14,0,14
Cesar Gracie,2006-03-10,Frank Shamrock,KO/TKO,0,0,0,0
Marc Stevens,2011-02-12,John Cholish,Submission,0,0,0,0
Hugo Duarte,1998-05-15,David Abbott,KO/TKO,0,0,0,0
Hugo Duarte,1998-10-11,Mark Kerr,DQ,0,0,0,0
Maiju Kujala,2010-08-13,Miesha Tate,Decision - Unanimous,0,0,0,0
Joe Giannetti,2018-07-06,Michael Trizano,Decision - Split,0,0,0,0
Chris Hofmann,2023-05-28,SangHoon Yoo,KO/TKO,0,2,0,2
Damir Mirenic,2007-10-19,Gegard Mousasi,KO/TKO,0,0,0,0
Alejandro Flores,2020-08-25,Rafael Alves,Submission,0,13,0,13
Floyd Sword,2007-06-23,Thales Leites,Submission,0,0,0,0
Anistavio Medeiros,2012-06-23,Rodrigo Damm,Submission,0,0,0,0
Angga,2022-06-10,Lu Kai,KO/TKO,0,0,0,0
Chris Solomon,2006-08-17,Casey Olson,Decision - Unanimous,0,0,0,0
Pauline Macias,2020-11-17,Gloria de Paula,Decision - Unanimous,0,0,0,0
Peggy Morgan,2013-11-30,Jessamyn Duke,Decision - Unanimous,0,0,0,0
Stephanie Luciano,2024-08-10,Talita Alencar,Decision - Unanimous,80,31,0,111
Adrian Diaz,2017-08-15,Grant Dawson,Submission,0,0,0,0
Wataru Sakata,2003-12-31,Daniel Gracie,Submission,0,0,0,0
Chuck O'Neil,2011-06-04,Chris Cope,Decision - Unanimous,0,0,0,0
Cameron Olson,2017-08-15,Karl Reed,Decision - Unanimous,80,14,0,94
Rolles Gracie,2010-02-06,Joey Beltran,KO/TKO,0,0,0,0
Ken Cross,2020-08-18,Kevin Syler,Decision - Unanimous,80,12,0,92
Kit Cope,2005-11-05,Kenny Florian,Submission,0,0,0,0
Kit Cope,2007-01-20,Rob McCullough,Submission,0,0,25,25
Daniel Allen,2023-09-19,Jacobi Jones,Decision - Unanimous,80,26,0,106
Jacobi Jones,2023-09-19,Daniel Allen,Decision - Unanimous,0,0,0,0
Michael Imperato,2024-08-20,Cortavious Romious,Decision - Unanimous,0,0,0,0
Jay Cucciniello,2018-07-06,Brad Katona,Decision - Unanimous,0,0,0,0
Yukiya Naito,2009-01-04,Muhammed Lawal,KO/TKO,0,0,0,0
Rainy Martinez,1997-02-07,Jerry Bohlander,Submission,0,0,0,0
Kenny Ento,2006-08-17,Mario Rivera,Submission,90,23,0,113
Mario Rivera,2006-08-17,Kenny Ento,Submission,0,0,0,0
Isabela de Padua,2019-11-16,Ariane da Silva,Decision - Unanimous,0,0,0,0
Alberta Cerra Leon,1994-03-11,Remco Pardoel,Submission,0,0,0,0
Lance Gibson,2000-03-10,Jermaine Andre,KO/TKO,100,6,0,106
Lance Gibson,2000-12-16,Evan Tanner,KO/TKO,0,0,0,0
Jermaine Andre,2000-03-10,Lance Gibson,KO/TKO,0,0,0,0
Josh Rafferty,2005-04-09,Alex Karalexis,KO/TKO,0,0,0,0
Josh Copeland,2014-11-22,Ruslan Magomedov,Decision - Unanimous,0,0,0,0
Josh Copeland,2015-03-14,Jared Rosholt,KO/TKO,0,0,0,0
Tomohiko Hashimoto,2003-12-31,Alistair Overeem,KO/TKO,0,0,0,0
Robert Bryczek,2024-02-10,Ihor Potieria,Decision - Unanimous,0,0,0,0
Stephen Ledbetter,2007-08-05,Jeff Curran,Decision - Unanimous,0,0,0,0
Ulysses Gomez,2013-02-16,Phil Harris,Decision - Unanimous,0,2,0,2
Ulysses Gomez,2012-08-04,John Moraga,KO/TKO,0,0,0,0
Takeru Uchida,2022-06-09,Shaun Etchell,Submission,90,0,0,90
Shaun Etchell,2022-06-09,Takeru Uchida,Submission,0,0,0,0
Adam Antolin,2017-08-29,Casey Kenney,Decision - Split,70,11,0,81
Kelly Velasco,2017-08-29,Lauren Mueller,Decision - Unanimous,0,0,0,0
Donnie Chappell,1997-07-27,Tony Fryklund,Submission,0,0,0,0
Reinier de Ridder,2024-11-09,Gerald Meerschaert,Submission,90,8,0,98
Cory Walmsley,2006-08-26,David Heath,Submission,0,0,0,0
Ralek Gracie,2010-05-29,Kazushi Sakuraba,Decision - Unanimous,80,10,0,90
Ralek Gracie,2008-06-15,Alavutdin Gadjiev,Submission,90,0,0,90
Koichiro Matsumoto,2011-05-29,Takeshi Inoue,KO/TKO,0,0,0,0
Marcin Wrzosek,2015-12-11,Julian Erosa,Decision - Split,0,0,0,0
Zach Skinner,2008-02-23,Scott Shaffer,Decision - Unanimous,80,0,0,80
Scott Shaffer,2008-02-23,Zach Skinner,Decision - Unanimous,0,28,0,28
Jaimelene Nievera,2018-06-26,Antonina Shevchenko,KO/TKO,0,0,0,0
Jason Jackson,2017-07-25,Kyle Stewart,KO/TKO,0,5,0,5
Derrick Noble,2006-04-15,Thiago Alves,KO/TKO,0,7,0,7
Fabio Mello,2004-07-19,Takanori Gomi,KO/TKO,0,0,0,0
Maciej Jewtuszko,2010-08-18,Anthony Njokuani,KO/TKO,100,3,0,103
Maciej Jewtuszko,2011-02-26,Curt Warburton,Decision - Unanimous,0,12,0,12
Erick Wanderlei,2003-09-06,Mauricio Rua,KO/TKO,0,0,0,0
Danilo Suzart,2022-08-02,Waldo Cortes-Acosta,KO/TKO,0,0,0,0
Alfred Khashakyan,2017-07-18,Sean O'Malley,KO/TKO,0,0,0,0
Yoshinori Horie,2019-07-27,Hakeem Dawodu,KO/TKO,0,0,0,0
Georgi Karakhanyan,2012-12-31,Hiroyuki Takaya,Decision - Split,70,39,0,109
Anthony Romero,2020-08-25,Mike Breeden,Decision - Unanimous,80,28,0,108
Donovan Beard,2022-09-27,Bo Nickal,Submission,0,0,0,0
Jonas Bilharinho,2021-11-02,Canaan Kawaihae,KO/TKO,100,5,0,105
Karolina Wojcik,2022-08-09,Sandra Lavado,Decision - Unanimous,80,27,0,107
Sandra Lavado,2022-08-09,Karolina Wojcik,Decision - Unanimous,0,0,0,0
Rodrigo Ruas,2002-06-22,Tony Fryklund,KO/TKO,0,0,0,0
Aaron Wetherspoon,2007-06-22,Mike Pyle,Decision - Unanimous,0,0,0,0
Emiliano Linares,2022-09-27,Jack Jenkins,KO/TKO,0,0,0,0
Jamelle Jones,2017-08-08,Mike Rodriguez,KO/TKO,0,0,0,0
Alexander Morgan,2022-08-30,Blake Bilder,Submission,0,3,0,3
Manolo Zecchini,2023-09-02,Morgan Charriere,KO/TKO,0,0,0,0
Mike Ciesnolevicz,2009-02-21,Neil Grove,Submission,90,0,0,90
Mike Ciesnolevicz,2009-06-20,Tomasz Drwal,KO/TKO,0,0,0,0
Neil Grove,2009-02-21,Mike Ciesnolevicz,Submission,0,0,0,0
Jair Farias,2023-10-10,Connor Matthews,Decision - Unanimous,0,0,0,0
Gregory Bouchelaghem,2006-06-04,Paulo Filho,Decision - Unanimous,0,0,0,0
Frank Caracci,1999-01-08,Laverne Clark,KO/TKO,0,0,0,0
Quillan Salkilld,2024-09-03,Gauge Young,Decision - Unanimous,80,17,0,97
Gauge Young,2024-09-03,Quillan Salkilld,Decision - Unanimous,0,0,0,0
Tom Tuggle,2006-06-09,Daniel Puder,Submission,0,0,0,0
Peter Petties,2017-08-08,Julio Arce,KO/TKO,0,0,0,0
Kenji Arai,2006-04-02,Jens Pulver,KO/TKO,0,0,0,0
Brian Cobb,2009-02-21,Terry Etim,KO/TKO,0,0,0,0
Gisele Moreira,2018-08-12,Dayana Silva,Decision - Split,70,0,0,70
Dayana Silva,2018-08-12,Gisele Moreira,Decision - Split,0,6,0,6
Ron van Clief,1994-12-16,Royce Gracie,Submission,0,0,0,0
Magno Almeida,2011-06-18,Conor Heun,Decision - Unanimous,0,0,0,0
Joe Martin,2006-08-17,Clay Guida,Decision - Unanimous,0,0,0,0
Ashe Bowman,2008-09-20,Josh Thomson,KO/TKO,0,0,0,0
Eddy Ellis,2008-02-23,Steve Berger,Decision - Unanimous,80,28,0,108
Chris Padilla,2024-04-27,James Llontop,Submission,90,0,0,90
Patrick Kaase,2006-10-12,Jarrod Kwitty,KO/TKO,100,29,0,129
Jarrod Kwitty,2006-10-12,Patrick Kaase,KO/TKO,0,0,0,0
Josh Thornburg,2011-03-05,Roger Bowling,Decision - Unanimous,0,0,0,0
Acacio Dos Santos,2022-07-26,Anton Turkalj,Decision - Unanimous,0,0,0,0
Tomomi Iwama,2005-05-22,Jens Pulver,KO/TKO,0,0,0,0
Mitchell Sipe,2018-07-31,Don'Tale Mayes,KO/TKO,0,0,0,0
Ashiek Ajim,2022-09-27,Mateus Mendonca,KO/TKO,0,0,0,0
Isaiah Hill,2011-01-29,Bobby Stack,Submission,90,4,0,94
Mike Altman,2006-03-10,Cung Le,KO/TKO,0,0,0,0
Martin Svensson,2016-02-27,David Teymur,KO/TKO,0,0,0,0
Dylan Lockard,2019-08-27,TJ Brown,Submission,0,0,0,0
Stewart Nicoll,2024-08-17,Jesus Aguilar,Submission,0,5,0,5
Alexandre Franca Nogueira,2008-06-01,Jose Aldo,KO/TKO,0,0,0,0
Chris Tickle,2012-06-01,Daron Cruickshank,Decision - Unanimous,0,0,0,0
Joe Duarte,2012-07-14,Ryan Couture,Decision - Split,0,0,0,0
Collin Huckbody,2020-08-25,Kyron Bowen,Submission,90,0,0,90
Kyron Bowen,2020-08-25,Collin Huckbody,Submission,0,1,0,1
Edson Gomez,2020-11-04,Ignacio Bahamondes,KO/TKO,0,0,0,0
KyuSung Kim,2024-05-19,Tokitaka Nakanishi,Decision - Unanimous,0,10,0,10
Jack Nilson,1997-05-30,Saeed Hosseini,KO/TKO,100,10,0,110
Saeed Hosseini,1997-05-30,Jack Nilson,KO/TKO,0,0,0,0
Sione Latu,1999-03-05,Joey Roberts,TKO - Doctor's Stoppage,0,0,0,0
Joey Roberts,1999-03-05,Sione Latu,TKO - Doctor's Stoppage,0,8,0,8
Shi Ming,2024-05-18,YeDam Seo,Decision - Unanimous,80,11,0,91
YeDam Seo,2024-05-18,Shi Ming,Decision - Unanimous,0,0,0,0
YeDam Seo,2022-06-10,Josefine Knutsson,Decision - Unanimous,0,0,0,0
Richard Dalton,2007-09-29,Daniel Puder,Decision - Unanimous,0,0,0,0
Bruno Carvalho,2011-07-16,Eiji Mitsuoka,Decision - Unanimous,0,0,0,0
Joe Jordan,2006-07-08,Hermes Franca,Submission,0,0,0,0
Ricky Steele,2019-08-20,Phil Caracappa,Decision - Split,70,17,0,87
Phil Caracappa,2019-08-20,Ricky Steele,Decision - Split,0,0,0,0
Francois Botha,2004-12-31,Yoshihiro Akiyama,Submission,0,0,0,0
John Teixeira,2012-06-23,Hugo Viana,Decision - Split,0,0,0,0
Raul Castillo,2010-02-26,Yancy Medeiros,Decision - Unanimous,0,0,0,0
Trent Jenkins,1993-11-12,Jason DeLucia,Submission,0,0,0,0
Matt Skelton,2001-11-03,Tom Erikson,Submission,0,0,0,0
Kevin Szaflarski,2023-08-08,Caio Machado,Decision - Unanimous,0,0,0,0
Jesse Moreng,2007-03-24,Micah Miller,Submission,0,0,0,0
Jesse Murray,2021-10-19,Caio Borralho,KO/TKO,0,0,0,0
Alavutdin Gadjiev,2008-06-15,Ralek Gracie,Submission,0,0,0,0
