name,KO/TKO,Submission,Decision - Unanimous,Decision - Majority,Decision - Split,StrikeBonus,5roundBonus,Value
Alistair Overeem,1900,630,320,75,0,617,250,3792
Anderson Silva,1900,270,640,0,0,600,375,3785
Max Holloway,1000,180,640,0,70,1322,400,3612
Georges St-Pierre,800,540,800,0,140,892,375,3547
Gegard Mousasi,1500,630,480,0,0,670,150,3430
Donald Cerrone,1000,900,720,0,0,443,300,3363
Mauricio Rua,2100,90,240,0,140,539,225,3334
Michael Bisping,1200,90,640,0,140,698,350,3118
Jon Jones,600,540,720,0,70,742,400,3072
Dan Henderson,1600,90,400,0,350,274,275,2989
Andrei Arlovski,1100,180,720,0,210,483,225,2918
Wanderlei Silva,1700,90,320,0,140,469,100,2819
Lyoto Machida,900,180,720,0,210,505,300,2815
Dustin Poirier,1100,360,480,75,0,437,350,2802
Nick Diaz,1000,540,160,0,70,781,225,2776
Mirko Filipovic,1900,270,240,0,0,340,25,2775
Jose Aldo,1100,0,880,0,0,363,400,2743
Jim Miller,600,1170,480,0,140,292,50,2732
Fabricio Werdum,600,990,480,0,0,426,175,2671
Rafael Dos Anjos,400,450,880,0,70,485,350,2635
Nate Diaz,400,1080,240,0,70,605,200,2595
Rich Franklin,1100,450,320,0,0,534,175,2579
Neil Magny,600,180,800,0,280,606,100,2566
Vitor Belfort,1500,270,320,0,0,204,225,2519
Urijah Faber,300,1080,400,0,0,348,375,2503
Quinton Jackson,1200,0,400,0,280,511,100,2491
Kazushi Sakuraba,300,1710,240,0,0,230,0,2480
Charles Oliveira,400,1440,240,0,0,198,175,2453
Demetrious Johnson,200,540,640,0,70,650,350,2450
Daniel Cormier,800,360,480,0,70,468,250,2428
Robbie Lawler,1400,0,320,0,210,175,300,2405
Derrick Lewis,1500,0,160,0,140,301,300,2401
Fedor Emelianenko,700,810,400,0,0,427,50,2387
Frankie Edgar,400,180,800,0,70,586,350,2386
Joseph Benavidez,600,360,800,0,70,423,125,2378
Antonio Rodrigo Nogueira,300,1170,560,0,0,201,100,2331
Amanda Nunes,800,270,400,0,70,488,300,2328
Cub Swanson,700,180,800,0,70,453,100,2303
Gilbert Melendez,700,0,560,0,140,587,300,2287
Shinya Aoki,100,1440,480,0,70,124,50,2264
Jessica Andrade,600,270,480,0,140,612,150,2252
Junior Dos Santos,1000,0,400,0,0,534,300,2234
Demian Maia,100,990,640,75,70,179,175,2229
Josh Barnett,700,900,80,0,70,348,100,2198
Diego Sanchez,600,180,800,0,210,373,25,2188
Glover Teixeira,700,720,160,0,70,267,250,2167
Randy Couture,600,360,320,75,0,454,350,2159
Ovince Saint Preux,800,450,320,75,140,246,125,2156
Robert Whittaker,600,0,800,0,70,458,225,2153
Sean Strickland,400,90,560,0,280,607,200,2137
King Green,300,180,640,0,70,880,50,2120
BJ Penn,600,540,240,0,0,420,300,2100
Kamaru Usman,400,90,800,0,0,555,250,2095
Matt Hughes,600,450,400,0,0,343,300,2093
Jacare Souza,500,900,320,0,0,182,175,2077
Jorge Masvidal,600,90,640,0,70,493,175,2068
Alexander Volkanovski,500,0,560,0,70,709,225,2064
Matt Brown,1300,180,160,0,0,362,50,2052
Benson Henderson,100,450,480,0,280,389,350,2049
Chuck Liddell,1100,0,480,0,0,287,175,2042
Cain Velasquez,1200,0,160,0,0,486,175,2021
Aljamain Sterling,200,360,560,0,140,630,125,2015
Joanna Jedrzejczyk,200,0,560,0,70,894,275,1999
Edson Barboza,900,0,560,75,70,267,125,1997
Tatsuya Kawajiri,400,540,800,0,0,219,25,1984
Rogerio Nogueira,800,360,320,0,210,266,25,1981
Stipe Miocic,900,0,400,0,0,327,325,1952
Clay Guida,200,450,720,0,280,227,75,1952
Cristiane Justino,900,0,240,0,0,568,200,1908
Thiago Santos,1100,0,240,0,0,376,175,1891
TJ Dillashaw,700,90,320,0,70,472,225,1877
Darren Elkins,400,270,800,0,140,259,0,1869
Valentina Shevchenko,400,180,400,0,140,407,325,1852
Tito Ortiz,700,180,240,0,140,324,225,1809
Carlos Condit,500,360,240,0,70,383,250,1803
Igor Vovchanchyn,800,180,480,0,0,337,0,1797
Mark Coleman,700,450,320,0,0,322,0,1792
Israel Adesanya,500,0,560,0,70,332,325,1787
Takanori Gomi,900,270,240,0,140,236,0,1786
Alexander Volkov,600,90,320,0,70,527,175,1782
Tim Means,600,180,480,0,70,444,0,1774
Alex Caceres,100,360,560,0,210,516,25,1771
Tyron Woodley,600,270,240,75,210,174,200,1769
Josh Thomson,400,450,400,75,0,311,125,1761
Michael Johnson,600,0,640,0,70,390,50,1750
Ryan Bader,500,90,640,0,70,346,100,1746
Anthony Pettis,400,630,320,0,70,150,175,1745
Luke Rockhold,500,540,160,0,0,259,275,1734
Francisco Trinaldo,400,180,720,0,140,292,0,1732
Rashad Evans,700,0,400,75,280,143,125,1723
Dominick Cruz,100,0,720,0,210,416,275,1721
Kevin Holland,500,450,160,0,140,367,100,1717
Stephen Thompson,600,0,480,0,0,420,200,1700
Derek Brunson,700,180,480,0,0,205,125,1690
Islam Makhachev,300,630,400,0,0,204,150,1684
Frank Mir,500,720,160,0,0,104,200,1684
Jake Shields,100,540,400,75,210,209,150,1684
Nate Marquardt,700,270,320,0,0,293,100,1683
Mark Hunt,1000,0,80,0,140,282,150,1652
Beneil Dariush,300,450,480,0,140,255,25,1650
Rob Font,600,90,320,0,0,532,100,1642
Khabib Nurmagomedov,200,450,480,0,0,410,100,1640
Belal Muhammad,200,90,880,0,70,320,75,1635
Sean O'Malley,700,0,240,0,70,543,75,1628
Marlon Vera,700,360,320,0,0,146,100,1626
Thiago Alves,700,90,400,0,70,316,50,1626
Jeremy Stephens,700,0,480,0,70,295,75,1620
Tony Ferguson,300,540,240,0,70,361,100,1611
Ben Rothwell,900,270,160,0,140,116,25,1611
Gilbert Burns,300,450,560,0,0,195,100,1605
Curtis Blaydes,700,0,400,0,0,298,200,1598
Rani Yahya,0,990,400,0,70,107,25,1592
Ciryl Gane,400,180,240,0,70,518,175,1583
Jon Fitch,100,270,720,0,140,326,25,1581
Ikuhisa Minowa,300,990,160,0,70,61,0,1581
Yves Edwards,600,270,320,0,70,288,25,1573
Vicente Luque,700,540,80,0,70,129,50,1569
Raphael Assuncao,200,90,640,0,280,323,25,1558
Jan Blachowicz,500,180,320,0,70,310,175,1555
Colby Covington,300,180,560,0,0,314,200,1554
Dan Hooker,700,180,160,0,210,254,50,1554
Anthony Johnson,1100,0,160,0,0,193,100,1553
Ricardo Lamas,500,270,560,0,0,168,50,1548
Leon Edwards,300,90,640,75,70,195,175,1545
Gary Goodridge,1200,90,0,0,70,183,0,1543
Johny Hendricks,600,0,480,75,140,146,100,1541
Heath Herring,500,450,160,0,140,287,0,1537
Brad Tavares,200,0,800,0,210,290,25,1525
Josh Koscheck,600,270,400,0,70,146,25,1511
Chris Leben,800,270,160,0,70,148,50,1498
Anthony Smith,500,540,80,0,70,108,175,1473
Kelvin Gastelum,300,180,400,0,210,222,150,1462
Jack Hermansson,300,270,400,0,0,364,125,1459
Chad Mendes,600,90,480,0,0,162,125,1457
Rick Story,200,180,400,0,210,440,25,1455
Nik Lentz,300,180,560,0,140,271,0,1451
Raquel Pennington,0,270,560,0,210,322,75,1437
Chris Weidman,400,270,400,0,0,161,200,1431
Hayato Sakurai,600,90,480,0,0,232,25,1427
Forrest Griffin,200,270,480,0,70,349,50,1419
Yushin Okami,400,0,640,0,140,188,50,1418
John Lineker,600,90,320,0,70,284,50,1414
Miesha Tate,100,450,480,75,0,158,150,1413
Petr Yan,400,0,480,0,0,383,150,1413
Drew Dober,900,90,240,0,0,181,0,1411
Angela Hill,100,90,720,0,0,437,50,1397
Gleison Tibau,100,360,480,0,350,106,0,1396
Merab Dvalishvili,100,0,800,0,0,438,50,1388
Deiveson Figueiredo,400,360,320,0,70,61,175,1386
Alexandre Pantoja,200,450,320,0,140,171,100,1381
Randy Brown,300,270,480,0,70,260,0,1380
Yoshihiro Akiyama,500,630,80,0,70,97,0,1377
Dennis Siver,300,180,480,75,0,315,25,1375
Conor McGregor,800,0,80,75,0,141,275,1371
Rose Namajunas,200,270,320,0,140,162,275,1367
Ed Herman,400,450,240,0,70,207,0,1367
Joe Lauzon,500,630,80,0,70,84,0,1364
Alex Morono,200,180,640,0,70,274,0,1364
Tim Sylvia,500,0,320,0,0,292,250,1362
Kenny Florian,200,720,160,0,0,207,75,1362
Yair Rodriguez,400,90,240,0,140,288,200,1358
Stefan Struve,500,540,80,75,0,102,50,1347
Zhang Weili,200,180,320,0,70,398,175,1343
Thiago Silva,1000,90,80,0,0,165,0,1335
Alexander Gustafsson,500,180,240,0,0,230,175,1325
Jake Matthews,100,450,400,0,70,304,0,1324
Dong Hyun Kim,400,90,480,0,140,184,25,1319
Francis Ngannou,900,90,80,0,0,95,150,1315
Renan Barao,200,450,320,0,0,191,150,1311
John Makdessi,300,0,480,0,140,391,0,1311
Marcin Tybura,400,90,480,75,0,165,100,1310
Chris Lytle,200,540,240,0,70,256,0,1306
Cory Sandhagen,400,90,160,0,140,341,175,1306
Mike Pyle,500,360,240,0,70,134,0,1304
Tim Boetsch,700,0,240,0,140,198,25,1303
Jared Cannonier,600,0,240,0,70,217,175,1302
Evan Dunham,100,90,400,0,210,502,0,1302
Thales Leites,200,450,400,0,70,129,50,1299
Brendan Allen,100,720,240,0,70,114,50,1294
Sergei Kharitonov,800,270,0,0,70,146,0,1286
Gabriel Gonzaga,700,360,80,0,0,90,50,1280
Mark Munoz,600,0,320,0,70,189,100,1279
Li Jingliang,800,0,160,0,70,244,0,1274
Michael Chiesa,0,720,400,0,0,99,50,1269
Chael Sonnen,0,180,560,0,0,397,125,1262
Patrick Cote,700,0,320,0,70,116,50,1256
Court McGee,0,270,560,0,70,355,0,1255
Nikita Krylov,400,450,160,0,0,244,0,1254
Corey Anderson,300,0,560,0,0,362,25,1247
Cheick Kongo,600,0,240,75,0,331,0,1246
Renato Moicano,100,540,160,0,140,227,75,1242
Jairzinho Rozenstruik,800,0,0,0,70,222,150,1242
Danny Castillo,500,0,400,0,140,199,0,1239
Magomed Ankalaev,600,0,400,0,0,189,50,1239
Kevin Lee,200,360,240,0,70,218,150,1238
Gillian Robertson,200,630,240,0,0,165,0,1235
Eddie Wineland,800,0,160,0,70,153,50,1233
Henry Cejudo,400,0,320,0,140,217,150,1227
Gerald Meerschaert,100,990,0,0,0,135,0,1225
Ronda Rousey,300,630,0,0,0,44,250,1224
Alex Pereira,700,0,80,0,70,215,150,1215
Melvin Guillard,700,0,160,0,140,214,0,1214
Brandon Moreno,200,270,240,0,70,230,200,1210
Evan Tanner,400,360,160,0,0,215,75,1210
Santiago Ponzinibbio,600,0,400,0,0,160,50,1210
Brian Stann,700,90,160,0,0,183,75,1208
Marcos Rogerio de Lima,600,180,240,0,0,182,0,1202
Rousimar Palhares,0,990,160,0,0,51,0,1201
Alex Oliveira,400,270,240,0,70,194,25,1199
Tim Kennedy,300,360,240,0,0,198,100,1198
Arnold Allen,200,180,480,0,70,210,50,1190
Grant Dawson,200,450,320,0,0,193,25,1188
Royce Gracie,100,900,160,0,0,27,0,1187
Diego Ferreira,500,180,240,0,0,266,0,1186
Elizeu Zaleski dos Santos,400,90,320,0,140,235,0,1185
Scott Jorgensen,200,270,480,0,0,183,50,1183
Yan Xiaonan,100,0,560,75,0,380,50,1165
Dan Ige,400,180,240,0,140,155,50,1165
Tecia Pennington,0,90,640,0,0,432,0,1162
Maycee Barber,500,0,240,0,140,278,0,1158
Kazuhiro Nakamura,200,180,640,0,0,137,0,1157
Joanne Wood,100,90,320,0,210,433,0,1153
Matt Lindland,400,90,320,75,0,238,25,1148
Martin Kampmann,200,450,160,0,140,148,50,1148
Song Yadong,500,90,240,0,70,170,75,1145
Iuri Alcantara,400,180,320,0,70,168,0,1138
Ross Pearson,400,0,400,0,140,173,25,1138
Kennedy Nzechukwu,700,90,80,0,70,194,0,1134
Rory MacDonald,300,90,400,0,0,267,75,1132
Marina Rodriguez,300,0,320,0,70,367,75,1132
Dennis Bermudez,100,180,400,0,140,283,25,1128
Paulo Filho,100,630,160,0,70,118,50,1128
Chris Cariaso,100,90,480,0,140,290,25,1125
Chris Gutierrez,300,0,320,0,140,340,25,1125
Marvin Vettori,0,180,560,0,0,255,125,1120
Holly Holm,200,0,400,0,70,221,225,1116
Andre Fili,400,0,320,0,280,115,0,1115
Krzysztof Jotko,100,0,560,0,210,243,0,1113
Arman Tsarukyan,400,0,320,0,70,273,50,1113
Jamahal Hill,500,0,160,0,0,350,100,1110
Yoel Romero,700,0,80,0,70,131,125,1106
Dustin Jacoby,500,0,320,0,0,285,0,1105
Renato Sobral,0,540,240,75,0,174,75,1104
Sarah Kaufman,100,0,400,75,0,428,100,1103
Mike Swick,600,180,160,75,0,61,25,1101
Joaquin Buckley,600,0,160,0,70,241,25,1096
Tarec Saffiedine,100,0,560,0,70,290,75,1095
Ricco Rodriguez,600,90,160,0,0,194,50,1094
Bryan Barberena,400,90,240,0,70,291,0,1091
Justin Gaethje,600,0,80,75,0,86,250,1091
Daniel Rodriguez,200,90,320,0,140,339,0,1089
Antonio Silva,600,90,80,0,70,119,125,1084
Sara McMann,100,270,480,0,70,137,25,1082
Keith Jardine,300,90,320,0,140,207,25,1082
Jonathan Martinez,400,0,480,0,0,199,0,1079
Don Frye,600,270,0,0,70,139,0,1079
Pedro Munhoz,300,270,320,0,0,161,25,1076
Dominick Reyes,500,90,80,0,70,234,100,1074
Karolina Kowalkiewicz,0,90,480,0,140,338,25,1073
Jens Pulver,500,90,240,75,0,63,100,1068
Tyson Griffin,200,90,400,0,70,292,0,1052
Katlyn Cerminara,0,0,720,0,140,166,25,1051
Travis Browne,700,90,80,0,0,106,75,1051
Chan Sung Jung,400,180,80,0,0,136,250,1046
Joe Stevenson,200,450,240,0,0,125,25,1040
Matt Wiman,200,270,400,0,0,170,0,1040
Matt Mitrione,800,0,80,0,0,131,25,1036
Cody Garbrandt,600,0,240,0,0,68,125,1033
Takeya Mizugaki,100,0,400,0,280,224,25,1029
Josh Emmett,400,0,320,0,140,66,100,1026
Montel Jackson,400,90,320,0,0,216,0,1026
Al Iaquinta,400,0,320,0,70,160,75,1025
Roy Nelson,800,0,80,0,0,41,100,1021
James Krause,300,180,320,0,0,220,0,1020
Rafael Natal,100,90,400,0,140,264,25,1019
Germaine de Randamie,400,90,240,0,70,141,75,1016
CB Dollaway,200,180,400,0,70,138,25,1013
Miguel Torres,100,270,240,0,0,277,125,1012
Jared Gordon,200,0,400,0,70,339,0,1009
John Dodson,500,0,240,0,70,123,75,1008
Michel Pereira,200,270,240,0,70,200,25,1005
Mike Pierce,400,90,320,0,70,124,0,1004
Nasrat Haqparast,200,0,480,0,70,253,0,1003
Murilo Rua,400,180,160,0,0,213,50,1003
Tom Aspinall,600,180,0,0,0,96,125,1001
Eryk Anders,500,0,240,0,70,139,50,999
Brandon Vera,500,90,240,0,0,117,50,997
Lorenz Larkin,400,0,320,0,70,205,0,995
Sergio Pettis,0,0,640,0,70,259,25,994
Gunnar Nelson,0,720,160,0,0,62,50,992
Chase Hooper,200,360,160,0,0,272,0,992
Geoff Neal,600,90,80,0,70,125,25,990
Muhammed Lawal,600,0,160,0,0,179,50,989
Tim Elliott,0,180,560,0,0,222,25,987
Khalil Rountree Jr.,700,0,80,0,70,108,25,983
Sam Alvey,500,90,160,0,140,91,0,981
Jake Ellenberger,500,90,160,0,70,111,50,981
Kai Kara-France,300,0,320,0,70,239,50,979
Matt Hamill,500,0,240,75,0,163,0,978
James Vick,200,270,320,0,0,162,25,977
Cung Le,600,0,80,0,0,220,75,975
Gray Maynard,100,0,560,0,210,53,50,973
Elias Theodorou,200,0,400,0,70,301,0,971
Mitsuhiro Ishida,0,180,560,0,70,136,25,971
Carla Esparza,100,90,320,75,210,76,100,971
Johnny Walker,500,90,160,0,0,140,75,965
Alan Jouban,400,0,320,0,0,243,0,963
Zak Cummings,200,360,320,0,0,82,0,962
Caio Borralho,200,90,480,0,0,166,25,961
Cole Miller,100,630,160,0,0,71,0,961
Phil Davis,0,180,480,0,0,273,25,958
Brian Ortega,300,360,80,0,0,67,150,957
Frank Shamrock,300,450,0,0,0,106,100,956
Paul Craig,300,540,0,0,0,91,25,956
Louis Smolka,400,180,160,0,0,214,0,954
Dricus Du Plessis,400,180,80,0,70,174,50,954
Ian Machado Garry,300,0,320,0,70,238,25,953
Anthony Njokuani,500,0,160,0,0,292,0,952
Tai Tuivasa,700,0,80,0,0,94,75,949
Aleksei Oleinik,100,630,0,0,70,72,75,947
Alonzo Menifield,500,180,160,0,0,106,0,946
Alex Perez,300,270,160,0,0,138,75,943
Billy Quarantillo,400,90,160,0,0,293,0,943
Paul Felder,400,90,160,0,140,101,50,941
Mackenzie Dern,0,360,240,0,140,125,75,940
Thiago Tavares,100,450,320,0,0,66,0,936
Carlos Ulberg,500,90,160,0,0,183,0,933
Julianna Pena,200,180,240,0,70,142,100,932
Ben Saunders,300,270,160,0,70,132,0,932
Nathaniel Wood,0,270,400,0,0,261,0,931
Michelle Waterson-Gomez,0,360,160,0,140,145,125,930
Volkan Oezdemir,400,90,80,0,140,169,50,929
Serghei Spivac,300,270,80,75,0,128,75,928
Mario Bautista,100,270,320,0,70,168,0,928
Michel Prazeres,0,270,320,0,210,125,0,925
Charles Jourdain,200,270,160,0,0,295,0,925
Mike Brown,200,180,320,0,0,120,100,920
Drakkar Klose,200,0,480,0,70,168,0,918
Rafael Cavalcante,800,0,0,0,0,68,50,918
Nassourdine Imavov,300,0,240,75,0,227,75,917
Ilia Topuria,500,90,160,0,0,92,75,917
Eddie Alvarez,400,90,80,0,140,131,75,916
Jorge Rivera,500,0,160,0,70,185,0,915
Norma Dumont,0,0,560,0,70,260,25,915
Jailton Almeida,200,450,80,0,0,130,50,910
Movsar Evloev,0,0,640,0,70,199,0,909
Amanda Lemos,300,180,160,0,70,98,100,908
KJ Noons,400,0,240,0,70,121,75,906
Jack Della Maddalena,400,90,80,0,140,195,0,905
Bruno Silva,700,90,0,0,0,115,0,905
Marcus Davis,300,360,80,0,70,95,0,905
Guy Mezger,400,90,240,0,0,175,0,905
Dustin Ortiz,400,0,80,0,210,211,0,901
Alexa Grasso,0,180,400,0,70,174,75,899
Chris Camozzi,100,90,320,0,140,248,0,898
Uriah Hall,600,0,80,0,70,71,75,896
Gian Villante,500,0,80,0,210,103,0,893
Julio Arce,400,90,160,0,0,240,0,890
Hiroyuki Takaya,500,0,160,0,70,135,25,890
Jamie Varner,400,90,0,0,140,155,100,885
Manvel Gamburyan,100,270,400,0,0,90,25,885
Omari Akhmedov,200,90,400,0,70,124,0,884
Anthony Rocco Martin,100,270,400,0,0,114,0,884
Aaron Simpson,300,0,320,0,70,192,0,882
Anthony Hernandez,200,360,80,0,0,216,25,881
Manon Fiorot,200,0,400,0,0,256,25,881
Khamzat Chimaev,200,360,80,75,0,114,50,879
Jeremy Horn,200,360,240,0,0,53,25,878
Sean Woodson,300,0,240,0,140,198,0,878
Ryan Spann,300,360,80,0,70,41,25,876
Alexis Davis,100,90,400,0,140,121,25,876
Sean Sherk,0,90,480,0,70,133,100,873
Irene Aldana,300,90,240,0,70,121,50,871
Ricky Simon,100,270,240,0,140,93,25,868
Amanda Ribas,100,180,320,0,0,242,25,867
John Moraga,200,270,160,0,70,141,25,866
Shane Burgos,200,90,240,75,70,190,0,865
Roman Dolidze,500,0,160,0,70,108,25,863
Davey Grant,300,90,160,0,70,243,0,863
Sam Stout,100,0,400,0,210,152,0,862
Ken Shamrock,300,450,0,0,0,85,25,860
Devin Clark,100,0,560,0,0,174,25,859
Ilir Latifi,300,180,240,0,70,69,0,859
Giga Chikadze,300,0,240,0,140,127,50,857
Ion Cutelaba,400,0,160,0,70,227,0,857
Pedro Rizzo,600,0,80,0,70,31,75,856
Bibiano Fernandes,100,270,240,0,140,106,0,856
Alan Belcher,400,270,0,0,70,112,0,852
Myles Jury,300,90,240,0,70,149,0,849
Joachim Hansen,300,270,80,0,140,59,0,849
Spencer Fisher,200,180,320,0,0,147,0,847
TJ Grant,300,90,240,0,70,144,0,844
Julian Erosa,200,360,80,0,140,63,0,843
Lerone Murphy,200,0,320,0,70,228,25,843
Calvin Kattar,400,0,240,0,0,76,125,841
JJ Aldrich,100,0,560,0,70,109,0,839
Rustam Khabilov,100,0,560,0,70,83,25,838
Kyler Phillips,200,90,320,0,0,227,0,837
Nate Quarry,500,0,160,0,0,151,25,836
Ignacio Bahamondes,400,90,80,0,0,265,0,835
JunYong Park,0,270,160,75,140,189,0,834
David Abbott,500,180,80,0,0,72,0,832
Vladimir Matyushenko,300,0,320,0,70,115,25,830
Max Griffin,300,0,160,75,140,155,0,830
Brandon Royval,100,270,0,0,210,174,75,829
Steve Garcia,700,0,0,0,0,128,0,828
Duane Ludwig,300,0,240,0,70,216,0,826
Erin Blanchfield,0,270,320,0,0,160,75,825
Jalin Turner,400,270,0,0,0,153,0,823
John Hathaway,100,0,400,0,70,226,25,821
Mark Kerr,200,450,80,0,0,90,0,820
Liz Carmouche,200,0,320,0,70,152,75,817
Gabriel Benitez,300,180,160,0,0,177,0,817
Paul Daley,700,0,0,0,0,67,50,817
Akira Shoji,200,270,160,0,140,46,0,816
Raoni Barcelos,200,180,240,0,0,195,0,815
Kevin Randleman,200,0,400,0,0,139,75,814
Muslim Salikhov,400,0,160,0,140,113,0,813
Tatiana Suarez,100,360,160,0,0,193,0,813
Erik Koch,300,180,240,0,0,90,0,810
Niko Price,400,180,160,0,0,70,0,810
Phil Baroni,500,90,80,0,0,114,25,809
Mark Bocek,0,360,240,0,70,138,0,808
Joe Riggs,400,90,160,0,0,158,0,808
Ricardo Almeida,0,270,400,0,0,134,0,804
Alejandro Perez,300,90,240,0,70,104,0,804
Karol Rosa,0,0,320,75,140,267,0,802
Luana Carolina,100,0,400,0,70,231,0,801
Joel Alvarez,400,270,0,0,0,131,0,801
Karo Parisyan,100,90,400,0,70,140,0,800
Gregory Rodrigues,500,0,160,0,0,139,0,799
Thiago Moises,200,270,240,0,0,63,25,798
Stephan Bonnar,200,180,320,0,0,97,0,797
Kyoji Horiguchi,200,0,400,0,0,165,25,790
Trevin Giles,300,0,160,0,140,188,0,788
Sodiq Yusuff,200,90,320,0,0,151,25,786
Marc Diakiese,200,0,400,0,70,115,0,785
Carlos Newton,0,450,160,0,70,27,75,782
Edmen Shahbazyan,500,90,0,0,70,121,0,781
Shawn Jordan,600,90,0,0,0,91,0,781
Ricardo Arona,200,90,240,0,140,105,0,775
Jordan Mein,300,0,240,0,70,164,0,774
Bryce Mitchell,100,90,400,75,0,109,0,774
Brian Kelleher,200,270,240,0,0,64,0,774
Alexandr Romanov,100,270,160,0,70,174,0,774
Jussier Formiga,0,270,480,0,0,21,0,771
Hakeem Dawodu,100,0,160,0,210,301,0,771
Lauren Murphy,200,90,160,0,210,84,25,769
Cezar Ferreira,0,270,320,0,140,38,0,768
Umar Nurmagomedov,100,180,240,0,0,222,25,767
Miranda Maverick,0,180,400,0,0,185,0,765
Dan Severn,0,450,160,0,70,84,0,764
Gregor Gillespie,400,180,80,0,0,101,0,761
Kyung Ho Kang,0,360,80,0,210,108,0,758
Fabio Maldonado,200,0,160,0,70,302,25,757
Nordine Taleb,200,0,320,0,70,166,0,756
Hideo Tokoro,100,180,320,0,70,86,0,756
Sean Brady,0,270,320,0,0,139,25,754
Jonathan Pearce,300,90,160,0,0,204,0,754
Ryan LaFlare,0,0,560,0,0,167,25,752
Molly McCann,200,90,320,0,0,142,0,752
Kiyoshi Tamura,400,90,160,0,0,101,0,751
Michal Oleksiejczuk,600,0,0,0,70,80,0,750
Bryan Battle,300,180,80,0,70,120,0,750
Erick Silva,200,450,0,0,0,74,25,749
Cody Stamann,100,0,320,0,140,189,0,749
Dan Miller,0,540,80,0,70,27,25,742
Shane Roller,100,450,160,0,0,31,0,741
Shavkat Rakhmonov,100,450,80,0,0,86,25,741
George Roop,300,0,160,0,70,210,0,740
Macy Chiasson,200,180,160,0,70,130,0,740
Adrian Yanez,600,0,0,0,70,69,0,739
Chas Skelly,200,360,160,0,0,17,0,737
Mateusz Gamrot,300,90,160,0,70,66,50,736
Taylor Lapilus,100,0,400,0,0,234,0,734
Tanner Boser,300,0,160,0,0,272,0,732
Sergei Pavlovich,600,0,0,0,0,82,50,732
Natalia Silva,200,0,320,0,0,211,0,731
Hermes Franca,200,270,160,0,0,51,50,731
Alexander Hernandez,300,0,240,0,70,120,0,730
Murilo Bustamante,200,270,160,0,0,50,50,730
Said Nurmagomedov,200,270,80,0,70,109,0,729
Walt Harris,600,0,0,0,0,104,25,729
Warlley Alves,200,270,160,0,0,98,0,728
Vinc Pichel,100,0,480,0,0,148,0,728
Amir Sadollah,100,90,240,0,70,228,0,728
Michael McDonald,200,270,80,0,70,58,50,728
Jimmie Rivera,100,0,400,0,70,132,25,727
Antonio Banuelos,0,0,400,0,210,115,0,725
Mike Perry,400,0,160,0,70,95,0,725
Mairbek Taisumov,500,0,160,0,0,63,0,723
Paulo Costa,400,0,160,0,0,87,75,722
Stevie Ray,200,0,160,150,70,142,0,722
Mark Hominick,200,270,80,0,70,77,25,722
Augusto Sakai,300,0,80,0,140,150,50,720
Brian Bowles,200,360,80,0,0,30,50,720
Pat Miletich,100,270,80,0,140,55,75,720
Aleksandar Rakic,200,0,320,0,0,173,25,718
Kurt Pellegrino,100,360,160,0,0,98,0,718
Greg Hardy,500,0,80,0,0,137,0,717
Scott Holtzman,100,90,320,0,0,207,0,717
Randa Markos,0,90,320,0,140,166,0,716
Andre Muniz,0,360,240,0,70,46,0,716
Akihiro Gono,0,360,240,0,70,44,0,714
George Sotiropoulos,100,360,160,0,0,68,25,713
Patrick Cummins,200,0,240,0,70,201,0,711
Brock Lesnar,300,90,80,0,0,116,125,711
Paul Buentello,500,90,0,0,0,70,50,710
Miles Johns,200,0,320,0,70,119,0,709
Denis Kang,200,180,240,0,0,89,0,709
Matt Serra,200,90,160,75,70,64,50,709
Tatsuro Taira,200,180,160,0,0,118,50,708
Nicolas Dalby,100,0,320,0,140,145,0,705
Roger Huerta,300,90,160,0,0,154,0,704
Yancy Medeiros,200,270,80,0,70,55,25,700
Andrea Lee,100,90,240,0,0,269,0,699
Ludovit Klein,200,0,320,0,70,109,0,699
Erik Perez,200,90,240,0,70,99,0,699
Darren Till,200,0,240,0,70,39,150,699
Antonio Carlos Junior,0,450,160,0,0,88,0,698
Ricardo Ramos,200,90,240,0,140,27,0,697
Waldo Cortes-Acosta,200,0,320,0,0,176,0,696
Kendall Grove,200,180,80,0,140,94,0,694
Kyle Noke,300,180,0,0,70,141,0,691
Ray Borg,0,180,400,0,0,86,25,691
Loopy Godinez,0,180,240,0,140,129,0,689
Sergio Moraes,100,270,160,0,140,15,0,685
Charles Johnson,200,0,240,0,70,174,0,684
Claudia Gadelha,0,90,320,0,140,109,25,684
Douglas Silva de Andrade,200,90,320,0,0,72,0,682
Brad Pickett,100,180,240,0,140,21,0,681
Leonardo Santos,200,180,160,0,70,71,0,681
Kazuyuki Fujita,300,180,160,0,0,41,0,681
Olivier Aubin-Mercier,100,360,80,0,70,71,0,681
Cortney Casey,100,180,160,0,70,166,0,676
Joshua Van,100,0,240,0,70,265,0,675
Matheus Nicolau,100,90,240,0,140,79,25,674
Ketlen Vieira,0,90,320,0,210,3,50,673
Gina Carano,200,90,240,0,0,115,25,670
Michael Morales,300,0,240,0,0,130,0,670
Chris Curtis,400,0,80,0,70,93,25,668
Loma Lookboonmee,0,90,320,0,70,187,0,667
Casey O'Neill,200,90,80,0,70,226,0,666
Jasmine Jasudavicius,0,180,400,0,0,85,0,665
Danny Roberts,300,90,80,0,140,54,0,664
Ariane da Silva,0,180,240,0,70,174,0,664
Viviane Araujo,100,0,480,0,0,55,25,660
Andre Petroski,100,180,240,0,70,69,0,659
Pat Healy,0,180,400,0,0,79,0,659
Sage Northcutt,200,90,240,0,0,129,0,659
Matthew Riddle,100,0,320,0,70,168,0,658
Don'Tale Mayes,400,0,160,0,0,98,0,658
Zabit Magomedsharipov,0,270,240,0,0,147,0,657
Punahele Soriano,300,0,160,0,0,196,0,656
Luke Stewart,300,270,0,0,0,86,0,656
Jack Shore,0,270,160,0,70,154,0,654
Diego Nunes,0,0,400,0,140,114,0,654
Lavar Johnson,500,0,0,0,0,153,0,653
Chad Laprise,300,0,160,0,70,122,0,652
Benoit Saint Denis,300,180,0,0,0,122,50,652
Alessio Sakara,400,0,80,0,70,100,0,650
Cynthia Calvillo,0,270,240,0,0,113,25,648
Bill Algeo,100,90,240,0,0,217,0,647
Brendan Schaub,300,90,160,0,0,97,0,647
Shane Carwin,500,0,0,0,0,96,50,646
Misha Cirkunov,100,450,0,0,0,89,0,639
Chidi Njokuani,300,0,80,0,70,189,0,639
Muhammad Mokaev,0,360,240,0,0,39,0,639
Yana Santos,0,0,400,0,0,213,25,638
Rafael Fiziev,300,0,240,0,0,46,50,636
Hidehiko Yoshida,0,540,80,0,0,16,0,636
James Thompson,500,0,0,0,0,136,0,636
Paige VanZant,200,180,80,0,0,126,50,636
Song Kenan,300,0,240,0,0,95,0,635
Makwan Amirkhani,100,360,80,0,70,25,0,635
Tyson Pedro,400,180,0,0,0,53,0,633
Fares Ziam,100,0,240,75,70,145,0,630
Youssef Zalal,0,270,240,0,0,119,0,629
Wilson Reis,0,180,400,0,0,23,25,628
Frank Trigg,300,0,160,0,0,117,50,627
Mirsad Bektic,200,90,80,75,70,112,0,627
Abdul Razak Alhassan,600,0,0,0,0,26,0,626
Jennifer Maia,0,90,400,0,0,108,25,623
Trevor Smith,0,90,320,0,70,142,0,622
Semmy Schilt,400,180,0,0,0,41,0,621
Joselyne Edwards,0,90,160,0,140,230,0,620
Aleksander Emelianenko,300,180,0,0,70,70,0,620
Antonina Shevchenko,200,90,80,0,70,179,0,619
Bryan Caraway,0,450,80,0,70,19,0,619
Brock Larson,200,270,80,0,0,44,25,619
Daron Cruickshank,300,0,160,0,70,88,0,618
Phil Hawes,300,0,80,75,0,163,0,618
Khaos Williams,400,0,80,0,70,68,0,618
Ryan Couture,100,180,0,75,140,120,0,615
Tracy Cortez,0,0,400,0,70,119,25,614
Uros Medic,500,0,0,0,0,112,0,612
Eugene Jackson,300,180,80,0,0,27,25,612
Casey Kenney,0,90,400,0,0,120,0,610
Matt Frevola,300,90,80,0,70,68,0,608
Tom Lawlor,200,180,160,0,0,67,0,607
Wilson Gouveia,200,360,0,0,0,46,0,606
Maurice Smith,100,270,80,0,70,85,0,605
Dooho Choi,500,0,0,0,0,79,25,604
Paddy Pimblett,100,270,160,0,0,70,0,600
Thomas Almeida,400,0,80,0,0,93,25,598
Marion Reneau,200,180,80,0,0,137,0,597
Jason MacDonald,200,360,0,0,0,36,0,596
Enrique Barzola,0,0,400,0,70,126,0,596
Terry Etim,100,360,80,0,0,55,0,595
Mayra Bueno Silva,0,450,80,0,0,40,25,595
Marcin Prachnio,100,0,240,0,0,255,0,595
Denise Gomes,200,0,160,0,70,163,0,593
Jessica Penne,100,270,0,0,140,7,75,592
Jared Rosholt,100,0,400,0,0,90,0,590
Joshua Burkman,100,90,240,0,70,90,0,590
Jeff Monson,100,270,80,0,70,42,25,587
Melvin Manhoef,500,0,0,0,0,85,0,585
Ryo Chonan,0,90,240,0,140,115,0,585
Christos Giagos,100,180,240,0,0,65,0,585
Sijara Eubanks,100,0,320,0,0,163,0,583
Azamat Murzakanov,400,0,80,0,0,103,0,583
Constantinos Philippou,300,0,160,0,70,27,25,582
Manel Kape,300,0,160,0,0,121,0,581
Jake Collier,100,90,160,0,70,161,0,581
John Howard,200,0,80,0,280,20,0,580
Montana De La Rosa,100,270,80,0,70,59,0,579
Rameau Thierry Sokoudjou,500,0,0,0,0,78,0,578
James Te Huna,300,0,160,0,0,93,25,578
Ramsey Nijem,200,0,240,0,0,137,0,577
Josh Neer,0,270,160,0,0,146,0,576
Efrain Escudero,100,90,240,0,0,146,0,576
Francis Carmont,0,180,240,0,70,86,0,576
Joe Solecki,0,270,160,75,0,70,0,575
Aiemann Zahabi,200,0,320,0,0,53,0,573
Pannie Kianzad,0,0,400,0,0,171,0,571
Cody Durden,100,90,320,0,0,60,0,570
Abel Trujillo,300,90,80,0,0,99,0,569
Pat Sabatini,0,270,240,0,0,54,0,564
Bo Nickal,100,360,80,0,0,23,0,563
Paul Kelly,100,90,240,0,0,133,0,563
Tom Breese,400,0,80,0,0,81,0,561
Terrance McKinney,300,180,0,0,0,80,0,560
Damon Jackson,100,180,160,0,70,50,0,560
Joe Pyfer,400,90,0,0,0,45,25,560
Dan Hardy,200,0,160,0,140,35,25,560
Marius Zaromskis,300,0,160,0,0,74,25,559
Bethe Correia,100,0,160,0,140,108,50,558
Nina Nunes,0,90,240,0,70,158,0,558
Marc-Andre Barriault,200,90,160,0,0,106,0,556
Kazuo Misaki,100,0,240,0,140,75,0,555
Maryna Moroz,0,180,240,0,70,64,0,554
Taila Santos,0,90,320,0,0,118,25,553
Chase Sherman,300,0,80,0,0,173,0,553
Marlon Moraes,200,90,0,0,140,23,100,553
Martin Buday,100,90,160,0,140,63,0,553
Mickey Gall,0,450,80,0,0,22,0,552
Jimmy Crute,300,180,0,0,0,72,0,552
Rashid Magomedov,100,0,240,0,70,141,0,551
Matt Schnell,0,270,80,0,140,61,0,551
Virna Jandiroba,0,270,240,0,0,16,25,551
Brian Ebersole,100,0,240,0,140,70,0,550
Carlos Prates,500,0,0,0,0,24,25,549
Krzysztof Soszynski,100,180,160,0,0,108,0,548
Tony Gravely,300,0,80,0,70,98,0,548
Daniel Pineda,100,360,0,0,0,87,0,547
Joaquim Silva,300,0,80,0,140,27,0,547
Roman Kopylov,400,0,0,0,70,75,0,545
Leonard Garcia,200,90,0,0,210,16,25,541
John Alessio,0,270,160,0,0,85,25,540
Yves Jabouin,0,0,240,0,210,89,0,539
Mateusz Rebecki,100,180,80,0,70,108,0,538
Daniel Kelly,100,90,240,0,70,38,0,538
Mac Danzig,100,180,160,0,0,95,0,535
Armen Petrosyan,100,0,160,0,70,205,0,535
Jamie Mullarkey,200,0,160,0,70,104,0,534
Tabatha Ricci,0,90,320,0,70,54,0,534
William Knight,300,0,160,0,0,73,0,533
Caol Uno,100,90,240,0,0,77,25,532
Robert Peralta,200,0,80,0,140,112,0,532
Diego Lopes,200,90,160,0,0,80,0,530
Scott Smith,500,0,0,0,0,5,25,530
Oleg Taktarov,0,450,80,0,0,0,0,530
Justin Scoggins,100,0,240,0,0,189,0,529
Rinya Nakamura,200,90,160,0,0,78,0,528
Farid Basharat,0,90,320,0,0,118,0,528
Nate Maness,200,90,160,0,0,78,0,528
Javid Basharat,0,90,240,0,0,198,0,528
Cyrille Diabate,100,90,80,75,0,182,0,527
Chris Daukaus,400,0,0,0,0,76,50,526
Jiri Prochazka,300,90,0,0,0,34,100,524
David Onama,200,90,160,0,0,73,0,523
John Castaneda,100,90,240,0,0,92,0,522
Payton Talbott,200,90,80,0,0,152,0,522
Luis Pena,100,90,160,0,70,101,0,521
Amir Albazi,100,180,80,0,70,39,50,519
Joanderson Brito,200,180,80,0,0,59,0,519
David Teymur,200,0,240,0,0,76,0,516
Roosevelt Roberts,0,270,160,0,0,85,0,515
Jason High,0,270,80,0,140,24,0,514
Mick Parkin,100,90,240,0,0,84,0,514
Shamil Abdurakhimov,200,0,160,0,70,59,25,514
Marloes Coenen,0,360,0,0,0,53,100,513
Diego Brandao,100,180,160,0,0,46,25,511
Daniel Marcos,100,0,160,0,140,111,0,511
Mike Malott,100,270,80,0,0,59,0,509
Ron Waterman,100,180,160,0,0,68,0,508
Cameron Saaiman,300,0,0,75,0,133,0,508
Anthony Perosh,200,270,0,0,0,37,0,507
Doug Marshall,300,90,0,0,0,42,75,507
Karl Roberson,100,180,80,0,70,77,0,507
Albert Tumenov,300,0,80,0,70,55,0,505
Katsunori Kikuno,200,90,160,0,0,55,0,505
Leslie Smith,200,0,160,0,0,145,0,505
Dusko Todorovic,300,0,80,0,0,125,0,505
Damir Ismagulov,0,0,320,0,70,114,0,504
Steven Siler,100,90,240,0,0,74,0,504
Darren Stewart,200,90,80,0,70,64,0,504
Norman Parke,100,0,320,0,0,84,0,504
Christian Rodriguez,0,90,240,0,70,102,0,502
Jose Quinonez,0,90,320,0,0,92,0,502
Matthew Semelsberger,200,0,240,0,0,62,0,502
Jacob Volkmann,0,90,240,0,140,31,0,501
Nate Landwehr,100,180,80,75,0,65,0,500
,100,0,0,0,0,0,400,500
Marco Ruas,100,360,0,0,0,39,0,499
Pat Barry,400,0,80,0,0,18,0,498
Ivan Salaverry,200,180,0,0,0,117,0,497
Zubaira Tukhugov,200,0,160,0,70,66,0,496
Frankie Saenz,0,0,240,0,140,116,0,496
Makhmud Muradov,200,0,160,0,0,135,0,495
Jason Miller,100,180,80,0,0,84,50,494
Shara Magomedov,200,0,160,0,0,134,0,494
Jordan Leavitt,200,180,0,0,70,44,0,494
Rongzhu,200,90,80,0,0,123,0,493
Andrew Sanchez,100,0,320,0,0,73,0,493
Sam Sicilia,300,0,160,0,0,31,0,491
Drew Fickett,0,360,80,0,0,50,0,490
Ryan Hall,0,90,320,0,0,79,0,489
Siyar Bahadurzada,300,90,0,0,0,98,0,488
Josefine Knutsson,0,0,320,0,0,168,0,488
Bart Palaszewski,300,90,0,0,70,27,0,487
Jason Lambert,300,90,0,0,0,96,0,486
Felipe Arantes,100,180,160,0,0,46,0,486
Dustin Hazelett,0,360,80,0,0,46,0,486
Ryan Gracie,200,180,0,0,70,35,0,485
Paulo Thiago,100,90,240,0,0,54,0,484
Jordan Espinosa,100,90,160,0,0,133,0,483
Alex White,200,0,160,0,0,122,0,482
Seth Baczynski,100,180,80,0,70,51,0,481
Jessica Eye,0,0,160,0,140,131,50,481
Marcus Aurelio,100,180,160,0,0,41,0,481
Vitor Petrino,200,90,160,0,0,30,0,480
Francisco Rivera,300,0,80,0,0,100,0,480
Rinat Fakhretdinov,0,90,240,0,70,79,0,479
Raul Rosas Jr.,100,180,160,0,0,39,0,479
Godofredo Pepey,100,270,0,0,70,38,0,478
Marcus McGhee,200,90,80,0,0,106,0,476
Ali Bagautinov,100,0,240,0,0,110,25,475
Ben Nguyen,100,180,80,0,0,114,0,474
Paul Taylor,200,0,80,0,70,123,0,473
Charles Rosa,0,180,80,0,140,72,0,472
Rob McCullough,100,90,0,75,70,62,75,472
Esteban Ribovics,200,0,80,0,70,122,0,472
Jack Jenkins,200,0,80,0,70,121,0,471
Aspen Ladd,300,0,80,0,0,41,50,471
Melsik Baghdasaryan,100,0,240,0,0,131,0,471
Brett Rogers,400,0,0,0,0,45,25,470
Jimi Manuwa,300,0,80,0,0,65,25,470
Charlie Valencia,100,90,160,0,70,49,0,469
Gavin Tucker,0,180,160,0,0,127,0,467
Karine Silva,0,360,80,0,0,27,0,467
Alex Garcia,200,90,80,0,70,25,0,465
Antoni Hardonk,400,0,0,0,0,64,0,464
Soa Palelei,400,0,0,0,0,63,0,463
Claudio Silva,0,270,80,0,70,43,0,463
Kenny Robertson,100,180,80,0,0,100,0,460
Mike Kyle,200,90,80,0,0,89,0,459
Brett Johns,0,180,240,0,0,39,0,459
Jerry Bohlander,0,360,80,0,0,18,0,458
Jacob Malkoun,100,0,240,0,0,116,0,456
Ricky Glenn,100,0,80,0,140,136,0,456
Ramazan Emeev,0,0,320,0,70,65,0,455
Claudio Puelles,0,270,160,0,0,25,0,455
Rodrigo Nascimento,0,180,80,0,140,30,25,455
Steve Cantwell,200,180,0,0,0,50,25,455
Ode Osbourne,200,90,80,0,70,14,0,454
Johnny Case,100,90,160,0,0,103,0,453
Marco Polo Reyes,300,0,0,0,70,82,0,452
Alan Patrick,100,0,320,0,0,32,0,452
Din Thomas,0,180,160,0,70,40,0,450
Themba Gorimbo,100,0,240,0,0,110,0,450
Rodolfo Vieira,0,450,0,0,0,0,0,450
SeungWoo Choi,100,0,240,0,0,109,0,449
Jeff Molina,100,0,160,0,70,119,0,449
Luiz Cane,300,0,80,0,0,69,0,449
Dean Lister,0,270,160,0,0,19,0,449
Phil Rowe,400,0,0,0,0,48,0,448
Chris Wade,0,180,240,0,0,28,0,448
Oban Elliott,100,0,160,75,0,112,0,447
Desmond Green,100,0,160,0,70,114,0,444
Rafa Garcia,0,90,240,0,0,112,0,442
Adlan Amagov,300,0,80,0,0,62,0,442
Lando Vannata,100,90,80,0,70,100,0,440
Maximo Blanco,100,0,240,0,0,99,0,439
Terry Martin,400,0,0,0,0,37,0,437
Trevor Prangley,0,180,160,0,0,97,0,437
Manuel Torres,300,90,0,0,0,46,0,436
Sabina Mazo,0,90,80,0,70,196,0,436
Viacheslav Borshchev,300,0,0,0,70,66,0,436
Alex Karalexis,200,0,80,75,0,81,0,436
Ian Heinisch,200,0,160,0,0,75,0,435
Jessica-Rose Clark,100,0,160,0,70,104,0,434
Drew McFedries,400,0,0,0,0,34,0,434
Dustin Stoltzfus,200,90,80,0,0,62,0,432
Victor Henry,100,0,80,0,70,181,0,431
Damir Hadzovic,200,0,80,0,70,80,0,430
Peter Sobotta,100,90,160,0,0,80,0,430
Julian Marquez,100,270,0,0,0,59,0,429
Felice Herrig,0,180,160,0,70,19,0,429
Daniel Omielanczuk,200,0,0,150,0,78,0,428
CJ Vergara,200,0,80,0,70,77,0,427
Alatengheili,100,0,240,0,70,17,0,427
Impa Kasanganay,0,90,240,0,0,97,0,427
Miguel Baeza,200,90,80,0,0,56,0,426
Aaron Riley,100,0,240,0,0,85,0,425
Tamdan McCrory,100,180,80,0,0,65,0,425
Jason Knight,100,90,80,0,70,83,0,423
Brunno Ferreira,400,0,0,0,0,22,0,422
Tafon Nchukwi,100,0,160,0,0,162,0,422
Brad Katona,0,0,320,0,0,102,0,422
Sam Hughes,100,0,80,75,70,96,0,421
Keita Nakamura,0,180,0,0,210,31,0,421
Rich Clementi,0,270,80,0,70,1,0,421
HyunSung Park,200,180,0,0,0,39,0,419
Justin Tafa,400,0,0,0,0,19,0,419
Jeremiah Wells,200,90,0,0,70,59,0,419
Ailin Perez,0,90,240,0,0,88,0,418
Mitch Gagnon,0,270,80,0,0,67,0,417
Luke Sanders,100,90,80,0,0,146,0,416
Luigi Fioravanti,200,0,160,0,0,56,0,416
Joe Proctor,200,90,80,0,0,45,0,415
Omar Morales,100,0,240,0,0,74,0,414
Guido Cannetti,100,90,160,0,0,64,0,414
Elise Reed,0,0,240,0,70,104,0,414
Dwight Grant,200,0,0,0,140,74,0,414
Chepe Mariscal,100,0,160,0,70,83,0,413
Dennis Hallman,100,180,80,0,0,28,25,413
TJ Brown,0,180,80,0,70,83,0,413
Kajan Johnson,100,0,160,0,70,82,0,412
Justin Willis,100,0,240,0,0,70,0,410
Roxanne Modafferi,100,0,160,0,70,30,50,410
Ivan Menjivar,100,180,80,0,0,50,0,410
Brad Riddell,0,0,240,0,70,98,0,408
Jake Hadley,100,180,80,0,0,48,0,408
Hatsu Hioki,0,0,240,0,70,98,0,408
Polyana Viana,100,270,0,0,0,37,0,407
Gabriel Bonfim,0,270,80,0,0,57,0,407
Lina Lansberg,0,0,320,0,0,61,25,406
Daniel Zellhuber,0,90,240,0,0,76,0,406
Cheyanne Vlismas,100,0,160,0,0,144,0,404
Jon Madsen,100,0,160,0,70,73,0,403
Mike Davis,100,90,160,0,0,53,0,403
Josh Grispi,100,270,0,0,0,32,0,402
Priscila Cachoeira,300,0,80,0,0,22,0,402
Christian Leroy Duncan,300,0,0,0,0,101,0,401
Felicia Spencer,200,90,0,0,0,85,25,400
Josh Parisian,300,0,0,0,70,30,0,400
Nikolas Motta,200,0,160,0,0,40,0,400
Veronica Hardy,0,90,160,0,70,79,0,399
Igor Pokrajac,200,90,80,0,0,29,0,399
Rei Tsuruya,100,90,160,0,0,48,0,398
Kyle Nelson,200,0,160,0,0,37,0,397
Chris Duncan,100,90,80,0,70,56,0,396
Sean Pierson,0,0,240,75,0,81,0,396
Carlston Harris,100,180,80,0,0,36,0,396
Parker Porter,100,0,240,0,0,55,0,395
Joe Duffy,100,180,80,0,0,35,0,395
Roger Gracie,0,270,80,0,0,45,0,395
Kevin Ferguson,300,0,80,0,0,15,0,395
David Branch,100,0,160,0,70,40,25,395
Ian McCall,100,0,160,0,0,134,0,394
Vanessa Demopoulos,0,90,160,0,140,4,0,394
Piera Rodriguez,0,0,320,0,0,74,0,394
Tsuyoshi Kohsaka,200,0,160,0,0,33,0,393
Rodrigo Gracie,0,90,240,0,0,63,0,393
Patrick Smith,100,270,0,0,0,23,0,393
Andre Ewell,0,0,80,0,210,103,0,393
Michihiro Omigawa,100,180,80,0,0,32,0,392
Caio Magalhaes,200,90,80,0,0,22,0,392
Ismail Naurdiev,0,0,240,0,0,152,0,392
Da Woon Jung,200,90,80,0,0,22,0,392
Yuta Sasaki,0,360,0,0,0,32,0,392
Karl Williams,0,0,320,0,0,70,0,390
Daniel Puder,0,270,80,0,0,40,0,390
DaMarques Johnson,200,180,0,0,0,10,0,390
Naoya Ogawa,100,270,0,0,0,19,0,389
Vaughan Lee,0,90,160,0,0,139,0,389
Asu Almabayev,0,90,240,0,0,58,0,388
Paul Varelans,200,90,80,0,0,17,0,387
Gerald Harris,300,0,0,0,70,17,0,387
Maurice Greene,100,180,0,0,70,37,0,387
Davi Ramos,0,270,80,0,0,36,0,386
Iasmin Lucindo,0,90,160,0,70,65,0,385
Todd Duffee,300,0,0,0,0,60,25,385
Anthony Hamilton,200,0,80,0,0,105,0,385
Rony Jason,200,90,80,0,0,14,0,384
Mike Rodriguez,300,0,0,0,0,84,0,384
Chris Gruetzemacher,100,0,160,0,0,124,0,384
Batgerel Danaa,300,0,0,0,0,83,0,383
TJ Waldburger,0,270,80,0,0,32,0,382
William Gomis,100,0,80,0,140,62,0,382
Lyman Good,300,0,0,0,0,82,0,382
Sumudaerji,100,0,160,0,0,122,0,382
Luiz Firmino,0,180,160,0,0,41,0,381
Hector Lombard,200,0,80,0,0,101,0,381
Philipe Lins,100,0,240,0,0,41,0,381
JeongYeong Lee,100,90,80,0,70,39,0,379
Adriano Martins,200,90,0,0,70,19,0,379
Charlie Brenneman,0,0,320,0,0,58,0,378
Jorge Gurgel,0,90,160,0,70,58,0,378
Michael Trizano,100,0,80,0,140,58,0,378
Roan Carneiro,100,90,80,0,70,38,0,378
Mark Madsen,100,0,160,0,70,48,0,378
Marcus Brimage,100,0,160,0,70,48,0,378
Wagnney Fabiano,0,90,240,0,0,48,0,378
Vinicius Oliveira,200,0,80,0,0,98,0,378
Lucas Martins,200,90,0,0,70,17,0,377
Alessio Di Chirico,200,0,0,0,140,36,0,376
Daisuke Nakamura,100,270,0,0,0,6,0,376
Dhiego Lima,100,0,80,0,140,55,0,375
Hyder Amil,200,0,80,0,0,95,0,375
Mario Sperry,200,90,0,0,0,84,0,374
Jon Tuck,100,180,80,0,0,13,0,373
Magnus Cedenblad,100,180,80,0,0,12,0,372
Jordan Johnson,0,90,160,0,70,52,0,372
Cat Zingano,200,0,80,0,0,67,25,372
Ismael Bonfim,100,0,160,0,0,111,0,371
Timothy Johnson,100,0,160,0,70,38,0,368
Sedriques Dumas,0,90,240,0,0,38,0,368
Vitor Miranda,300,0,0,0,0,67,0,367
Zak Ottow,100,0,0,0,210,57,0,367
Devonte Smith,300,0,0,0,0,67,0,367
Josh Culibao,0,90,80,0,70,126,0,366
Hunter Azure,0,0,240,0,0,126,0,366
Carlos Hernandez,0,0,80,0,210,74,0,364
Alex Serdyukov,100,180,0,0,0,83,0,363
Jared Hamman,200,0,80,0,0,83,0,363
Jesus Aguilar,100,180,0,0,70,12,0,362
Francimar Barroso,0,0,320,0,0,42,0,362
Brad Blackburn,100,0,80,0,70,112,0,362
Mu Bae Choi,0,270,80,0,0,11,0,361
Cesar Almeida,100,0,160,0,0,101,0,361
Jaqueline Amorim,100,180,0,0,0,80,0,360
Bevon Lewis,200,0,80,0,0,80,0,360
Riki Fukuda,0,0,240,0,0,120,0,360
Yizha,0,180,80,0,70,30,0,360
Ibo Aslan,300,0,0,0,0,59,0,359
Elias Silverio,0,90,160,0,0,109,0,359
Jamall Emmers,100,0,160,0,0,97,0,357
Nicolae Negumereanu,200,0,0,0,140,17,0,357
Daiju Takase,100,90,80,0,70,16,0,356
Hyun Gyu Lim,300,0,0,0,0,31,25,356
Jake O'Brien,100,0,160,0,70,25,0,355
Ruslan Magomedov,0,0,240,0,0,115,0,355
Kazuyuki Miyata,0,0,240,0,70,45,0,355
Trevor Peek,200,0,80,0,0,75,0,355
Kyle Kingsbury,100,0,160,0,70,25,0,355
Kenji Osawa,0,0,80,0,210,64,0,354
Cory McKenna,0,90,240,0,0,24,0,354
Modestas Bukauskas,100,90,160,0,0,3,0,353
Brandon Davis,0,90,160,0,0,102,0,352
Bob Sapp,300,0,0,0,0,52,0,352
Ji Yeon Kim,100,0,0,0,140,111,0,351
Nick Hein,0,0,320,0,0,31,0,351
Luis Saldana,100,0,160,0,0,89,0,349
Yoshiro Maeda,100,90,80,0,0,54,25,349
Alessandro Costa,200,0,0,0,70,79,0,349
Joey Beltran,200,0,80,0,0,68,0,348
Nick Catone,0,90,80,0,140,37,0,347
Vince Morales,100,0,160,0,0,87,0,347
Jacqueline Cavalcanti,0,0,80,0,140,126,0,346
George Sullivan,100,0,160,0,0,86,0,346
Da'Mon Blackshear,100,180,0,0,0,66,0,346
Renzo Gracie,0,90,160,0,0,95,0,345
Sanae Kikuta,0,90,240,0,0,14,0,344
Shamil Gaziev,100,90,80,0,0,49,25,344
Raulian Paiva,100,0,80,75,70,18,0,343
ChangHo Lee,200,0,0,0,70,73,0,343
Brian Foster,200,90,0,0,0,53,0,343
Lucie Pudilova,100,0,160,0,0,83,0,343
Ronnie Lawrence,100,0,160,0,0,82,0,342
Xiao Long,100,0,0,75,70,97,0,342
Ryan Jimmo,200,0,80,0,0,61,0,341
Tagir Ulanbekov,0,180,80,0,70,11,0,341
Tyson Nam,300,0,0,0,0,41,0,341
Jason Brilz,100,0,160,0,0,80,0,340
Austin Hubbard,0,0,240,0,0,100,0,340
Tomasz Drwal,200,90,0,0,0,49,0,339
Eddie Sanchez,300,0,0,0,0,38,0,338
Cathal Pendred,0,90,160,0,70,17,0,337
Yazmin Jauregui,100,0,160,0,0,76,0,336
Ashlee Evans-Smith,100,0,80,0,70,86,0,336
Clint Hester,100,0,80,0,70,86,0,336
Juan Adams,200,0,0,0,0,136,0,336
Luke Cummo,200,0,80,0,0,56,0,336
Danny Barlow,200,0,0,0,70,65,0,335
Victor Altamirano,100,0,80,0,70,85,0,335
Ildemar Alcantara,0,90,80,0,140,24,0,334
Sean Spencer,0,0,160,0,70,104,0,334
Chad Anheliger,100,0,80,0,70,83,0,333
Jeka Saragih,300,0,0,0,0,33,0,333
Aoriqileng,100,0,160,0,0,73,0,333
Johnny Eduardo,200,0,80,0,0,52,0,332
Ikram Aliskerov,200,90,0,0,0,17,25,332
Tim Credeur,200,90,0,0,0,40,0,330
Jamal Pogues,0,0,320,0,0,10,0,330
Cody Brundage,200,90,0,0,0,40,0,330
Logan Clark,200,0,80,0,0,49,0,329
Cody Gibson,100,90,80,0,0,58,0,328
Valerie Letourneau,0,0,160,0,70,73,25,328
Pablo Garza,100,90,80,0,0,58,0,328
Edimilson Souza,200,0,0,0,70,58,0,328
Luke Barnatt,100,90,80,0,0,58,0,328
Eduarda Moura,100,90,80,0,0,58,0,328
Kyle Daukaus,0,90,160,0,0,77,0,327
Yoshihisa Yamamoto,200,90,0,0,0,37,0,327
Richard Crunkilton,100,90,80,0,0,30,25,325
Jimy Hettes,0,180,80,0,0,65,0,325
Megan Anderson,200,90,0,0,0,10,25,325
Charles Byrd,0,270,0,0,0,54,0,324
Josh Samman,200,90,0,0,0,34,0,324
Chad Griggs,300,0,0,0,0,24,0,324
Curtis Millender,100,0,160,0,0,64,0,324
Zhang Mingyang,300,0,0,0,0,24,0,324
Josiane Nunes,100,0,160,0,0,63,0,323
Javier Vazquez,0,180,80,0,0,62,0,322
Tom Nolan,200,0,80,0,0,41,0,321
Chris Horodecki,0,90,0,0,140,91,0,321
Jean Silva,200,0,80,0,0,41,0,321
Ian Freeman,200,0,80,0,0,40,0,320
Shin Haraguchi,100,0,160,0,0,60,0,320
Ihor Potieria,200,0,80,0,0,39,0,319
Alex Stiebling,100,0,160,0,0,59,0,319
Shane del Rosario,100,180,0,0,0,38,0,318
Luana Santos,100,90,80,0,0,48,0,318
Steve Erceg,100,0,160,0,0,33,25,318
Zachary Reese,100,90,80,0,0,48,0,318
Poliana Botelho,100,0,160,0,0,58,0,318
Johnny Bedford,200,0,0,0,0,117,0,317
Jorge Santiago,300,0,0,0,0,17,0,317
Justin Salas,100,0,80,0,70,66,0,316
Hugo Viana,100,0,80,0,70,66,0,316
Eric Schafer,100,180,0,0,0,36,0,316
Pete Williams,100,180,0,0,0,10,25,315
Jhonata Diniz,200,0,80,0,0,34,0,314
Nick Ring,0,90,160,0,0,63,0,313
Tucker Lutz,0,0,240,0,0,72,0,312
Viscardi Andrade,100,0,160,0,0,52,0,312
Yan Cabral,0,180,80,0,0,51,0,311
Alexander Otsuka,100,90,80,0,0,40,0,310
Dave Beneteau,200,0,80,0,0,29,0,309
James Irvin,300,0,0,0,0,8,0,308
Justine Kish,0,0,240,0,0,68,0,308
Abus Magomedov,100,90,80,0,0,13,25,308
Ed Ratcliff,200,0,80,0,0,28,0,308
Clayton Carpenter,0,180,80,0,0,47,0,307
Richard Walsh,0,0,160,0,0,145,0,305
Dave Menne,0,0,160,0,0,95,50,305
Torrez Finney,100,90,80,0,0,35,0,305
Charles Bennett,200,90,0,0,0,14,0,304
Jafel Filho,100,180,0,0,0,24,0,304
Ryan Benoit,200,0,0,0,70,33,0,303
Rich Attonito,100,0,160,0,0,43,0,303
Julia Avila,100,90,80,0,0,33,0,303
Marcus Hicks,0,270,0,0,0,7,25,302
Shonie Carter,100,0,160,0,0,42,0,302
Teruto Ishihara,200,0,80,0,0,21,0,301
Mauricio Ruffy,200,0,80,0,0,21,0,301
Neil Seery,0,90,160,0,0,50,0,300
Jamie Pickett,100,0,160,0,0,40,0,300
Russell Doane,100,90,0,0,70,39,0,299
Reza Madadi,100,180,0,0,0,19,0,299
Charles Radtke,200,0,80,0,0,19,0,299
Joe Soto,0,180,80,0,0,14,25,299
Andrew Craig,100,0,80,0,70,49,0,299
Chase Beebe,0,0,160,0,0,64,75,299
Sarah Moras,100,90,80,0,0,28,0,298
Bartosz Fabinski,0,0,240,0,0,58,0,298
Nicholas Musoke,0,90,160,0,0,47,0,297
Claude Patrick,0,90,160,0,0,47,0,297
Joby Sanchez,100,0,80,0,70,46,0,296
Mike Easton,100,0,80,75,0,40,0,295
Bruna Brasil,100,0,160,0,0,35,0,295
Kleydson Rodrigues,100,0,80,0,0,115,0,295
Pete Spratt,0,270,0,0,0,25,0,295
Stephanie Egger,100,180,0,0,0,14,0,294
Jason Saggo,200,0,0,0,70,24,0,294
Natan Levy,0,90,160,0,0,44,0,294
Justin Ledet,0,90,80,0,70,54,0,294
Juliana Lima,0,0,240,0,0,53,0,293
David Dvorak,0,90,160,0,0,43,0,293
Enson Inoue,0,270,0,0,0,21,0,291
Manny Bermudez,0,270,0,0,0,21,0,291
Blas Avena,100,180,0,0,0,10,0,290
Jai Herbert,100,0,160,0,0,30,0,290
Bas Rutten,200,0,0,0,70,20,0,290
Leandro Silva,0,90,160,0,0,40,0,290
Tony DeSouza,0,180,80,0,0,30,0,290
Steven Peterson,100,0,80,0,70,40,0,290
Fabiano Iha,100,180,0,0,0,9,0,289
Rob Emerson,100,0,80,0,70,39,0,289
Remco Pardoel,100,180,0,0,0,9,0,289
Viktoriia Dudakova,100,0,160,0,0,28,0,288
Billy Evangelista,0,0,80,0,140,68,0,288
Tom Erikson,0,180,80,0,0,28,0,288
SeungGuk Choi,0,0,240,0,0,48,0,288
Joe Doerksen,0,180,80,0,0,2,25,287
Lukasz Brzeski,0,90,80,0,0,117,0,287
Alexander Yakovlev,100,90,80,0,0,17,0,287
Askar Askarov,0,0,240,0,0,47,0,287
Alberto Mina,200,0,0,0,70,17,0,287
Francis Marshall,100,0,80,0,70,36,0,286
Jeremy Kennedy,0,0,240,0,0,46,0,286
Ashley Yoder,0,0,160,0,70,55,0,285
Herbert Burns,100,180,0,0,0,5,0,285
Andre Lima,0,0,160,0,70,55,0,285
Jonathan Goulet,100,90,0,75,0,19,0,284
Matt Grice,0,0,80,0,70,134,0,284
Aleksa Camur,100,0,80,0,0,104,0,284
Makoto Takimoto,0,90,160,0,0,34,0,284
Frank Camacho,100,0,0,0,70,113,0,283
Ramiz Brahimaj,100,180,0,0,0,3,0,283
Dong Hyun Ma,100,0,80,0,70,32,0,282
Kamal Shalorus,100,0,80,0,70,31,0,281
Damacio Page,100,90,80,0,0,11,0,281
Garrett Armfield,100,0,80,0,0,101,0,281
Muhammad Naimov,200,0,80,0,0,1,0,281
Shayilan Nuerdanbieke,100,0,160,0,0,20,0,280
Jimmy Flick,0,270,0,0,0,10,0,280
Brad Scott,0,180,0,0,70,29,0,279
Matt Sayles,100,90,0,0,0,88,0,278
Paddy Holohan,0,90,160,0,0,28,0,278
Elves Brener,200,0,0,0,70,8,0,278
Michael Chandler,200,0,0,0,0,27,50,277
Pascal Krauss,0,0,160,0,0,117,0,277
Blagoy Ivanov,0,0,240,0,0,11,25,276
Cody McKenzie,0,180,80,0,0,15,0,275
Will Brooks,100,0,80,0,0,95,0,275
Zach Makovsky,0,0,240,0,0,35,0,275
Chico Camus,0,0,160,0,70,45,0,275
Rodrigo Damm,0,90,80,0,70,10,25,275
Albert Duraev,0,90,80,0,70,35,0,275
Luana Pinheiro,100,0,80,0,70,24,0,274
Justin Eilers,200,0,0,0,0,24,50,274
Brady Hiestand,100,90,80,0,0,4,0,274
Sam Patterson,0,270,0,0,0,4,0,274
Mike Russow,100,0,160,0,0,14,0,274
Rizvan Kuniev,200,0,0,0,0,73,0,273
Paul Sass,0,270,0,0,0,3,0,273
Ryan Janes,100,0,80,0,0,92,0,272
Nam Phan,0,0,80,0,70,120,0,270
Shane Young,100,0,80,0,0,90,0,270
Ronny Markes,0,0,160,0,70,39,0,269
David Loiseau,200,0,0,0,0,44,25,269
Rob Kimmons,0,180,80,0,0,7,0,267
Sergey Morozov,0,0,240,0,0,26,0,266
Mariya Agapova,0,180,0,0,0,85,0,265
Nick Maximov,0,0,160,0,70,35,0,265
Trey Ogden,0,0,240,0,0,25,0,265
SuYoung You,0,0,160,0,70,34,0,264
Melissa Gatto,200,0,0,0,0,64,0,264
Billy Ray Goff,200,0,0,0,0,64,0,264
Roland Delorme,0,180,80,0,0,4,0,264
Dongi Yang,200,0,0,0,0,63,0,263
Devin Cole,100,0,80,0,0,82,0,262
Tyler Toner,200,0,0,0,0,62,0,262
Emily Ducote,0,0,160,0,0,102,0,262
Piotr Hallmann,0,180,0,0,0,82,0,262
Isaac Dulgarian,100,90,0,0,0,71,0,261
Mohammed Usman,100,0,160,0,0,0,0,260
Livinha Souza,0,90,80,0,70,20,0,260
Hannah Goldy,0,90,80,0,0,90,0,260
Maxim Grishin,100,0,80,0,0,79,0,259
Eliot Marshall,0,90,80,0,70,19,0,259
Caio Machado,0,0,80,0,0,177,0,257
Benji Radach,100,0,80,0,0,76,0,256
Jean Matsumoto,0,90,160,0,0,6,0,256
Takeshi Inoue,200,0,0,0,0,31,25,256
Jack Marshman,100,0,80,0,70,6,0,256
WonBin Ki,200,0,0,0,0,55,0,255
Marco Beltran,0,90,80,0,70,14,0,254
Ricky Turcios,0,0,0,0,140,114,0,254
Daniel Roberts,0,180,0,0,70,3,0,253
Xie Bin,100,0,80,0,0,72,0,252
Maki Pitolo,200,0,0,0,0,51,0,251
Steven Nguyen,100,0,80,0,0,71,0,251
Brandon Thatch,200,0,0,0,0,26,25,251
Maheshate,100,0,80,0,70,1,0,251
Masakazu Imanari,0,180,0,0,70,0,0,250
Carlos Felipe,0,0,80,0,140,30,0,250
Kayla Harrison,0,90,80,0,0,80,0,250
Kevin Aguilar,0,0,160,0,70,18,0,248
Scott Ferrozzo,100,0,80,0,0,68,0,248
Nah-Shon Burrell,0,0,80,0,70,98,0,248
Hiromitsu Miura,200,0,0,0,0,23,25,248
Eric Shelton,0,0,80,0,70,97,0,247
LC Davis,0,0,80,75,70,22,0,247
Jared Vanderaa,100,0,80,0,0,66,0,246
Herschel Walker,200,0,0,0,0,46,0,246
Houston Alexander,200,0,0,0,0,45,0,245
Jose Johnson,0,90,80,0,0,75,0,245
Andrews Nakahara,200,0,0,0,0,45,0,245
Tony Fryklund,100,90,0,0,0,54,0,244
Mounir Lazzez,0,0,160,0,0,84,0,244
Arjan Bhullar,0,0,240,0,0,4,0,244
Dave Herman,200,0,0,0,0,43,0,243
Antonio Arroyo,0,90,80,0,0,73,0,243
Melquizael Costa,0,90,80,0,0,72,0,242
Gaston Bolanos,0,0,160,0,0,82,0,242
Kevin Jousset,0,90,80,0,0,72,0,242
Zelg Galesic,100,90,0,0,0,52,0,242
Wellington Turman,0,90,80,0,70,1,0,241
Rodolfo Bellato,200,0,0,0,0,40,0,240
Junior Assuncao,0,90,80,0,0,70,0,240
John Cholish,100,90,0,0,0,50,0,240
Junior Tafa,200,0,0,0,0,40,0,240
Julia Polastri,0,90,0,0,70,79,0,239
Andre Galvao,100,90,0,0,0,49,0,239
Gan McGee,200,0,0,0,0,14,25,239
Roger Bowling,100,0,80,0,0,58,0,238
Ebenezer Fontes Braga,0,90,80,0,0,67,0,237
Marcio Cruz,100,90,0,0,0,47,0,237
Evangelista Santos,100,90,0,0,0,21,25,236
Manny Tapia,100,0,0,0,70,41,25,236
Lucas Almeida,100,0,80,0,0,55,0,235
Tereza Bleda,0,0,160,0,0,75,0,235
Bolaji Oki,100,0,0,0,70,65,0,235
Gloria de Paula,0,0,160,0,0,74,0,234
Scott Askham,200,0,0,0,0,34,0,234
Forrest Petz,0,0,160,0,0,74,0,234
Ottman Azaitar,200,0,0,0,0,34,0,234
Sean O'Connell,200,0,0,0,0,33,0,233
Malcolm Gordon,100,0,80,0,0,52,0,232
Oskar Piechota,100,0,80,0,0,52,0,232
Joey Villasenor,200,0,0,0,0,7,25,232
Oumar Sy,0,90,80,0,0,61,0,231
Tony Kelley,100,0,80,0,0,51,0,231
Keith Hackney,100,90,0,0,0,41,0,231
Benito Lopez,0,0,160,0,70,0,0,230
Artem Lobov,0,0,160,0,0,45,25,230
Diana Belbita,0,0,160,0,0,70,0,230
Hacran Dias,0,0,160,0,70,0,0,230
Mikey Burnett,100,0,80,0,0,49,0,229
Evan Elder,0,90,80,0,0,59,0,229
Randy Costa,200,0,0,0,0,29,0,229
Chris Clements,100,0,0,0,70,58,0,228
Dalcha Lungiambula,100,0,80,0,0,48,0,228
Guangyou Ning,100,0,80,0,0,48,0,228
Preston Parsons,0,0,160,0,0,67,0,227
Gina Mazany,100,0,80,0,0,47,0,227
Nora Cornolle,100,0,80,0,0,47,0,227
Johnny Munoz,0,90,80,0,0,57,0,227
Darrick Minner,0,90,80,0,0,57,0,227
Atsushi Yamamoto,100,0,80,0,0,47,0,227
David Terrell,100,90,0,0,0,12,25,227
Amanda Cooper,100,0,80,0,0,47,0,227
Aleksei Kunchenko,0,0,160,0,0,67,0,227
Katsuyori Shibata,100,0,80,0,0,47,0,227
Katsuhisa Fujii,100,90,0,0,0,36,0,226
Claudio Ribeiro,200,0,0,0,0,26,0,226
Andy Ologun,100,0,80,0,0,45,0,225
Rafael Estevam,100,0,80,0,0,45,0,225
Morgan Charriere,200,0,0,0,0,25,0,225
Zhu Kangjie,0,0,80,0,70,74,0,224
Daniel Acacio,100,0,80,0,0,44,0,224
Fernando Padilla,100,90,0,0,0,34,0,224
Daniel Santos,100,0,80,0,0,44,0,224
Kuniyoshi Hironaka,100,0,80,0,0,43,0,223
Aisling Daly,0,90,80,0,0,53,0,223
Ange Loosa,0,0,160,0,0,63,0,223
James Moontasri,100,90,0,0,0,33,0,223
Luis Henrique,0,180,0,0,0,42,0,222
Bobby Southworth,0,90,80,0,0,2,50,222
Dennis Buzukja,100,0,80,0,0,42,0,222
Deron Winn,0,0,160,0,0,61,0,221
Sergey Khandozhko,100,0,80,0,0,41,0,221
Gilbert Yvel,200,0,0,0,0,21,0,221
Kurt Holobaugh,0,90,80,0,0,50,0,220
Isaac Vallie-Flagg,0,0,0,0,140,80,0,220
Tom Watson,100,0,80,0,0,39,0,219
Karlos Vemola,100,90,0,0,0,29,0,219
Ketlen Souza,0,90,80,0,0,49,0,219
Lance Benoist,0,0,160,0,0,59,0,219
Chris Beal,100,0,80,0,0,38,0,218
Josh Fremd,0,90,80,0,0,48,0,218
Orion Cosce,100,0,80,0,0,38,0,218
Magomed Mustafaev,200,0,0,0,0,18,0,218
Tae Hyun Bang,100,0,0,0,70,48,0,218
Gabe Green,100,0,80,0,0,38,0,218
Marco Tulio,100,0,80,0,0,37,0,217
Chelsea Chandler,100,0,80,0,0,37,0,217
Charlie Campbell,100,0,80,0,0,37,0,217
Bogdan Guskov,200,0,0,0,0,16,0,216
Yorgan De Castro,200,0,0,0,0,16,0,216
Takashi Sato,200,0,0,0,0,16,0,216
Robert Whiteford,100,0,80,0,0,36,0,216
Cyril Asker,100,90,0,0,0,26,0,216
Che Mills,200,0,0,0,0,16,0,216
Jess Liaudin,100,90,0,0,0,25,0,215
AJ Dobson,0,90,80,0,0,45,0,215
Allan Nascimento,0,90,80,0,0,45,0,215
Nurullo Aliev,100,0,0,75,0,40,0,215
Saidyokub Kakhramonov,0,90,80,0,0,45,0,215
Dylan Andrews,200,0,0,0,0,14,0,214
Nick Osipczak,100,90,0,0,0,24,0,214
Gerard Gordeau,200,0,0,0,0,14,0,214
Trey Waters,0,0,160,0,0,54,0,214
Nursulton Ruziboev,200,0,0,0,0,14,0,214
Noad Lahat,0,0,80,75,0,59,0,214
Nazim Sadykhov,100,90,0,0,0,24,0,214
Allan Goes,0,90,80,0,0,44,0,214
Khama Worthy,100,90,0,0,0,23,0,213
Jared Gooden,100,90,0,0,0,23,0,213
Jiniushiyue,100,0,80,0,0,33,0,213
Magomed Gadzhiyasulov,0,0,80,75,0,58,0,213
Timur Valiev,0,0,80,75,0,57,0,212
Casey Olson,0,90,80,0,0,42,0,212
Shana Dobson,200,0,0,0,0,12,0,212
Edwin Figueroa,100,0,0,0,70,42,0,212
Chris Barnett,200,0,0,0,0,11,0,211
Nad Narimani,0,0,160,0,0,51,0,211
Dominique Steele,100,0,80,0,0,31,0,211
Lauren Mueller,0,0,160,0,0,51,0,211
Melissa Mullins,100,0,80,0,0,30,0,210
Kenichi Yamamoto,0,90,80,0,0,15,25,210
Anthony Ruiz,100,0,0,0,0,84,25,209
Mike van Arsdale,0,90,80,0,0,39,0,209
Hector Sandoval,100,0,80,0,0,28,0,208
Juan Espino,0,180,0,0,0,28,0,208
Anthony Birchak,100,0,0,0,70,38,0,208
Leandro Issa,0,180,0,0,0,28,0,208
Andre Fialho,200,0,0,0,0,8,0,208
Laverne Clark,100,0,0,75,0,33,0,208
Adam Fugitt,100,0,0,0,70,38,0,208
Jutaro Nakao,200,0,0,0,0,8,0,208
Kevin Jackson,100,90,0,0,0,18,0,208
Jay Hieron,100,0,80,0,0,28,0,208
Matthew Lopez,100,0,80,0,0,27,0,207
Falaniko Vitale,200,0,0,0,0,7,0,207
Don Madge,100,0,80,0,0,27,0,207
Bea Malecki,0,90,80,0,0,37,0,207
Fredy Serrano,200,0,0,0,0,7,0,207
Micah Miller,100,90,0,0,0,17,0,207
Hannah Cifers,0,0,80,0,70,56,0,206
Ryan Jensen,0,180,0,0,0,26,0,206
Brian Johnston,200,0,0,0,0,6,0,206
Frank Gomez,0,90,80,0,0,36,0,206
Steve Jennum,100,90,0,0,0,16,0,206
Roman Zentsov,200,0,0,0,0,6,0,206
Eric Esch,100,90,0,0,0,16,0,206
Johnny Rhodes,100,90,0,0,0,16,0,206
Luiz Azeredo,100,0,0,0,70,35,0,205
Aaron Rosa,0,90,0,75,0,40,0,205
Anshul Jubli,100,0,0,0,70,35,0,205
Henrique da Silva,100,90,0,0,0,15,0,205
Lyle Beerbohm,0,90,0,0,70,44,0,204
Christian Wellisch,0,90,80,0,0,34,0,204
Lumumba Sayers,100,90,0,0,0,12,0,202
Victoria Leonardo,100,0,80,0,0,22,0,202
Mitch Clarke,0,90,80,0,0,32,0,202
MarQuel Mederos,100,0,80,0,0,21,0,201
Felipe Lima,0,90,80,0,0,31,0,201
Blake Bilder,0,90,80,0,0,31,0,201
Kaiwen,100,0,80,0,0,21,0,201
Jason Von Flue,0,180,0,0,0,20,0,200
Daniel Sarafian,100,90,0,0,0,10,0,200
Hiroshi Izumi,100,0,80,0,0,20,0,200
Jesse Taylor,0,180,0,0,0,20,0,200
Loik Radzhabov,100,0,80,0,0,19,0,199
Kimo Leopoldo,100,90,0,0,0,9,0,199
Jake Rosholt,100,90,0,0,0,9,0,199
Bryan Baker,100,0,0,0,70,28,0,198
Joseph Holmes,0,180,0,0,0,18,0,198
Danny Henry,0,90,80,0,0,28,0,198
Bec Rawlings,0,90,80,0,0,27,0,197
Victor Hugo,0,90,80,0,0,27,0,197
AJ Fletcher,100,90,0,0,0,7,0,197
James Wilks,0,90,80,0,0,27,0,197
Rory Singer,0,90,80,0,0,27,0,197
Jordan Griffin,0,180,0,0,0,16,0,196
Tatsuya Mizuno,100,90,0,0,0,6,0,196
Ariane Carnelossi,100,90,0,0,0,5,0,195
Bojan Velickovic,100,0,80,0,0,15,0,195
Daniel Gracie,0,90,0,0,70,35,0,195
Assuerio Silva,100,90,0,0,0,4,0,194
Austen Lane,100,0,80,0,0,14,0,194
Rickson Gracie,0,180,0,0,0,14,0,194
Aliaskhab Khizriev,0,180,0,0,0,13,0,193
Baergeng Jieleyisi,0,90,80,0,0,23,0,193
Steve Bosse,100,0,80,0,0,13,0,193
Jonathan Brookins,100,0,80,0,0,13,0,193
Yanal Ashmouz,100,0,80,0,0,13,0,193
Cristian Quinonez,100,0,80,0,0,13,0,193
Mike Massenzio,0,90,80,0,0,22,0,192
Andre Winner,100,0,80,0,0,12,0,192
Kalib Starnes,0,90,80,0,0,21,0,191
Pete Sell,0,90,80,0,0,21,0,191
Austin Lingo,0,0,160,0,0,31,0,191
Ken Stone,0,90,0,0,70,31,0,191
Antonio Schembri,100,90,0,0,0,1,0,191
Samandar Murodov,0,90,80,0,0,20,0,190
Gadzhimurad Antigulov,0,180,0,0,0,10,0,190
Thomas Petersen,0,90,80,0,0,20,0,190
Travis Lutter,100,90,0,0,0,0,0,190
Ivan Jorge,0,0,160,0,0,30,0,190
Marcelo Guimaraes,0,0,0,0,140,50,0,190
Kevin Burns,100,90,0,0,0,0,0,190
Garreth McLellan,100,0,0,0,0,89,0,189
Tainara Lisboa,0,90,80,0,0,19,0,189
Jonny Parsons,100,0,0,0,70,19,0,189
Laureano Staropoli,0,0,160,0,0,28,0,188
Eric Spicely,0,180,0,0,0,8,0,188
Andre Soukhamthath,100,0,80,0,0,8,0,188
Daijiro Matsui,0,0,160,0,0,28,0,188
Poppies Martinez,0,180,0,0,0,7,0,187
Dave Terrel,100,0,80,0,0,7,0,187
Myktybek Orolbai,0,90,80,0,0,17,0,187
Serhiy Sidey,100,0,0,0,70,17,0,187
Philip De Fries,0,90,80,0,0,17,0,187
Mackens Semerzier,0,180,0,0,0,7,0,187
Zhang Tiequan,0,180,0,0,0,6,0,186
Chris Brennan,0,180,0,0,0,6,0,186
Jason DeLucia,0,180,0,0,0,5,0,185
Jason Witt,0,90,0,75,0,20,0,185
Adam Wieczorek,0,90,80,0,0,14,0,184
Nobuhiko Takada,0,180,0,0,0,4,0,184
Genki Sudo,0,180,0,0,0,4,0,184
Dokonjonosuke Mishima,0,90,0,0,70,24,0,184
Danilo Marques,0,90,80,0,0,13,0,183
Rafael Alves,0,180,0,0,0,3,0,183
Julija Stoliarenko,0,180,0,0,0,3,0,183
Markus Perez,0,180,0,0,0,2,0,182
Jordan Rinaldi,0,90,80,0,0,12,0,182
Damian Stasiak,0,180,0,0,0,2,0,182
Shannon Gugerty,0,180,0,0,0,2,0,182
Rafaello Oliveira,0,0,160,0,0,22,0,182
Brendson Ribeiro,100,0,0,0,70,12,0,182
Tiago dos Santos e Silva,0,0,80,0,70,32,0,182
Yoshiyuki Yoshida,0,180,0,0,0,2,0,182
Emily Whitmire,0,90,80,0,0,11,0,181
Abubakar Nurmagomedov,0,0,160,0,0,21,0,181
Tresean Gore,0,180,0,0,0,1,0,181
Dustin Kimura,0,180,0,0,0,0,0,180
Michinori Tanaka,0,0,80,0,70,30,0,180
Tom Duquesnoy,100,0,80,0,0,0,0,180
Diego Rivas,100,0,80,0,0,0,0,180
Aleksandra Albu,0,90,80,0,0,10,0,180
Ralek Gracie,0,90,80,0,0,10,0,180
Akitoshi Tamura,0,0,80,0,0,100,0,180
Mike Wilkinson,100,0,80,0,0,0,0,180
Sam Hoger,0,90,80,0,0,9,0,179
Yaotzin Meza,0,90,80,0,0,9,0,179
Mike de la Torre,100,0,0,0,70,9,0,179
Masanori Kanehara,0,0,160,0,0,18,0,178
Mara Romero Borella,0,90,0,0,70,18,0,178
Tra Telligman,0,90,80,0,0,7,0,177
Damien Brown,100,0,0,0,70,7,0,177
Justin Edwards,0,90,80,0,0,7,0,177
Chris Kelades,0,0,80,0,70,27,0,177
Nyamjargal Tumendemberel,0,90,0,0,70,17,0,177
Mark De La Rosa,0,90,0,0,70,17,0,177
Darren Uyenoyama,0,90,80,0,0,6,0,176
James Head,0,90,0,0,70,16,0,176
Abdul-Kerim Edilov,100,0,0,0,0,76,0,176
Alexander Munoz,0,0,160,0,0,15,0,175
Sarah Frota,100,0,0,0,0,74,0,174
Chance Rencountre,0,90,80,0,0,4,0,174
Mallory Martin,0,90,80,0,0,3,0,173
Antonio Carvalho,100,0,0,0,70,3,0,173
Yohan Lainesse,100,0,0,0,70,3,0,173
Amar Suloev,0,0,80,0,70,23,0,173
Toshiomi Kazama,0,90,80,0,0,3,0,173
Ramon Taveras,100,0,0,0,70,3,0,173
Daermisi Zhawupasi,0,90,80,0,0,2,0,172
Michael Graves,0,90,80,0,0,1,0,171
Shane Nelson,100,0,0,0,70,1,0,171
Phillip Miller,0,90,80,0,0,1,0,171
Chris Holdsworth,0,90,80,0,0,1,0,171
Dione Barbosa,0,90,80,0,0,1,0,171
Francisco Figueiredo,0,90,80,0,0,1,0,171
John Maguire,0,90,80,0,0,0,0,170
Ronaldo Rodriguez,0,90,80,0,0,0,0,170
Guram Kutateladze,0,0,80,0,70,20,0,170
Jessamyn Duke,0,0,80,0,0,89,0,169
Jarred Brooks,0,0,0,0,140,28,0,168
Satoshi Ishii,0,0,160,0,0,8,0,168
Rogerio Bontorin,0,90,0,0,70,7,0,167
Jamey-Lyn Horth,0,0,80,0,70,17,0,167
Danielle Taylor,0,0,80,0,70,17,0,167
Justin Gonzales,0,0,80,0,0,87,0,167
Mana Martinez,0,0,0,0,140,26,0,166
Cody Haddon,0,0,80,0,0,86,0,166
Alex Hunter,0,90,0,0,70,6,0,166
Fredson Paixao,0,90,0,0,70,5,0,165
William Macario,0,0,80,0,0,85,0,165
Dong Sik Yoon,0,0,80,0,70,15,0,165
Yousri Belgaroui,100,0,0,0,0,64,0,164
Deividas Taurosevicius,0,0,80,0,70,14,0,164
Martin Bravo,100,0,0,0,0,64,0,164
Kiichi Kunimoto,0,90,0,0,70,4,0,164
Igor Araujo,0,0,160,0,0,3,0,163
Pingyuan Liu,0,0,80,0,70,13,0,163
Gabriella Fernandes,0,90,0,0,70,2,0,162
Felipe Colares,0,0,80,0,70,12,0,162
David Heath,0,90,0,0,70,1,0,161
Mizuto Hirota,0,0,80,0,0,81,0,161
Justin McCully,0,0,160,0,0,0,0,160
Jinh Yu Frey,0,0,160,0,0,0,0,160
Luke Jumeau,0,0,160,0,0,0,0,160
Nicco Montano,0,0,80,0,0,54,25,159
Mizuki,0,0,80,0,70,8,0,158
Qiu Lun,0,0,80,0,0,78,0,158
Sheymon Moraes,0,0,80,0,70,7,0,157
Danny Silva,0,0,80,0,70,7,0,157
Felipe Silva,100,0,0,0,0,56,0,156
James Llontop,0,0,80,0,0,75,0,155
Zhang Lipeng,0,0,80,0,70,4,0,154
Chris Wilson,0,0,80,0,0,73,0,153
Luan Chagas,0,90,0,0,0,63,0,153
Waylon Lowe,0,0,80,0,70,3,0,153
Satoshi Honma,100,0,0,0,0,53,0,153
Jason Day,100,0,0,0,0,26,25,151
Kazula Vargas,0,0,80,0,0,71,0,151
Akira Corassani,0,0,80,0,70,0,0,150
Royston Wee,0,0,80,0,70,0,0,150
Viviane Pereira,0,0,80,0,70,0,0,150
Sultan Aliev,0,0,80,0,70,0,0,150
Kyle Bochniak,0,0,80,0,70,0,0,150
Justin Wilcox,0,0,80,0,0,69,0,149
Zac Pauga,0,0,80,0,0,68,0,148
Andrew Holbrook,0,0,0,0,140,8,0,148
Ricky Palacios,0,0,80,0,0,67,0,147
Lucas Alexander,0,0,80,0,0,66,0,146
Yuki Kondo,100,0,0,0,0,21,25,146
Nathan Coy,0,0,80,0,0,65,0,145
Jeff Hughes,100,0,0,0,0,45,0,145
Khalid Murtazaliev,100,0,0,0,0,44,0,144
Igor Severino,100,0,0,0,0,44,0,144
Estevan Payan,0,0,80,0,0,64,0,144
Kaue Fernandes,100,0,0,0,0,43,0,143
James McSweeney,100,0,0,0,0,42,0,142
Mike Santiago,100,0,0,0,0,42,0,142
Brok Weaver,0,0,80,0,0,62,0,142
Aalon Cruz,100,0,0,0,0,40,0,140
Carmelo Marrero,0,0,0,0,140,0,0,140
Mario Miranda,100,0,0,0,0,40,0,140
Gil Castillo,0,0,80,0,0,9,50,139
Kevin Syler,0,0,80,0,0,59,0,139
Thiago Perpetuo,100,0,0,0,0,39,0,139
Bibulatov Magomed,0,0,80,0,0,59,0,139
Nick Thompson,0,0,80,0,0,34,25,139
Shane Campbell,0,0,80,0,0,59,0,139
Saparbeg Safarov,0,0,80,0,0,59,0,139
Yui Chul Nam,0,0,0,0,70,69,0,139
Corey Hill,100,0,0,0,0,39,0,139
Wang Cong,100,0,0,0,0,37,0,137
Muin Gafurov,0,0,80,0,0,56,0,136
Maria Silva,0,0,80,0,0,56,0,136
Jonathan Meunier,0,0,80,0,0,56,0,136
Gilbert Urbina,100,0,0,0,0,35,0,135
Geraldo de Freitas,0,0,80,0,0,55,0,135
Pedro Falcao,100,0,0,0,0,34,0,134
Leonardo Mafra,0,0,80,0,0,54,0,134
Reuben Duran,0,90,0,0,0,44,0,134
Kevin Vallejos,100,0,0,0,0,34,0,134
Charalampos Grigoriou,100,0,0,0,0,33,0,133
Caolan Loughran,0,0,80,0,0,52,0,132
Mike Guymon,0,0,80,0,0,52,0,132
Sheldon Westcott,100,0,0,0,0,32,0,132
Masaaki Satake,100,0,0,0,0,32,0,132
Mike Hayes,0,0,80,0,0,51,0,131
Jordan Wright,100,0,0,0,0,31,0,131
Kailin Curran,0,90,0,0,0,41,0,131
Zachary Micklewright,0,0,80,0,0,50,0,130
Edgar Garcia,100,0,0,0,0,30,0,130
Christian Morecraft,0,90,0,0,0,39,0,129
Chris Spang,100,0,0,0,0,29,0,129
Patrick Kaase,100,0,0,0,0,29,0,129
Brianna Fortino,0,0,80,0,0,49,0,129
Hirotaka Yokoi,0,90,0,0,0,38,0,128
Tom Murphy,100,0,0,0,0,28,0,128
Allen Crowder,100,0,0,0,0,28,0,128
Augusto Montano,100,0,0,0,0,27,0,127
Seth Petruzelli,100,0,0,0,0,27,0,127
Branden Lee Hinkle,100,0,0,0,0,27,0,127
Julius Anglickas,0,90,0,0,0,37,0,127
Jessica Aguilar,0,0,80,0,0,47,0,127
Mario Sousa,0,0,80,0,0,47,0,127
Mansur Abdul-Malik,100,0,0,0,0,26,0,126
Sherron Leggett,100,0,0,0,0,26,0,126
Navajo Stirling,0,0,80,0,0,46,0,126
Bertrand Amoussou,100,0,0,0,0,26,0,126
Sam Oropeza,100,0,0,0,0,26,0,126
Sasha Palatnikov,100,0,0,0,0,26,0,126
Norifumi Yamamoto,100,0,0,0,0,25,0,125
Joachim Christensen,100,0,0,0,0,25,0,125
Yusaku Kinoshita,100,0,0,0,0,25,0,125
Rob Broughton,0,90,0,0,0,35,0,125
Cole Escovedo,100,0,0,0,0,0,25,125
Renee Forte,0,0,80,0,0,44,0,124
Taiyilake Nueraji,100,0,0,0,0,24,0,124
Francisco Prado,100,0,0,0,0,24,0,124
Nate Mohr,0,0,80,0,0,44,0,124
Juliana Miller,100,0,0,0,0,24,0,124
John Albert,100,0,0,0,0,24,0,124
Kevin Borjas,0,0,80,0,0,44,0,124
Greg Soto,0,0,80,0,0,44,0,124
Cody Donovan,100,0,0,0,0,24,0,124
Austin Arnett,0,0,80,0,0,44,0,124
Alex Nicholson,100,0,0,0,0,23,0,123
Marcelo Golm,0,90,0,0,0,33,0,123
Mark Godbeer,0,0,80,0,0,43,0,123
Walel Watson,100,0,0,0,0,23,0,123
Akiyo Nishiura,100,0,0,0,0,23,0,123
Mark Eddiva,0,0,80,0,0,42,0,122
Tony Sims,100,0,0,0,0,22,0,122
Jarno Errens,0,0,80,0,0,42,0,122
Justin Lawrence,100,0,0,0,0,21,0,121
Alvin Robinson,0,0,80,0,0,41,0,121
Zarrukh Adashev,0,0,80,0,0,41,0,121
Wu Yanan,0,90,0,0,0,31,0,121
Willie Gates,100,0,0,0,0,21,0,121
Top Noi Kiwram,0,0,80,0,0,41,0,121
Frankie Perez,100,0,0,0,0,21,0,121
Cory Devela,100,0,0,0,0,20,0,120
Mike Whitehead,0,0,80,0,0,15,25,120
Gokhan Saki,100,0,0,0,0,20,0,120
Tulio Palhares,100,0,0,0,0,20,0,120
Bobby Moffett,0,90,0,0,0,29,0,119
Thibault Gouti,100,0,0,0,0,19,0,119
Adam Milstead,100,0,0,0,0,19,0,119
Ramazan Temirov,100,0,0,0,0,19,0,119
Bobby Lashley,100,0,0,0,0,19,0,119
Vik Grujic,100,0,0,0,0,18,0,118
Spike Carlyle,100,0,0,0,0,18,0,118
Geza Kalman,100,0,0,0,0,18,0,118
Jesse Lennox,100,0,0,0,0,18,0,118
Wesley Correira,100,0,0,0,0,18,0,118
Guto Inocente,0,0,80,0,0,37,0,117
Eduardo Garagorri,0,0,80,0,0,37,0,117
Shelton Graves,100,0,0,0,0,17,0,117
Mark Climaco,0,0,80,0,0,37,0,117
HanSeul Kim,0,90,0,0,0,27,0,117
Jeff Curran,0,0,80,0,0,12,25,117
Kim Couture,100,0,0,0,0,17,0,117
Eddie Gordon,100,0,0,0,0,17,0,117
Danni McCormack,0,0,80,0,0,36,0,116
Dave Strasser,0,0,80,0,0,36,0,116
Cameron Smotherman,0,0,80,0,0,36,0,116
Kyle Watson,0,0,80,0,0,36,0,116
Joe Pearson,0,90,0,0,0,1,25,116
Jake Hecht,100,0,0,0,0,16,0,116
Collin Anglin,0,0,80,0,0,36,0,116
Abu Azaitar,0,0,80,0,0,36,0,116
Darko Stosic,100,0,0,0,0,15,0,115
Luis Pajuelo,100,0,0,0,0,15,0,115
Crafton Wallace,100,0,0,0,0,15,0,115
Ben Askren,0,90,0,0,0,0,25,115
Elvis Sinosic,0,90,0,0,0,0,25,115
Gabriel Santos,0,0,80,0,0,35,0,115
Maciej Jewtuszko,100,0,0,0,0,15,0,115
Jon Hess,100,0,0,0,0,15,0,115
Peter Barrett,0,0,80,0,0,34,0,114
Clay Collard,0,0,80,0,0,34,0,114
Stanislav Nedkov,100,0,0,0,0,14,0,114
Reginaldo Vieira,0,0,80,0,0,33,0,113
Francisco Trevino,0,0,80,0,0,33,0,113
Ben Alloway,100,0,0,0,0,13,0,113
Dan Argueta,0,0,80,0,0,33,0,113
Carlos Candelario,0,0,80,0,0,33,0,113
Silvana Gomez Juarez,100,0,0,0,0,13,0,113
Brandon Visher,100,0,0,0,0,13,0,113
Jeremy Kimball,100,0,0,0,0,13,0,113
Mark Weir,100,0,0,0,0,13,0,113
Kenny Ento,0,90,0,0,0,23,0,113
Emil Meek,0,0,80,0,0,33,0,113
Robelis Despaigne,100,0,0,0,0,13,0,113
Denis Tiuliulin,100,0,0,0,0,13,0,113
Jerome Rivera,0,0,80,0,0,32,0,112
Ricardo Morais,100,0,0,0,0,12,0,112
Pete Rodriguez,100,0,0,0,0,12,0,112
Daria Zhelezniakova,0,0,80,0,0,32,0,112
Takashi Sugiura,100,0,0,0,0,12,0,112
Erik Silva,100,0,0,0,0,12,0,112
Justin Jaynes,100,0,0,0,0,12,0,112
Tristan Connelly,0,0,80,0,0,32,0,112
Vinicius Salvador,100,0,0,0,0,12,0,112
Marcel Fortuna,100,0,0,0,0,12,0,112
JP Buys,0,90,0,0,0,22,0,112
Oluwale Bamgbose,100,0,0,0,0,12,0,112
Jan Nortje,100,0,0,0,0,12,0,112
Mike Breeden,100,0,0,0,0,12,0,112
Naoki Inoue,0,0,80,0,0,32,0,112
John Lewis,100,0,0,0,0,11,0,111
Robert McDaniel,0,90,0,0,0,21,0,111
Jenna Castillo,100,0,0,0,0,11,0,111
Mike Grundy,100,0,0,0,0,11,0,111
Bobby Voelker,100,0,0,0,0,11,0,111
Devin Powell,100,0,0,0,0,11,0,111
Marcos Vinicius,100,0,0,0,0,11,0,111
Luigi Vendramini,100,0,0,0,0,11,0,111
Stephanie Luciano,0,0,80,0,0,31,0,111
Brian Melancon,100,0,0,0,0,11,0,111
Sam Spengler,100,0,0,0,0,11,0,111
Seth Kleinbeck,100,0,0,0,0,11,0,111
Louis Cosce,100,0,0,0,0,11,0,111
Victor Martinez,0,0,80,0,0,31,0,111
Jordan Williams,100,0,0,0,0,10,0,110
Jeff Hougland,0,0,80,0,0,30,0,110
Troy Mandaloniz,100,0,0,0,0,10,0,110
Paul Jones,0,90,0,0,0,20,0,110
Daiki Hata,0,0,80,0,0,30,0,110
Yoshihiro Nakao,0,90,0,0,0,20,0,110
Syuri Kondo,0,0,0,0,70,40,0,110
Cal Worsham,100,0,0,0,0,10,0,110
Kazuhiro Hamanaka,0,0,80,0,0,30,0,110
Brendan Seguin,0,0,80,0,0,30,0,110
Jack Nilson,100,0,0,0,0,10,0,110
Carlos Zevallos,100,0,0,0,0,10,0,110
Dwayne Cason,100,0,0,0,0,10,0,110
Chris de la Rocha,100,0,0,0,0,10,0,110
Junie Browning,0,90,0,0,0,19,0,109
Georgi Karakhanyan,0,0,0,0,70,39,0,109
Brad Kohler,100,0,0,0,0,9,0,109
Francisco Bueno,100,0,0,0,0,9,0,109
John Gunderson,0,0,80,0,0,29,0,109
Issei Tamura,100,0,0,0,0,9,0,109
Harold Howard,100,0,0,0,0,9,0,109
Taiei Kin,0,0,80,0,0,28,0,108
Nick Denis,100,0,0,0,0,8,0,108
Anthony Romero,0,0,80,0,0,28,0,108
Danny Sabatello,0,0,80,0,0,28,0,108
Zhalgas Zhumagulov,0,90,0,0,0,18,0,108
Rafael Carino,100,0,0,0,0,8,0,108
Jarjis Danho,100,0,0,0,0,8,0,108
Hong Man Choi,100,0,0,0,0,8,0,108
Mike Nickels,0,90,0,0,0,18,0,108
Ramazan Kuramagomedov,0,0,0,0,70,38,0,108
Danillo Villefort,100,0,0,0,0,8,0,108
Egan Inoue,100,0,0,0,0,8,0,108
Eddy Ellis,0,0,80,0,0,28,0,108
Joseph Morales,0,90,0,0,0,18,0,108
KyeungPyo Kim,100,0,0,0,0,7,0,107
Bruno Lopes,100,0,0,0,0,7,0,107
Michael Kuiper,100,0,0,0,0,7,0,107
Karolina Wojcik,0,0,80,0,0,27,0,107
Elizabeth Phillips,0,0,80,0,0,27,0,107
Ron Stallings,0,0,80,0,0,27,0,107
Tadao Yasuda,0,0,0,0,70,37,0,107
Marcelo Mello,100,0,0,0,0,7,0,107
Dan Bobish,0,90,0,0,0,17,0,107
Jenel Lausa,0,0,80,0,0,27,0,107
SangWon Kim,100,0,0,0,0,7,0,107
Sai Wang,0,0,80,0,0,27,0,107
Abel Cullum,0,0,80,0,0,27,0,107
Galore Bofando,100,0,0,0,0,7,0,107
Rex Richards,100,0,0,0,0,7,0,107
Ricardo Abreu,0,90,0,0,0,16,0,106
Peter Danesoe,100,0,0,0,0,6,0,106
Daniel Allen,0,0,80,0,0,26,0,106
Anton Kuivanen,0,0,0,0,70,36,0,106
Jamie Moyle,0,0,80,0,0,26,0,106
Henry Miller,100,0,0,0,0,6,0,106
Orlando Wiet,100,0,0,0,0,6,0,106
Joe Slick,100,0,0,0,0,6,0,106
Christian Aguilera,100,0,0,0,0,6,0,106
Lance Gibson,100,0,0,0,0,6,0,106
Daniel Spitz,100,0,0,0,0,5,0,105
Justin Levens,100,0,0,0,0,5,0,105
Shamil Gamzatov,0,0,0,0,70,35,0,105
Rafael Rebello,0,90,0,0,0,15,0,105
Wagner da Conceicao Martins,100,0,0,0,0,5,0,105
Wallid Ismail,0,90,0,0,0,15,0,105
Yusup Saadulaev,100,0,0,0,0,5,0,105
Daniel Spohn,0,90,0,0,0,15,0,105
Khalid Taha,100,0,0,0,0,5,0,105
Matt Hobar,0,0,80,0,0,25,0,105
Mateus Mendonca,100,0,0,0,0,5,0,105
Jerome LeBanner,100,0,0,0,0,5,0,105
Matt Dwyer,100,0,0,0,0,5,0,105
Kay Hansen,0,90,0,0,0,15,0,105
Andy Ogle,0,0,80,0,0,25,0,105
Shohei Nose,100,0,0,0,0,5,0,105
Valmir Lazaro,0,0,0,0,70,35,0,105
Travis Fulton,0,0,80,0,0,25,0,105
Dan Christison,0,90,0,0,0,15,0,105
Jonas Bilharinho,100,0,0,0,0,5,0,105
JJ Okanovich,0,0,80,0,0,25,0,105
Anthony Figueroa,100,0,0,0,0,5,0,105
Kyle Bradley,100,0,0,0,0,4,0,104
John Phillips,100,0,0,0,0,4,0,104
Rolando Delgado,0,90,0,0,0,14,0,104
David Bielkheden,0,0,80,0,0,24,0,104
Tamires Vidal,100,0,0,0,0,4,0,104
Humberto Bandenay,100,0,0,0,0,4,0,104
Jonathan Wilson,100,0,0,0,0,4,0,104
Jeremiah Metcalf,0,90,0,0,0,13,0,103
Kevin Rosier,100,0,0,0,0,3,0,103
Talita Bernardo,0,0,80,0,0,23,0,103
Ian Loveland,0,0,80,0,0,23,0,103
Connor Matthews,0,0,80,0,0,23,0,103
Chibwikem Onyenegecha,0,0,0,0,70,33,0,103
Cole Smith,0,0,80,0,0,23,0,103
Tommy Speer,100,0,0,0,0,2,0,102
Trevin Jones,100,0,0,0,0,2,0,102
Josh Quinlan,100,0,0,0,0,2,0,102
Ivana Petrovic,0,90,0,0,0,12,0,102
Koya Kanda,0,0,80,0,0,22,0,102
Junior Albini,100,0,0,0,0,2,0,102
Mark Hall,100,0,0,0,0,2,0,102
Maria Oliveira,0,0,0,0,70,32,0,102
Tokimitsu Ishizawa,100,0,0,0,0,2,0,102
Alvaro Herrera Mendoza,100,0,0,0,0,2,0,102
Fernie Garcia,100,0,0,0,0,2,0,102
Daniel Teymur,0,0,80,0,0,22,0,102
Valentijn Overeem,0,90,0,0,0,12,0,102
Lu Kai,100,0,0,0,0,2,0,102
Brendan Loughnane,0,0,80,0,0,21,0,101
Erick Montano,0,0,0,0,70,31,0,101
Kevin Casey,0,0,80,0,0,21,0,101
Azunna Anyanwu,100,0,0,0,0,1,0,101
Thanh Le,100,0,0,0,0,1,0,101
Te Edwards,100,0,0,0,0,1,0,101
Simeon Thoresen,0,90,0,0,0,11,0,101
Yoshiki Takahashi,0,0,80,0,0,21,0,101
Shanna Young,100,0,0,0,0,1,0,101
Austin Springer,0,90,0,0,0,11,0,101
Goran Reljic,100,0,0,0,0,0,0,100
Tim Hague,0,90,0,0,0,10,0,100
Marcin Held,0,0,80,0,0,20,0,100
Jason Black,100,0,0,0,0,0,0,100
Rory Markham,100,0,0,0,0,0,0,100
Kazuki Okubo,0,90,0,0,0,10,0,100
SangHoon Yoo,100,0,0,0,0,0,0,100
War Machine,100,0,0,0,0,0,0,100
Journey Newson,0,0,80,0,0,20,0,100
Daichi Abe,0,0,80,0,0,20,0,100
Pawel Nastula,0,90,0,0,0,10,0,100
Ernesta Kareckaite,0,0,0,0,70,30,0,100
Tedd Williams,100,0,0,0,0,0,0,100
John Salter,100,0,0,0,0,0,0,100
Kyle Stewart,100,0,0,0,0,0,0,100
Kaynan Kruschewsky,0,90,0,0,0,10,0,100
Geane Herrera,100,0,0,0,0,0,0,100
Dale Hartt,100,0,0,0,0,0,0,100
James Terry,100,0,0,0,0,0,0,100
Keisuke Sasu,0,0,80,0,0,20,0,100
Andrei Semenov,100,0,0,0,0,0,0,100
Genaro Valdez,100,0,0,0,0,0,0,100
Jonathan Wiezorek,100,0,0,0,0,0,0,100
Jose Torres,100,0,0,0,0,0,0,100
Andre Roberts,100,0,0,0,0,0,0,100
Ike Villanueva,100,0,0,0,0,0,0,100
Mike Cook,100,0,0,0,0,0,0,100
Matt Veach,100,0,0,0,0,0,0,100
Josh Sampo,0,90,0,0,0,10,0,100
Lucas Rocha,100,0,0,0,0,0,0,100
Nate Moore,100,0,0,0,0,0,0,100
Chris Cope,0,0,80,0,0,19,0,99
Keith Rockel,0,90,0,0,0,9,0,99
Jason Gonzalez,0,90,0,0,0,9,0,99
Danny Downes,0,0,80,0,0,19,0,99
Gustavo Lopez,0,90,0,0,0,9,0,99
Irina Alekseeva,0,90,0,0,0,9,0,99
Viktor Pesta,0,0,80,0,0,18,0,98
Will Campuzano,0,0,80,0,0,18,0,98
Reinier de Ridder,0,90,0,0,0,8,0,98
Renato Verissimo,0,0,80,0,0,18,0,98
Per Eklund,0,90,0,0,0,8,0,98
Royler Gracie,0,90,0,0,0,8,0,98
Gadzhi Omargadzhiev,0,90,0,0,0,8,0,98
Jon Delos Reyes,0,90,0,0,0,8,0,98
Vinny Magalhaes,0,90,0,0,0,7,0,97
Sherrard Blackledge,0,0,80,0,0,17,0,97
Igor Gracie,0,90,0,0,0,7,0,97
Luke Zachrich,0,0,80,0,0,17,0,97
Daniel McWilliams,0,90,0,0,0,7,0,97
Akbarh Arreola,0,90,0,0,0,7,0,97
Rob MacDonald,0,90,0,0,0,7,0,97
Quillan Salkilld,0,0,80,0,0,17,0,97
Chris Fishgold,0,90,0,0,0,7,0,97
Maiquel Falcao,0,0,80,0,0,17,0,97
Richie Vaculik,0,0,80,0,0,16,0,96
Coty Wheeler,0,90,0,0,0,6,0,96
Ariel Gandulla,0,0,0,0,70,1,25,96
Donnie Liles,0,90,0,0,0,6,0,96
Teemu Packalen,0,90,0,0,0,6,0,96
David Mitchell,0,0,80,0,0,15,0,95
Patrick Williams,0,90,0,0,0,5,0,95
Jason Young,0,0,80,0,0,15,0,95
Glaico Franca Moreira,0,90,0,0,0,5,0,95
Edgar Chairez,0,90,0,0,0,5,0,95
Seo Hee Ham,0,0,80,0,0,15,0,95
Satoru Kitaoka,0,0,0,0,70,0,25,95
Sarah Alpar,0,90,0,0,0,5,0,95
Fabricio Camoes,0,90,0,0,0,5,0,95
Abdul-Kareem Al-Selwady,0,0,80,0,0,15,0,95
Conor Heun,0,0,80,0,0,14,0,94
Shamar Bailey,0,0,80,0,0,14,0,94
Dmitry Sosnovskiy,0,90,0,0,0,4,0,94
Eric Lawson,0,90,0,0,0,4,0,94
Isaiah Hill,0,90,0,0,0,4,0,94
Vinicius Moreira,0,90,0,0,0,4,0,94
Eric Schambari,0,0,80,0,0,14,0,94
Jeff Bedard,0,0,80,0,0,14,0,94
Danny Martinez,0,0,80,0,0,14,0,94
Crosley Gracie,0,90,0,0,0,4,0,94
Tor Troeng,0,90,0,0,0,4,0,94
Cameron Olson,0,0,80,0,0,14,0,94
Michael Page,0,0,80,0,0,14,0,94
Matt Arroyo,0,90,0,0,0,3,0,93
Ray Sefo,0,90,0,0,0,3,0,93
Mike Budnik,0,90,0,0,0,3,0,93
Seth Dikun,0,90,0,0,0,3,0,93
Miranda Granger,0,0,80,0,0,13,0,93
Mike Ricci,0,0,80,0,0,13,0,93
Buddy Roberts,0,0,80,0,0,13,0,93
Vagner Rocha,0,90,0,0,0,3,0,93
James Lee,0,90,0,0,0,3,0,93
Pawel Pawlak,0,0,80,0,0,13,0,93
Megumi Fujii,0,90,0,0,0,3,0,93
Trevor Harris,0,90,0,0,0,3,0,93
Todd Medina,0,90,0,0,0,3,0,93
Jessin Ayari,0,0,0,0,70,23,0,93
Tim McKenzie,0,90,0,0,0,3,0,93
Will Kerr,0,90,0,0,0,2,0,92
Ken Cross,0,0,80,0,0,12,0,92
Nick Pace,0,90,0,0,0,2,0,92
Anderson Dos Santos,0,90,0,0,0,2,0,92
Wang Guan,0,0,0,0,70,22,0,92
Rulon Gardner,0,0,80,0,0,12,0,92
Kazunari Murakami,0,90,0,0,0,2,0,92
Vanessa Melo,0,0,80,0,0,12,0,92
Drako Rodriguez,0,90,0,0,0,2,0,92
Frank Hamaker,0,90,0,0,0,2,0,92
Bassil Hafez,0,0,80,0,0,12,0,92
Edson Berto,0,90,0,0,0,1,0,91
Tomoya Miyashita,0,0,80,0,0,11,0,91
Scott Morris,0,90,0,0,0,1,0,91
Niklas Backstrom,0,90,0,0,0,1,0,91
Rachael Ostovich,0,90,0,0,0,1,0,91
Shi Ming,0,0,80,0,0,11,0,91
Gabriel Miranda,0,90,0,0,0,1,0,91
Philip Perez,0,90,0,0,0,1,0,91
Alberto Montes,0,90,0,0,0,1,0,91
Rodolfo Marques Diniz,0,0,80,0,0,11,0,91
Dylan Budka,0,0,80,0,0,11,0,91
Antonio Braga Neto,0,90,0,0,0,1,0,91
Cortavious Romious,0,0,80,0,0,11,0,91
Robert Sanchez,0,90,0,0,0,1,0,91
Masakatsu Funaki,0,90,0,0,0,1,0,91
Alex Gilpin,0,90,0,0,0,0,0,90
Ian Entwistle,0,90,0,0,0,0,0,90
Ricardo Romero,0,90,0,0,0,0,0,90
Mandy Bohm,0,0,0,0,70,20,0,90
Ron Keslar,0,90,0,0,0,0,0,90
Darrius Flowers,0,90,0,0,0,0,0,90
Wayne Cole,0,90,0,0,0,0,0,90
Charles McCarthy,0,90,0,0,0,0,0,90
Hector Urbina,0,90,0,0,0,0,0,90
Liana Jojua,0,90,0,0,0,0,0,90
Jamie Colleen,0,90,0,0,0,0,0,90
Takeru Uchida,0,90,0,0,0,0,0,90
Ahmad Hassanzada,0,90,0,0,0,0,0,90
Bob Cook,0,90,0,0,0,0,0,90
Sangwook Kim,0,90,0,0,0,0,0,90
Yasuhito Namekawa,0,90,0,0,0,0,0,90
Justin Buchholz,0,90,0,0,0,0,0,90
Westin Wilson,0,90,0,0,0,0,0,90
Lee Murray,0,90,0,0,0,0,0,90
Valter Walker,0,90,0,0,0,0,0,90
Felipe dos Santos,0,0,0,0,70,20,0,90
Dustin Pague,0,90,0,0,0,0,0,90
Shuya Kamikubo,0,0,0,0,70,20,0,90
Carlos Eduardo Rocha,0,90,0,0,0,0,0,90
Paulo Cesar Silva,0,90,0,0,0,0,0,90
Dan Molina,0,90,0,0,0,0,0,90
J.T Taylor,0,90,0,0,0,0,0,90
Steven Graham,0,90,0,0,0,0,0,90
Dan Lauzon,0,90,0,0,0,0,0,90
Mike Joy,0,90,0,0,0,0,0,90
Marcio Alexandre Junior,0,90,0,0,0,0,0,90
Mike Rio,0,90,0,0,0,0,0,90
Chris Padilla,0,90,0,0,0,0,0,90
Sean McCorkle,0,90,0,0,0,0,0,90
Jason Dent,0,90,0,0,0,0,0,90
Shauna Bannon,0,0,0,0,70,20,0,90
Austin Vanderford,0,90,0,0,0,0,0,90
Scott Bessac,0,90,0,0,0,0,0,90
Levan Makashvili,0,0,0,0,70,20,0,90
Nicolle Caliari,0,90,0,0,0,0,0,90
Alex Chambers,0,90,0,0,0,0,0,90
David Zawada,0,90,0,0,0,0,0,90
Kron Gracie,0,90,0,0,0,0,0,90
Steve Bruno,0,90,0,0,0,0,0,90
Louis Gaudinot,0,90,0,0,0,0,0,90
Roman Mitichyan,0,90,0,0,0,0,0,90
Henry Briones,0,90,0,0,0,0,0,90
Domingo Pilarte,0,90,0,0,0,0,0,90
Scott Adams,0,90,0,0,0,0,0,90
Collin Huckbody,0,90,0,0,0,0,0,90
Anthony Torres,0,90,0,0,0,0,0,90
Abongo Humphrey,0,90,0,0,0,0,0,90
Koji Kitao,0,90,0,0,0,0,0,90
Mike Ciesnolevicz,0,90,0,0,0,0,0,90
Nate Loughran,0,90,0,0,0,0,0,90
Rolando Dy,0,0,80,0,0,9,0,89
Michael Lombardo,0,0,80,0,0,9,0,89
Marvin Eastman,0,0,80,0,0,9,0,89
Mason Jones,0,0,80,0,0,9,0,89
Karen Darabedyan,0,0,0,0,70,19,0,89
Joe Moreira,0,0,80,0,0,9,0,89
Josh Stansbury,0,0,0,75,0,14,0,89
Jerrel Venetiaan,0,0,0,0,70,18,0,88
Kamuela Kirk,0,0,80,0,0,8,0,88
Andreas Michailidis,0,0,80,0,0,8,0,88
Mo Miller,0,0,80,0,0,8,0,88
Mickael Lebout,0,0,80,0,0,8,0,88
Klidson Abreu,0,0,80,0,0,8,0,88
Clifford Starks,0,0,80,0,0,8,0,88
Katsuhiko Nagata,0,0,80,0,0,7,0,87
Albert Morales,0,0,0,0,70,17,0,87
Rami Hamed,0,0,80,0,0,7,0,87
Marcus LeVesseur,0,0,0,0,70,17,0,87
Melissa Martinez,0,0,80,0,0,7,0,87
Ricky Steele,0,0,0,0,70,17,0,87
Nadia Kassem,0,0,80,0,0,7,0,87
Carlos Barreto,0,0,80,0,0,7,0,87
Rafael Dias,0,0,80,0,0,6,0,86
Rashad Coulter,0,0,80,0,0,6,0,86
Chalid Arrab,0,0,80,0,0,6,0,86
Danny Chavez,0,0,80,0,0,6,0,86
Tyrone Roberts,0,0,80,0,0,6,0,86
Leah Letson,0,0,0,0,70,16,0,86
Colton Smith,0,0,80,0,0,6,0,86
Jerrod Sanders,0,0,80,0,0,5,0,85
Romie Aram,0,0,80,0,0,5,0,85
Eiji Mitsuoka,0,0,80,0,0,5,0,85
Yan Qihui,0,0,0,0,70,15,0,85
Clay Harvison,0,0,0,0,70,15,0,85
Tony Johnson,0,0,80,0,0,5,0,85
Mark Hughes,0,0,80,0,0,5,0,85
Chad George,0,0,80,0,0,5,0,85
Raphael Pessoa,0,0,80,0,0,5,0,85
Brendan O'Reilly,0,0,80,0,0,4,0,84
Roger Narvaez,0,0,0,0,70,14,0,84
Kanako Murata,0,0,80,0,0,3,0,83
Hans Stringer,0,0,0,0,70,13,0,83
Ben Earwood,0,0,80,0,0,3,0,83
Phil Harris,0,0,80,0,0,3,0,83
Shungo Oyama,0,0,80,0,0,3,0,83
Alex Da Silva,0,0,80,0,0,2,0,82
Shinsho Anzai,0,0,80,0,0,2,0,82
Gesias Cavalcante,0,0,0,0,70,12,0,82
Dave Jansen,0,0,80,0,0,2,0,82
Jesus Pinedo,0,0,80,0,0,2,0,82
David Michaud,0,0,80,0,0,2,0,82
Kyle Driscoll,0,0,80,0,0,2,0,82
Anton Turkalj,0,0,80,0,0,2,0,82
Puja Tomar,0,0,0,0,70,11,0,81
Adam Antolin,0,0,0,0,70,11,0,81
Carl Malenko,0,0,80,0,0,1,0,81
Julia Budd,0,0,80,0,0,1,0,81
Bobby Stack,0,0,80,0,0,0,0,80
Gasan Umalatov,0,0,80,0,0,0,0,80
Ricky Legere Jr.,0,0,80,0,0,0,0,80
Lara Procopio,0,0,80,0,0,0,0,80
Boston Salmon,0,0,80,0,0,0,0,80
Kai Kamaka,0,0,80,0,0,0,0,80
Cole Province,0,0,80,0,0,0,0,80
Erisson Ferreira,0,0,80,0,0,0,0,80
Mads Burnell,0,0,80,0,0,0,0,80
Sirwan Kakai,0,0,80,0,0,0,0,80
Timmy Cuamba,0,0,80,0,0,0,0,80
Bahatebole Batebolati,0,0,80,0,0,0,0,80
Daniel Barez,0,0,80,0,0,0,0,80
Danyelle Wolf,0,0,80,0,0,0,0,80
Ralph Gracie,0,0,80,0,0,0,0,80
Patrick Walsh,0,0,80,0,0,0,0,80
Montserrat Conejo Ruiz,0,0,80,0,0,0,0,80
Matt Ricehouse,0,0,80,0,0,0,0,80
Sidney Outlaw,0,0,80,0,0,0,0,80
John Franchi,0,0,0,0,70,10,0,80
Dwight Joseph,0,0,80,0,0,0,0,80
Papy Abedi,0,0,0,0,70,10,0,80
Lemont Davis,0,0,80,0,0,0,0,80
Curt Warburton,0,0,80,0,0,0,0,80
Callan Potter,0,0,80,0,0,0,0,80
Heather Clark,0,0,80,0,0,0,0,80
Jaime Alvarez,0,0,80,0,0,0,0,80
Kazuki Tokudome,0,0,80,0,0,0,0,80
Takeshi Yamazaki,0,0,80,0,0,0,0,80
Tokitaka Nakanishi,0,0,80,0,0,0,0,80
Zach Skinner,0,0,80,0,0,0,0,80
Cody Pfister,0,0,80,0,0,0,0,80
Carlo Pedersoli Jr.,0,0,0,0,70,9,0,79
Yao Zhikui,0,0,0,0,70,9,0,79
Montserrat Rendon,0,0,0,0,70,9,0,79
John Polakowski,0,0,0,0,70,9,0,79
Dan Cramer,0,0,0,0,70,8,0,78
Chris Dempsey,0,0,0,0,70,7,0,77
Hailey Cowan,0,0,0,0,70,7,0,77
Olivier Murad,0,0,0,0,70,6,0,76
Cristiano Marcello,0,0,0,0,70,6,0,76
Josh McDonald,0,0,0,75,0,0,0,75
John Gunther,0,0,0,75,0,0,0,75
Masio Fullen,0,0,0,0,70,5,0,75
Will Ribeiro,0,0,0,0,70,5,0,75
Chris Tuchscherer,0,0,0,75,0,0,0,75
Tom Niinimaki,0,0,0,0,70,4,0,74
Martin Day,0,0,0,0,0,72,0,72
Augusto Mendes,0,0,0,0,70,2,0,72
Steve Steinbeiss,0,0,0,0,0,72,0,72
Ernest Chavez,0,0,0,0,70,2,0,72
Sean Soriano,0,0,0,0,0,72,0,72
Phillipe Nover,0,0,0,0,70,0,0,70
Talita Alencar,0,0,0,0,70,0,0,70
Yusuke Kawaguchi,0,0,0,0,70,0,0,70
Koyomi Matsushima,0,0,0,0,70,0,0,70
Joe Warren,0,0,0,0,70,0,0,70
Saimon Oliveira,0,0,0,0,70,0,0,70
Bruno Santos,0,0,0,0,70,0,0,70
Quinn Mulhern,0,0,0,0,70,0,0,70
Irwin Rivera,0,0,0,0,70,0,0,70
Bogdan Grad,0,0,0,0,70,0,0,70
Milana Dudieva,0,0,0,0,70,0,0,70
Juan Puerta,0,0,0,0,70,0,0,70
Joe Ellenberger,0,0,0,0,70,0,0,70
Henry Martinez,0,0,0,0,70,0,0,70
Jim Alers,0,0,0,0,70,0,0,70
Gisele Moreira,0,0,0,0,70,0,0,70
Lucrezia Ria,0,0,0,0,70,0,0,70
Alptekin Ozkilic,0,0,0,0,70,0,0,70
Azat Maksum,0,0,0,0,70,0,0,70
Darrell Horcher,0,0,0,0,70,0,0,70
Eddie Yagin,0,0,0,0,70,0,0,70
Nick Ertl,0,0,0,0,70,0,0,70
Rolando Bedoya,0,0,0,0,0,56,0,56
Michael Aswell,0,0,0,0,0,53,0,53
Carli Judice,0,0,0,0,0,50,0,50
Akira Kikuchi,0,0,0,0,0,49,0,49
Blood Diamond,0,0,0,0,0,47,0,47
Nolan Ticman,0,0,0,0,0,43,0,43
Patrick Murphy,0,0,0,0,0,39,0,39
Istela Nunes,0,0,0,0,0,39,0,39
JR Coughran,0,0,0,0,0,38,0,38
Yoislandy Izquierdo,0,0,0,0,0,35,0,35
Julie Kedzie,0,0,0,0,0,35,0,35
Matt Van Buren,0,0,0,0,0,34,0,34
Taneisha Tennant,0,0,0,0,0,34,0,34
Alan Omer,0,0,0,0,0,34,0,34
Johnny Rees,0,0,0,0,0,32,0,32
Allan Zuniga,0,0,0,0,0,32,0,32
Kelly Faszholz,0,0,0,0,0,31,0,31
Darian Weeks,0,0,0,0,0,31,0,31
Mychal Clark,0,0,0,0,0,29,0,29
Scott Shaffer,0,0,0,0,0,28,0,28
Victor Reyna,0,0,0,0,0,28,0,28
Mike King,0,0,0,0,0,27,0,27
Ross Pointon,0,0,0,0,0,2,25,27
Felipe Olivieri,0,0,0,0,0,27,0,27
Naho Sugiyuma,0,0,0,0,0,1,25,26
Gabe Lemley,0,0,0,0,0,0,25,25
Chance Farrar,0,0,0,0,0,0,25,25
Jan Finney,0,0,0,0,0,0,25,25
Takayo Hashi,0,0,0,0,0,0,25,25
Carlo Prater,0,0,0,0,0,0,25,25
Fernando Gonzalez,0,0,0,0,0,25,0,25
Kit Cope,0,0,0,0,0,0,25,25
Bryan Pardoe,0,0,0,0,0,0,25,25
Joe Hurley,0,0,0,0,0,0,25,25
Justin McElfresh,0,0,0,0,0,0,25,25
Andre Pederneiras,0,0,0,0,0,0,25,25
Ryan McGivern,0,0,0,0,0,0,25,25
Miika Mehmet,0,0,0,0,0,0,25,25
Kai Asakura,0,0,0,0,0,0,25,25
Jameel Massouh,0,0,0,0,0,25,0,25
Ronald Jhun,0,0,0,0,0,0,25,25
Solomon Renfro,0,0,0,0,0,25,0,25
Tonya Evinger,0,0,0,0,0,0,25,25
Jakob Lovstad,0,0,0,0,0,0,25,25
Micol Di Segni,0,0,0,0,0,24,0,24
Mateo Vogel,0,0,0,0,0,24,0,24
Tiki Ghosn,0,0,0,0,0,23,0,23
Duda Santana,0,0,0,0,0,23,0,23
Victor Valimaki,0,0,0,0,0,22,0,22
Yosdenis Cedeno,0,0,0,0,0,22,0,22
Kevin Croom,0,0,0,0,0,22,0,22
Jay Perrin,0,0,0,0,0,21,0,21
Rayanne dos Santos,0,0,0,0,0,21,0,21
Kalindra Faria,0,0,0,0,0,21,0,21
Patrik White,0,0,0,0,0,20,0,20
Alice Ardelean,0,0,0,0,0,20,0,20
Alan Baudot,0,0,0,0,0,19,0,19
Jesse Ronson,0,0,0,0,0,19,0,19
Terrion Ware,0,0,0,0,0,18,0,18
Jeff Joslin,0,0,0,0,0,18,0,18
Willamy Freire,0,0,0,0,0,18,0,18
Dean Barry,0,0,0,0,0,18,0,18
Mike Seal,0,0,0,0,0,17,0,17
Dave Galera,0,0,0,0,0,17,0,17
Shoji Maruyama,0,0,0,0,0,17,0,17
Zelim Imadaev,0,0,0,0,0,17,0,17
Hector Ramirez,0,0,0,0,0,17,0,17
Ruben Villareal,0,0,0,0,0,16,0,16
Jeremy Larsen,0,0,0,0,0,16,0,16
Sam Greco,0,0,0,0,0,16,0,16
Jose Palacios,0,0,0,0,0,15,0,15
Zarah Fairn,0,0,0,0,0,15,0,15
Antonio McKee,0,0,0,0,0,15,0,15
Phil Cardella,0,0,0,0,0,15,0,15
Ricardo Funch,0,0,0,0,0,15,0,15
Brandon Cash,0,0,0,0,0,14,0,14
Tiffany Masters,0,0,0,0,0,14,0,14
Davi Bittencourt,0,0,0,0,0,14,0,14
Steve Montgomery,0,0,0,0,0,14,0,14
Ali AlQaisi,0,0,0,0,0,14,0,14
Colin Fletcher,0,0,0,0,0,14,0,14
Jean Francois Lenogue,0,0,0,0,0,13,0,13
Roldan Sangcha'an,0,0,0,0,0,13,0,13
Alejandro Flores,0,0,0,0,0,13,0,13
Kultar Gill,0,0,0,0,0,13,0,13
Tyler Diamond,0,0,0,0,0,13,0,13
Antonio Dos Santos,0,0,0,0,0,13,0,13
Nohelin Hernandez,0,0,0,0,0,12,0,12
Barb Honchak,0,0,0,0,0,12,0,12
Brodie Farber,0,0,0,0,0,12,0,12
Sabah Homasi,0,0,0,0,0,12,0,12
Denis Stojnic,0,0,0,0,0,12,0,12
Joshua Weems,0,0,0,0,0,12,0,12
Joe Merritt,0,0,0,0,0,12,0,12
Joe Lowry,0,0,0,0,0,12,0,12
TJ Laramie,0,0,0,0,0,12,0,12
Jorge Ortiz,0,0,0,0,0,11,0,11
Denys Bondar,0,0,0,0,0,11,0,11
Jared Rollins,0,0,0,0,0,11,0,11
Jaime Jara,0,0,0,0,0,11,0,11
Malik Lewis,0,0,0,0,0,11,0,11
Scott Junk,0,0,0,0,0,11,0,11
Yuri Panferov,0,0,0,0,0,11,0,11
Todd Moore,0,0,0,0,0,10,0,10
Michael Cora,0,0,0,0,0,10,0,10
Angelo Trevino,0,0,0,0,0,10,0,10
Jon Olav Einemo,0,0,0,0,0,10,0,10
Cameron Dollar,0,0,0,0,0,10,0,10
KyuSung Kim,0,0,0,0,0,10,0,10
Kiefer Crosbie,0,0,0,0,0,10,0,10
Mike Polchlopek,0,0,0,0,0,10,0,10
Wade Shipp,0,0,0,0,0,10,0,10
Khadis Ibragimov,0,0,0,0,0,10,0,10
Louis Taylor,0,0,0,0,0,10,0,10
Kevin Jordan,0,0,0,0,0,9,0,9
Nazareno Malegarie,0,0,0,0,0,9,0,9
Steve Nelmark,0,0,0,0,0,9,0,9
Dylan Mantello,0,0,0,0,0,9,0,9
Eduardo Neves,0,0,0,0,0,9,0,9
Al Matavao,0,0,0,0,0,8,0,8
Anying Wang,0,0,0,0,0,8,0,8
Sergio Gomez,0,0,0,0,0,8,0,8
Bernardo Magalhaes,0,0,0,0,0,8,0,8
Jessica Rakoczy,0,0,0,0,0,8,0,8
Paulo Renato Junior,0,0,0,0,0,8,0,8
Anthony Macias,0,0,0,0,0,8,0,8
Marcelo Rojo,0,0,0,0,0,8,0,8
Joey Roberts,0,0,0,0,0,8,0,8
Hector Aldana,0,0,0,0,0,7,0,7
Teddy Ash,0,0,0,0,0,7,0,7
Gideon Ray,0,0,0,0,0,7,0,7
Keith Wisniewski,0,0,0,0,0,7,0,7
Yurij Kiseliov,0,0,0,0,0,7,0,7
Jesse Juarez,0,0,0,0,0,7,0,7
Rodney Faverus,0,0,0,0,0,7,0,7
Brian Sleeman,0,0,0,0,0,7,0,7
Leonardo Guimaraes,0,0,0,0,0,7,0,7
George Bush,0,0,0,0,0,7,0,7
Aaron Jeffery,0,0,0,0,0,7,0,7
Derrick Noble,0,0,0,0,0,7,0,7
Mark Schultz,0,0,0,0,0,7,0,7
Kestutis Smirnovas,0,0,0,0,0,7,0,7
Robert Densley,0,0,0,0,0,7,0,7
Taylor Johnson,0,0,0,0,0,7,0,7
Nandor Guelmino,0,0,0,0,0,7,0,7
Jacob Silva,0,0,0,0,0,7,0,7
Alex Andrade,0,0,0,0,0,6,0,6
Danny Mitchell,0,0,0,0,0,6,0,6
Anton Zafir,0,0,0,0,0,6,0,6
Kenneth Seegrist,0,0,0,0,0,6,0,6
Jose Landi-Jons,0,0,0,0,0,6,0,6
Bob Schrijber,0,0,0,0,0,6,0,6
Nissen Osterneck,0,0,0,0,0,6,0,6
Razak Al-Hassan,0,0,0,0,0,6,0,6
Brian Lo-A-Njoe,0,0,0,0,0,6,0,6
Kris McCray,0,0,0,0,0,6,0,6
Cesar Arzamendia,0,0,0,0,0,6,0,6
Dayana Silva,0,0,0,0,0,6,0,6
Shonte Barnes,0,0,0,0,0,6,0,6
Brian Schwartz,0,0,0,0,0,6,0,6
Corinne Laframboise,0,0,0,0,0,6,0,6
Joey Gambino,0,0,0,0,0,6,0,6
Joey Gomez,0,0,0,0,0,6,0,6
Carlton Jones,0,0,0,0,0,5,0,5
Roger Zapata,0,0,0,0,0,5,0,5
Jason Jackson,0,0,0,0,0,5,0,5
Larry Cureton,0,0,0,0,0,5,0,5
Nasrudin Nasrudinov,0,0,0,0,0,5,0,5
Anthony Morrison,0,0,0,0,0,5,0,5
Stewart Nicoll,0,0,0,0,0,5,0,5
Marilia Santos,0,0,0,0,0,5,0,5
Jamie Yager,0,0,0,0,0,5,0,5
Kazuma Maruyama,0,0,0,0,0,5,0,5
Grigory Popov,0,0,0,0,0,5,0,5
Roybert Echeverria,0,0,0,0,0,5,0,5
Steve Judson,0,0,0,0,0,5,0,5
Kwan Ho Kwak,0,0,0,0,0,4,0,4
Juan Andres Luna,0,0,0,0,0,4,0,4
Stefan Leko,0,0,0,0,0,4,0,4
Niklas Stolze,0,0,0,0,0,4,0,4
Juan Manuel Puig,0,0,0,0,0,4,0,4
JunYoung Hong,0,0,0,0,0,4,0,4
Lisa Kyriacou,0,0,0,0,0,4,0,4
Cristina Stanciu,0,0,0,0,0,4,0,4
Michal Figlak,0,0,0,0,0,4,0,4
Jordan Vucenic,0,0,0,0,0,4,0,4
Cam Rowston,0,0,0,0,0,4,0,4
Rafael  Del Real,0,0,0,0,0,4,0,4
Josh LaBerge,0,0,0,0,0,4,0,4
Wagner Prado,0,0,0,0,0,4,0,4
Christina Marks,0,0,0,0,0,4,0,4
Kyle Dietz,0,0,0,0,0,3,0,3
Errol Zimmerman,0,0,0,0,0,3,0,3
Bobby Nash,0,0,0,0,0,3,0,3
Oliver Enkamp,0,0,0,0,0,3,0,3
Mike Moreno,0,0,0,0,0,3,0,3
Nikolay Veretennikov,0,0,0,0,0,3,0,3
Eli Aronov,0,0,0,0,0,3,0,3
Vitor Ribeiro,0,0,0,0,0,3,0,3
Anthony Lapsley,0,0,0,0,0,3,0,3
Alexander Morgan,0,0,0,0,0,3,0,3
Jake Lindsey,0,0,0,0,0,3,0,3
Rodrigo Lidio,0,0,0,0,0,3,0,3
Hayder Hassan,0,0,0,0,0,3,0,3
Bobby McAndrews,0,0,0,0,0,3,0,3
Royce Alger,0,0,0,0,0,3,0,3
Tuco Tokkos,0,0,0,0,0,3,0,3
Elaina Maxwell,0,0,0,0,0,3,0,3
Gary Padilla,0,0,0,0,0,3,0,3
Lucasz Sudolski,0,0,0,0,0,3,0,3
Ernie Verdicia,0,0,0,0,0,2,0,2
Fernando Bruno,0,0,0,0,0,2,0,2
Kyle Sturgeon,0,0,0,0,0,2,0,2
Lucio Linhares,0,0,0,0,0,2,0,2
Rodolfo Rubio Perez,0,0,0,0,0,2,0,2
Mario Piazzon,0,0,0,0,0,2,0,2
Masanori Suda,0,0,0,0,0,2,0,2
Chris Hofmann,0,0,0,0,0,2,0,2
Bryan Vetell,0,0,0,0,0,2,0,2
Yuri Villefort,0,0,0,0,0,2,0,2
Drew Dimanlig,0,0,0,0,0,2,0,2
Won Sik Park,0,0,0,0,0,2,0,2
Yuki Sasaki,0,0,0,0,0,2,0,2
Lisa Ellis,0,0,0,0,0,2,0,2
Ulysses Gomez,0,0,0,0,0,2,0,2
Scott Norton,0,0,0,0,0,2,0,2
Lucas Gamaza,0,0,0,0,0,2,0,2
Luis Santos,0,0,0,0,0,2,0,2
Ren Ozaki,0,0,0,0,0,2,0,2
Vinicius Cenci,0,0,0,0,0,2,0,2
Mike Campbell,0,0,0,0,0,2,0,2
Brandon Melendez,0,0,0,0,0,2,0,2
Cameron VanCamp,0,0,0,0,0,2,0,2
Juancamilo Ronderos,0,0,0,0,0,2,0,2
David Lee,0,0,0,0,0,1,0,1
Tim Williams,0,0,0,0,0,1,0,1
Sarah D'alelio,0,0,0,0,0,1,0,1
Won Jin Eoh,0,0,0,0,0,1,0,1
Dmitri Stepanov,0,0,0,0,0,1,0,1
Harry Moskowitz,0,0,0,0,0,1,0,1
Alejandro Garcia,0,0,0,0,0,1,0,1
Paul Georgieff,0,0,0,0,0,1,0,1
John Cofer,0,0,0,0,0,1,0,1
Branko Cikatic,0,0,0,0,0,1,0,1
Alvin Cacdac,0,0,0,0,0,1,0,1
Joe Charles,0,0,0,0,0,1,0,1
Joao Roque,0,0,0,0,0,1,0,1
Fabio Cherant,0,0,0,0,0,1,0,1
Leonardo Morales,0,0,0,0,0,1,0,1
Tim Lajcik,0,0,0,0,0,1,0,1
Emily Kagan,0,0,0,0,0,1,0,1
Tommy Hayden,0,0,0,0,0,1,0,1
Antwain Britt,0,0,0,0,0,1,0,1
Tom Blackledge,0,0,0,0,0,1,0,1
Alex Ricci,0,0,0,0,0,1,0,1
Lee Kwan Bum,0,0,0,0,0,1,0,1
Scott Fiedler,0,0,0,0,0,1,0,1
Kristof Midoux,0,0,0,0,0,1,0,1
Dennis Reed,0,0,0,0,0,1,0,1
Lukasz Sajewski,0,0,0,0,0,1,0,1
Minoki Ichihara,0,0,0,0,0,1,0,1
Seichi Ikemoto,0,0,0,0,0,1,0,1
Ariel Beck,0,0,0,0,0,1,0,1
Amiran Gogoladze,0,0,0,0,0,1,0,1
Philip Preece,0,0,0,0,0,1,0,1
Kyron Bowen,0,0,0,0,0,1,0,1
Jared Papazian,0,0,0,0,0,1,0,1
Leonardo Silva de Oliveira,0,0,0,0,0,1,0,1
Jumabieke Tuerxun,0,0,0,0,0,1,0,1
Nathan Jones,0,0,0,0,0,1,0,1
Liliya Shakirova,0,0,0,0,0,1,0,1
Maurice Mitchell,0,0,0,0,0,1,0,1
Emiliano Sordi,0,0,0,0,0,1,0,1
Mark Holst,0,0,0,0,0,1,0,1
Clay French,0,0,0,0,0,1,0,1
Takafumi Otsuka,0,0,0,0,0,1,0,1
Paul Rodriguez,0,0,0,0,0,1,0,1
Sean Salmon,0,0,0,0,0,1,0,1
Wes Combs,0,0,0,0,0,1,0,1
David Hood,0,0,0,0,0,1,0,1
Marcus Bossett,0,0,0,0,0,1,0,1
Greg Rebello,0,0,0,0,0,1,0,1
Mike Jackson,0,0,0,0,0,1,0,1
Caros Fodor,0,0,0,0,0,1,0,1
Amir Rahnavardi,0,0,0,0,0,1,0,1
Jorge Lopez,0,0,0,0,0,1,0,1
Flavio Luiz Moura,0,0,0,0,0,1,0,1
Reese Andy,0,0,0,0,0,0,0,0
Wes Albritton,0,0,0,0,0,0,0,0
Aurelijus Kerpe,0,0,0,0,0,0,0,0
Hiroyuki Abe,0,0,0,0,0,0,0,0
Raou Raou,0,0,0,0,0,0,0,0
Roman Salazar,0,0,0,0,0,0,0,0
Shane Howell,0,0,0,0,0,0,0,0
Erik Apple,0,0,0,0,0,0,0,0
Jae Hyun Park,0,0,0,0,0,0,0,0
Gigo Jara,0,0,0,0,0,0,0,0
Mal Foki,0,0,0,0,0,0,0,0
Victor Dias,0,0,0,0,0,0,0,0
Matheus Scheffel,0,0,0,0,0,0,0,0
Angela Magana,0,0,0,0,0,0,0,0
Justin Bruckmann,0,0,0,0,0,0,0,0
Ryan Roberts,0,0,0,0,0,0,0,0
Hugo Cunha,0,0,0,0,0,0,0,0
Leiticia Pestova,0,0,0,0,0,0,0,0
Adam Yandiev,0,0,0,0,0,0,0,0
Dae Won Kim,0,0,0,0,0,0,0,0
Aaron Phillips,0,0,0,0,0,0,0,0
Nick Rossborough,0,0,0,0,0,0,0,0
Luke Caudillo,0,0,0,0,0,0,0,0
Carlos Calderon,0,0,0,0,0,0,0,0
Masutatsu Yano,0,0,0,0,0,0,0,0
Shane Primm,0,0,0,0,0,0,0,0
Anthony Christodoulou,0,0,0,0,0,0,0,0
Yukio Sakaguchi,0,0,0,0,0,0,0,0
Murtaza Talha,0,0,0,0,0,0,0,0
Dan Moret,0,0,0,0,0,0,0,0
Junior Barata,0,0,0,0,0,0,0,0
Felix Lee Mitchell,0,0,0,0,0,0,0,0
David Roberts,0,0,0,0,0,0,0,0
Rosi Sexton,0,0,0,0,0,0,0,0
Mitch Ramirez,0,0,0,0,0,0,0,0
Ruan Potts,0,0,0,0,0,0,0,0
Henrique Shiguemoto,0,0,0,0,0,0,0,0
Carlos Leal,0,0,0,0,0,0,0,0
David Kaplan,0,0,0,0,0,0,0,0
Tyra Parker,0,0,0,0,0,0,0,0
Rafael Freitas,0,0,0,0,0,0,0,0
Ray Wizard,0,0,0,0,0,0,0,0
Andre Walker,0,0,0,0,0,0,0,0
Junya Kudo,0,0,0,0,0,0,0,0
Darrell Montague,0,0,0,0,0,0,0,0
Will Chope,0,0,0,0,0,0,0,0
Adam Cella,0,0,0,0,0,0,0,0
Justin Haskins,0,0,0,0,0,0,0,0
Frank Lester,0,0,0,0,0,0,0,0
Moti Horenstein,0,0,0,0,0,0,0,0
Rhys McKee,0,0,0,0,0,0,0,0
Sean Daugherty,0,0,0,0,0,0,0,0
Kevin Natividad,0,0,0,0,0,0,0,0
Lodune Sincaid,0,0,0,0,0,0,0,0
Hu Yaozong,0,0,0,0,0,0,0,0
Denis Sobolev,0,0,0,0,0,0,0,0
Donald Sanchez,0,0,0,0,0,0,0,0
Reza Nasri,0,0,0,0,0,0,0,0
Herdem Alacabek,0,0,0,0,0,0,0,0
Jason Reinhardt,0,0,0,0,0,0,0,0
Zviad Lazishvili,0,0,0,0,0,0,0,0
Eddy Millis,0,0,0,0,0,0,0,0
Steve Berger,0,0,0,0,0,0,0,0
Townsend Saunders,0,0,0,0,0,0,0,0
Matt Lucas,0,0,0,0,0,0,0,0
Wallen Del Rosario,0,0,0,0,0,0,0,0
Tim Catalfo,0,0,0,0,0,0,0,0
Nicdali Rivera-Calanoc,0,0,0,0,0,0,0,0
Bruno Oliveira,0,0,0,0,0,0,0,0
Alberto Crane,0,0,0,0,0,0,0,0
Nick Fiore,0,0,0,0,0,0,0,0
Anna Elmose,0,0,0,0,0,0,0,0
Yazan Hajeh,0,0,0,0,0,0,0,0
Fabiano Scherner,0,0,0,0,0,0,0,0
Liudvik Sholinian,0,0,0,0,0,0,0,0
Bristol Marunde,0,0,0,0,0,0,0,0
Ryuki Ueyama,0,0,0,0,0,0,0,0
Izabela Badurek,0,0,0,0,0,0,0,0
Dos Caras Jr.,0,0,0,0,0,0,0,0
Angel Pacheco,0,0,0,0,0,0,0,0
Suman Mokhtarian,0,0,0,0,0,0,0,0
Hashem Arkhagha,0,0,0,0,0,0,0,0
Masanori Tonooka,0,0,0,0,0,0,0,0
Sean Alvarez,0,0,0,0,0,0,0,0
CJ Keith,0,0,0,0,0,0,0,0
Marcus Silveira,0,0,0,0,0,0,0,0
Matt Bessette,0,0,0,0,0,0,0,0
Windri Patilima,0,0,0,0,0,0,0,0
JJ Ambrose,0,0,0,0,0,0,0,0
Richie Smullen,0,0,0,0,0,0,0,0
Brandon Saling,0,0,0,0,0,0,0,0
Nick Newell,0,0,0,0,0,0,0,0
Greg McIntyre,0,0,0,0,0,0,0,0
Sam Fulton,0,0,0,0,0,0,0,0
Jason Godsey,0,0,0,0,0,0,0,0
Ryan Parker,0,0,0,0,0,0,0,0
Eric Wisely,0,0,0,0,0,0,0,0
Charlie Kohler,0,0,0,0,0,0,0,0
John Marsh,0,0,0,0,0,0,0,0
Mehdi Baghdad,0,0,0,0,0,0,0,0
John Renken,0,0,0,0,0,0,0,0
Wagner Campos,0,0,0,0,0,0,0,0
James Giboo,0,0,0,0,0,0,0,0
Andreas Stahl,0,0,0,0,0,0,0,0
Xavier Foupa-Pokam,0,0,0,0,0,0,0,0
Patricia Alujas,0,0,0,0,0,0,0,0
Abdellah Er-Ramy,0,0,0,0,0,0,0,0
Ramona Pascual,0,0,0,0,0,0,0,0
Dave Phillips,0,0,0,0,0,0,0,0
Steve Kennedy,0,0,0,0,0,0,0,0
Claudia Leite,0,0,0,0,0,0,0,0
JungHyun Lee,0,0,0,0,0,0,0,0
Leon Shahbazyan,0,0,0,0,0,0,0,0
Jason Suttie,0,0,0,0,0,0,0,0
Alex Torres,0,0,0,0,0,0,0,0
Guilherme Vasconcelos,0,0,0,0,0,0,0,0
Tina Lahdemaki,0,0,0,0,0,0,0,0
Yusuke Imamura,0,0,0,0,0,0,0,0
Andy Enz,0,0,0,0,0,0,0,0
Jeremy  Freitag,0,0,0,0,0,0,0,0
Brian Geraghty,0,0,0,0,0,0,0,0
Stevie Lynch,0,0,0,0,0,0,0,0
Rainn Guerrero,0,0,0,0,0,0,0,0
Michel Quinones,0,0,0,0,0,0,0,0
Jong Man Kim,0,0,0,0,0,0,0,0
TJ Cook,0,0,0,0,0,0,0,0
Jason Tan,0,0,0,0,0,0,0,0
Mitch Raposo,0,0,0,0,0,0,0,0
Kazunori Yokota,0,0,0,0,0,0,0,0
Ron Fields,0,0,0,0,0,0,0,0
Maimaitituoheti Keremuaili,0,0,0,0,0,0,0,0
Justin Jones,0,0,0,0,0,0,0,0
Yuri Vaulin,0,0,0,0,0,0,0,0
Marcos Conrado Jr.,0,0,0,0,0,0,0,0
Dante Rivera,0,0,0,0,0,0,0,0
Chris Sanford,0,0,0,0,0,0,0,0
Wendell Oliveira Marques,0,0,0,0,0,0,0,0
Jose Maria,0,0,0,0,0,0,0,0
Chris Liguori,0,0,0,0,0,0,0,0
Yanis Ghemmouri,0,0,0,0,0,0,0,0
Vernon White,0,0,0,0,0,0,0,0
Mike Bourke,0,0,0,0,0,0,0,0
Will Santiago,0,0,0,0,0,0,0,0
Gaetano Pirrello,0,0,0,0,0,0,0,0
Iliarde Santos,0,0,0,0,0,0,0,0
Solomon Hutcherson,0,0,0,0,0,0,0,0
Tony Juarez,0,0,0,0,0,0,0,0
Steven Koslow,0,0,0,0,0,0,0,0
Joao Pierini,0,0,0,0,0,0,0,0
Murad Chunkaiev,0,0,0,0,0,0,0,0
Derrick Krantz,0,0,0,0,0,0,0,0
Carl Deaton,0,0,0,0,0,0,0,0
Jesse Forbes,0,0,0,0,0,0,0,0
Ozzy Diaz,0,0,0,0,0,0,0,0
Ansar Chalangov,0,0,0,0,0,0,0,0
Kelly Dullanty,0,0,0,0,0,0,0,0
Teila Tuli,0,0,0,0,0,0,0,0
Federico Lopez,0,0,0,0,0,0,0,0
Pearl Gonzalez,0,0,0,0,0,0,0,0
Christophe Leninger,0,0,0,0,0,0,0,0
Todd Gouwenberg,0,0,0,0,0,0,0,0
Joe Camacho,0,0,0,0,0,0,0,0
Samy Schiavo,0,0,0,0,0,0,0,0
Joao Elias,0,0,0,0,0,0,0,0
Neil Wain,0,0,0,0,0,0,0,0
David Dodd,0,0,0,0,0,0,0,0
Fabio Silva,0,0,0,0,0,0,0,0
Thomas Paull,0,0,0,0,0,0,0,0
Yoko Takahashi,0,0,0,0,0,0,0,0
Daniel Jolly,0,0,0,0,0,0,0,0
Josh Wick,0,0,0,0,0,0,0,0
Igor Zinoviev,0,0,0,0,0,0,0,0
Fatima Kline,0,0,0,0,0,0,0,0
Elvis Mutapcic,0,0,0,0,0,0,0,0
Yosuke Nishijima,0,0,0,0,0,0,0,0
Ravena Oliveira,0,0,0,0,0,0,0,0
Kailan Hill,0,0,0,0,0,0,0,0
Michal Martinek,0,0,0,0,0,0,0,0
Ivan Serati,0,0,0,0,0,0,0,0
Kasey Tanner,0,0,0,0,0,0,0,0
Sidney Silva,0,0,0,0,0,0,0,0
Tetsuji Kato,0,0,0,0,0,0,0,0
Jesse Bongfeldt,0,0,0,0,0,0,0,0
Mike Wessel,0,0,0,0,0,0,0,0
Jules Bruchez,0,0,0,0,0,0,0,0
Pedro Otavio,0,0,0,0,0,0,0,0
Roberto Traven,0,0,0,0,0,0,0,0
Tsuyoshi Kurihara,0,0,0,0,0,0,0,0
Frank Megallon,0,0,0,0,0,0,0,0
Greg Stott,0,0,0,0,0,0,0,0
Magomed Sultanakhmedov,0,0,0,0,0,0,0,0
Scott Harper,0,0,0,0,0,0,0,0
Johil de Oliveira,0,0,0,0,0,0,0,0
Anthony Ivy,0,0,0,0,0,0,0,0
Cindy Dandois,0,0,0,0,0,0,0,0
Leo Sylvest,0,0,0,0,0,0,0,0
Mabelly Lima,0,0,0,0,0,0,0,0
Iouri Kotchkine,0,0,0,0,0,0,0,0
David Gardner,0,0,0,0,0,0,0,0
Jesse Sanders,0,0,0,0,0,0,0,0
Adrian Diaz,0,0,0,0,0,0,0,0
Sheila Gaff,0,0,0,0,0,0,0,0
Brad Imes,0,0,0,0,0,0,0,0
Rolles Gracie,0,0,0,0,0,0,0,0
Chris Guillen,0,0,0,0,0,0,0,0
Chuck O'Neil,0,0,0,0,0,0,0,0
Wataru Sakata,0,0,0,0,0,0,0,0
Jorge de Oliveira,0,0,0,0,0,0,0,0
Michael Imperato,0,0,0,0,0,0,0,0
Peggy Morgan,0,0,0,0,0,0,0,0
Pauline Macias,0,0,0,0,0,0,0,0
Chris Solomon,0,0,0,0,0,0,0,0
Angga,0,0,0,0,0,0,0,0
Anistavio Medeiros,0,0,0,0,0,0,0,0
Floyd Sword,0,0,0,0,0,0,0,0
Jacobi Jones,0,0,0,0,0,0,0,0
Jay Cucciniello,0,0,0,0,0,0,0,0
Joe Giannetti,0,0,0,0,0,0,0,0
Josh Rafferty,0,0,0,0,0,0,0,0
Shaun Etchell,0,0,0,0,0,0,0,0
Ronys Torres,0,0,0,0,0,0,0,0
Stephen Ledbetter,0,0,0,0,0,0,0,0
Robert Bryczek,0,0,0,0,0,0,0,0
Tomohiko Hashimoto,0,0,0,0,0,0,0,0
Josh Copeland,0,0,0,0,0,0,0,0
Jermaine Andre,0,0,0,0,0,0,0,0
Yukiya Naito,0,0,0,0,0,0,0,0
Leigh Remedios,0,0,0,0,0,0,0,0
Alberta Cerra Leon,0,0,0,0,0,0,0,0
Isabela de Padua,0,0,0,0,0,0,0,0
Mario Rivera,0,0,0,0,0,0,0,0
Darrel Gholar,0,0,0,0,0,0,0,0
Rainy Martinez,0,0,0,0,0,0,0,0
Damir Mirenic,0,0,0,0,0,0,0,0
Maiju Kujala,0,0,0,0,0,0,0,0
Ericka Almeida,0,0,0,0,0,0,0,0
Steve Vigneault,0,0,0,0,0,0,0,0
Cory Hendricks,0,0,0,0,0,0,0,0
Bill Duvall,0,0,0,0,0,0,0,0
Taiga Iwasaki,0,0,0,0,0,0,0,0
Larry Parker,0,0,0,0,0,0,0,0
Fiona Muxlow,0,0,0,0,0,0,0,0
Shunichi Shimizu,0,0,0,0,0,0,0,0
Rene Kronvold,0,0,0,0,0,0,0,0
Garrett Gross,0,0,0,0,0,0,0,0
Tatsuya Saika,0,0,0,0,0,0,0,0
Bryson Kamaka,0,0,0,0,0,0,0,0
Braxton Smith,0,0,0,0,0,0,0,0
Ryan MacDonald,0,0,0,0,0,0,0,0
Kaik Brito,0,0,0,0,0,0,0,0
Robert Breslin,0,0,0,0,0,0,0,0
Angel De Anda,0,0,0,0,0,0,0,0
Tom Egan,0,0,0,0,0,0,0,0
Hugo Duarte,0,0,0,0,0,0,0,0
John Dowdy,0,0,0,0,0,0,0,0
Marc Stevens,0,0,0,0,0,0,0,0
Cesar Gracie,0,0,0,0,0,0,0,0
Milton Vieira,0,0,0,0,0,0,0,0
Andy Anderson,0,0,0,0,0,0,0,0
Sammy Morgan,0,0,0,0,0,0,0,0
Karla Benitez,0,0,0,0,0,0,0,0
Nikolajus Cilkinas,0,0,0,0,0,0,0,0
John Dixson,0,0,0,0,0,0,0,0
Jinnosuke Kashimura,0,0,0,0,0,0,0,0
Josh Bennett,0,0,0,0,0,0,0,0
Pawan Maan,0,0,0,0,0,0,0,0
Andrei Kopylov,0,0,0,0,0,0,0,0
Fabio Nascimento,0,0,0,0,0,0,0,0
Tatsuya Ando,0,0,0,0,0,0,0,0
Antonio Trocoli,0,0,0,0,0,0,0,0
Kelly Velasco,0,0,0,0,0,0,0,0
Donnie Chappell,0,0,0,0,0,0,0,0
Mike Altman,0,0,0,0,0,0,0,0
Keigo Kunihara,0,0,0,0,0,0,0,0
Joe Duarte,0,0,0,0,0,0,0,0
Chris Tickle,0,0,0,0,0,0,0,0
Alexandre Franca Nogueira,0,0,0,0,0,0,0,0
Dylan Lockard,0,0,0,0,0,0,0,0
Martin Svensson,0,0,0,0,0,0,0,0
Shayna Baszler,0,0,0,0,0,0,0,0
Anthony Leone,0,0,0,0,0,0,0,0
Ashiek Ajim,0,0,0,0,0,0,0,0
Mitchell Sipe,0,0,0,0,0,0,0,0
Tomomi Iwama,0,0,0,0,0,0,0,0
Acacio Dos Santos,0,0,0,0,0,0,0,0
Josh Thornburg,0,0,0,0,0,0,0,0
Jarrod Kwitty,0,0,0,0,0,0,0,0
Edson Gomez,0,0,0,0,0,0,0,0
Saeed Hosseini,0,0,0,0,0,0,0,0
Harry Hunsucker,0,0,0,0,0,0,0,0
John Teixeira,0,0,0,0,0,0,0,0
Jesse Murray,0,0,0,0,0,0,0,0
Jesse Moreng,0,0,0,0,0,0,0,0
Kevin Szaflarski,0,0,0,0,0,0,0,0
Matt Skelton,0,0,0,0,0,0,0,0
Trent Jenkins,0,0,0,0,0,0,0,0
Raul Castillo,0,0,0,0,0,0,0,0
Francois Botha,0,0,0,0,0,0,0,0
Sione Latu,0,0,0,0,0,0,0,0
Phil Caracappa,0,0,0,0,0,0,0,0
Jeff Cox,0,0,0,0,0,0,0,0
Joe Jordan,0,0,0,0,0,0,0,0
Bruno Carvalho,0,0,0,0,0,0,0,0
Richard Dalton,0,0,0,0,0,0,0,0
YeDam Seo,0,0,0,0,0,0,0,0
Pat Schilling,0,0,0,0,0,0,0,0
Allen Berube,0,0,0,0,0,0,0,0
Ashe Bowman,0,0,0,0,0,0,0,0
Erick Wanderlei,0,0,0,0,0,0,0,0
Sandra Lavado,0,0,0,0,0,0,0,0
Felipe Bunes,0,0,0,0,0,0,0,0
Donovan Beard,0,0,0,0,0,0,0,0
Yoshinori Horie,0,0,0,0,0,0,0,0
Alfred Khashakyan,0,0,0,0,0,0,0,0
Danilo Suzart,0,0,0,0,0,0,0,0
Jeff Terry,0,0,0,0,0,0,0,0
Joe Martin,0,0,0,0,0,0,0,0
Fabio Mello,0,0,0,0,0,0,0,0
Jaimelene Nievera,0,0,0,0,0,0,0,0
Marcin Wrzosek,0,0,0,0,0,0,0,0
Koichiro Matsumoto,0,0,0,0,0,0,0,0
Austin Tweedy,0,0,0,0,0,0,0,0
Cory Walmsley,0,0,0,0,0,0,0,0
Rodrigo Ruas,0,0,0,0,0,0,0,0
Aaron Wetherspoon,0,0,0,0,0,0,0,0
Emiliano Linares,0,0,0,0,0,0,0,0
Jamelle Jones,0,0,0,0,0,0,0,0
Manolo Zecchini,0,0,0,0,0,0,0,0
Neil Grove,0,0,0,0,0,0,0,0
Jair Farias,0,0,0,0,0,0,0,0
Gregory Bouchelaghem,0,0,0,0,0,0,0,0
Frank Caracci,0,0,0,0,0,0,0,0
Gauge Young,0,0,0,0,0,0,0,0
Tom Tuggle,0,0,0,0,0,0,0,0
Peter Petties,0,0,0,0,0,0,0,0
Kenji Arai,0,0,0,0,0,0,0,0
Brian Cobb,0,0,0,0,0,0,0,0
Jorge Patino,0,0,0,0,0,0,0,0
Ron van Clief,0,0,0,0,0,0,0,0
Magno Almeida,0,0,0,0,0,0,0,0
Sean O'Haire,0,0,0,0,0,0,0,0
Nick Serra,0,0,0,0,0,0,0,0
Rick Davis,0,0,0,0,0,0,0,0
Antony Rea,0,0,0,0,0,0,0,0
Todd Brown,0,0,0,0,0,0,0,0
Thomas Ramirez,0,0,0,0,0,0,0,0
Joe Benoit,0,0,0,0,0,0,0,0
Maka Watson,0,0,0,0,0,0,0,0
Melinda Fabian,0,0,0,0,0,0,0,0
Chad Johnson,0,0,0,0,0,0,0,0
Darrill Schoonover,0,0,0,0,0,0,0,0
Jin Oh Kim,0,0,0,0,0,0,0,0
Elias Urbina,0,0,0,0,0,0,0,0
Johnny Sampaio,0,0,0,0,0,0,0,0
Sim Kai Xiong,0,0,0,0,0,0,0,0
Kevin Knabjian,0,0,0,0,0,0,0,0
Aaron Wilkinson,0,0,0,0,0,0,0,0
Sherman Pendergarst,0,0,0,0,0,0,0,0
Gerald Strebendt,0,0,0,0,0,0,0,0
Ty Flores,0,0,0,0,0,0,0,0
Danny Abbadi,0,0,0,0,0,0,0,0
Willie Peeters,0,0,0,0,0,0,0,0
Rico Farrington,0,0,0,0,0,0,0,0
Marcus Jones,0,0,0,0,0,0,0,0
Lucas Stark,0,0,0,0,0,0,0,0
Estefani Almeida,0,0,0,0,0,0,0,0
Young Sam Jung,0,0,0,0,0,0,0,0
Kerry Schall,0,0,0,0,0,0,0,0
Robert Lucarelli,0,0,0,0,0,0,0,0
Mohammad Yahya,0,0,0,0,0,0,0,0
Shannon Ritch,0,0,0,0,0,0,0,0
Filip Pejic,0,0,0,0,0,0,0,0
Gilbert Rael,0,0,0,0,0,0,0,0
Rolando Perez,0,0,0,0,0,0,0,0
Zach Light,0,0,0,0,0,0,0,0
Quang Le,0,0,0,0,0,0,0,0
Chris Mierzwiak,0,0,0,0,0,0,0,0
Humberto Brown Morrison,0,0,0,0,0,0,0,0
Melchor Manibusan,0,0,0,0,0,0,0,0
Salim Touahri,0,0,0,0,0,0,0,0
Devin Smyth,0,0,0,0,0,0,0,0
Alex Gorgees,0,0,0,0,0,0,0,0
Gugun Gusman,0,0,0,0,0,0,0,0
Sam Liera,0,0,0,0,0,0,0,0
Helio Dipp,0,0,0,0,0,0,0,0
Balajin,0,0,0,0,0,0,0,0
Khadzhi Bestaev,0,0,0,0,0,0,0,0
Justin Wren,0,0,0,0,0,0,0,0
Luis Gomez,0,0,0,0,0,0,0,0
Liang Na,0,0,0,0,0,0,0,0
Jhonata Silva,0,0,0,0,0,0,0,0
Yusaku Nakamura,0,0,0,0,0,0,0,0
Oron Kahlon,0,0,0,0,0,0,0,0
Min Soo Kim,0,0,0,0,0,0,0,0
Carlos Mota,0,0,0,0,0,0,0,0
Vernon Ramos Ho,0,0,0,0,0,0,0,0
Khusein Askhabov,0,0,0,0,0,0,0,0
Motonobu Tezuka,0,0,0,0,0,0,0,0
Jonathan Piersma,0,0,0,0,0,0,0,0
Bubba Bush,0,0,0,0,0,0,0,0
Brian Camozzi,0,0,0,0,0,0,0,0
Mike Aina,0,0,0,0,0,0,0,0
Edivan Santos,0,0,0,0,0,0,0,0
Colleen Schneider,0,0,0,0,0,0,0,0
Andre Mussi,0,0,0,0,0,0,0,0
Craig White,0,0,0,0,0,0,0,0
Bryan Travers,0,0,0,0,0,0,0,0
Don Carlo-Clauss,0,0,0,0,0,0,0,0
Alberto Uda,0,0,0,0,0,0,0,0
Harvey Park,0,0,0,0,0,0,0,0
Andy Wang,0,0,0,0,0,0,0,0
Richie Hightower,0,0,0,0,0,0,0,0
Eun Soo Lee,0,0,0,0,0,0,0,0
Derek Downey,0,0,0,0,0,0,0,0
Jose Alday,0,0,0,0,0,0,0,0
Ben Wall,0,0,0,0,0,0,0,0
Egidijus Valavicius,0,0,0,0,0,0,0,0
Jianping Yang,0,0,0,0,0,0,0,0
Claudio Mattos,0,0,0,0,0,0,0,0
Diego Henrique da Silva,0,0,0,0,0,0,0,0
Brock Jardine,0,0,0,0,0,0,0,0
Jose Barreto,0,0,0,0,0,0,0,0
Brogan Walker,0,0,0,0,0,0,0,0
Mark Striegl,0,0,0,0,0,0,0,0
Tony Bonello,0,0,0,0,0,0,0,0
Josh Diekmann,0,0,0,0,0,0,0,0
Chris Price,0,0,0,0,0,0,0,0
Charlie Ontiveros,0,0,0,0,0,0,0,0
Jacob Rosales,0,0,0,0,0,0,0,0
Travis Wiuff,0,0,0,0,0,0,0,0
Kaloyan Kolev,0,0,0,0,0,0,0,0
Ronaldo Candido,0,0,0,0,0,0,0,0
Kristian Rothaermel,0,0,0,0,0,0,0,0
CM Punk,0,0,0,0,0,0,0,0
Stephanie Webber,0,0,0,0,0,0,0,0
Larissa Pacheco,0,0,0,0,0,0,0,0
Geronimo dos Santos,0,0,0,0,0,0,0,0
Raymond Daniels,0,0,0,0,0,0,0,0
Vitor Vianna,0,0,0,0,0,0,0,0
Don Shainis,0,0,0,0,0,0,0,0
Jeremia Siregar,0,0,0,0,0,0,0,0
Nick Sanzo,0,0,0,0,0,0,0,0
Sean Gannon,0,0,0,0,0,0,0,0
Tatsuya Iwasaki,0,0,0,0,0,0,0,0
Chris Saunders,0,0,0,0,0,0,0,0
Tebaris Gordon,0,0,0,0,0,0,0,0
Alexandre Ferreira,0,0,0,0,0,0,0,0
Dimitiri Wanderley,0,0,0,0,0,0,0,0
Carl Seumanutafa,0,0,0,0,0,0,0,0
Ricardo Barros,0,0,0,0,0,0,0,0
Donny Walker,0,0,0,0,0,0,0,0
Horacio Gutierrez,0,0,0,0,0,0,0,0
Katsuya Inoue,0,0,0,0,0,0,0,0
Charlene Gellner,0,0,0,0,0,0,0,0
Cole Williams,0,0,0,0,0,0,0,0
Adriano Santos,0,0,0,0,0,0,0,0
Roque Martinez,0,0,0,0,0,0,0,0
Israel Albuquerque,0,0,0,0,0,0,0,0
Courtney Buck,0,0,0,0,0,0,0,0
Josh Bryant,0,0,0,0,0,0,0,0
Derrick Mehmen,0,0,0,0,0,0,0,0
Keiichiro Yamamiya,0,0,0,0,0,0,0,0
Albert Cheng,0,0,0,0,0,0,0,0
Yusuke Kasuya,0,0,0,0,0,0,0,0
Sergey Ignatov,0,0,0,0,0,0,0,0
Ibragim Magomedov,0,0,0,0,0,0,0,0
George Allen,0,0,0,0,0,0,0,0
Eric Wray,0,0,0,0,0,0,0,0
Alexandru Lungu,0,0,0,0,0,0,0,0
Klaudia Sygula,0,0,0,0,0,0,0,0
Marcelo Brito,0,0,0,0,0,0,0,0
Leonardo Damiani,0,0,0,0,0,0,0,0
Miguel Linares,0,0,0,0,0,0,0,0
Zane Frazier,0,0,0,0,0,0,0,0
Hiroko Yamanaka,0,0,0,0,0,0,0,0
Kyle Jensen,0,0,0,0,0,0,0,0
Josh Shockman,0,0,0,0,0,0,0,0
Ryan Madigan,0,0,0,0,0,0,0,0
Jon Murphy,0,0,0,0,0,0,0,0
Lorenzo Hood,0,0,0,0,0,0,0,0
Chelsea Hackett,0,0,0,0,0,0,0,0
Roger Hollett,0,0,0,0,0,0,0,0
Canaan Kawaihae,0,0,0,0,0,0,0,0
Mayana Kellem,0,0,0,0,0,0,0,0
Thomas Gifford,0,0,0,0,0,0,0,0
Jeremy Lang,0,0,0,0,0,0,0,0
Michael Lerma,0,0,0,0,0,0,0,0
Danilo Belluardo,0,0,0,0,0,0,0,0
Fabio Gurgel,0,0,0,0,0,0,0,0
Ray Seraille,0,0,0,0,0,0,0,0
Joe Vedepo,0,0,0,0,0,0,0,0
Gabe Ruediger,0,0,0,0,0,0,0,0
Bret Bergmark,0,0,0,0,0,0,0,0
Rodrigo de Lima,0,0,0,0,0,0,0,0
Benardo Sopaj,0,0,0,0,0,0,0,0
Ricardo Prasel,0,0,0,0,0,0,0,0
Rudy Bears,0,0,0,0,0,0,0,0
Josh Smith,0,0,0,0,0,0,0,0
Steve Mensing,0,0,0,0,0,0,0,0
Kali Robbins,0,0,0,0,0,0,0,0
Kim In Seok,0,0,0,0,0,0,0,0
Mikey Gonzalez,0,0,0,0,0,0,0,0
Art Jimmerson,0,0,0,0,0,0,0,0
Billy Pasulatan,0,0,0,0,0,0,0,0
Richard Jacobi,0,0,0,0,0,0,0,0
Harris Sarmiento,0,0,0,0,0,0,0,0
Nariman Abbasov,0,0,0,0,0,0,0,0
Matt Foki,0,0,0,0,0,0,0,0
Gary Frazier,0,0,0,0,0,0,0,0
Deshaun Johnson,0,0,0,0,0,0,0,0
Alex Reyes,0,0,0,0,0,0,0,0
Scott McAfee,0,0,0,0,0,0,0,0
Lolohea Mahe,0,0,0,0,0,0,0,0
Shawn Teed,0,0,0,0,0,0,0,0
Garett Whiteley,0,0,0,0,0,0,0,0
Greg Nagy,0,0,0,0,0,0,0,0
Luis Ramos,0,0,0,0,0,0,0,0
Tateki Matsuda,0,0,0,0,0,0,0,0
Andre Amado,0,0,0,0,0,0,0,0
Eldari Kurtanidze,0,0,0,0,0,0,0,0
David Levicki,0,0,0,0,0,0,0,0
Kiril Sidelnikov,0,0,0,0,0,0,0,0
Minoru Toyonaga,0,0,0,0,0,0,0,0
Korey Kuppe,0,0,0,0,0,0,0,0
Konstantin Erokhin,0,0,0,0,0,0,0,0
Ryuta Sakurai,0,0,0,0,0,0,0,0
Kelly Kobold,0,0,0,0,0,0,0,0
Jeremiah Constant,0,0,0,0,0,0,0,0
Art Santore,0,0,0,0,0,0,0,0
Zachary Borrego,0,0,0,0,0,0,0,0
Theo Rlayang,0,0,0,0,0,0,0,0
Li Yunfeng,0,0,0,0,0,0,0,0
Desmond Torres,0,0,0,0,0,0,0,0
Marcos Mariano,0,0,0,0,0,0,0,0
Dion Staring,0,0,0,0,0,0,0,0
Rin Nakai,0,0,0,0,0,0,0,0
Rodrigo Gripp de Sousa,0,0,0,0,0,0,0,0
Zachary Scroggin,0,0,0,0,0,0,0,0
Katsuaki Furuki,0,0,0,0,0,0,0,0
Julio Paulino,0,0,0,0,0,0,0,0
Tommy Lee,0,0,0,0,0,0,0,0
Kathryn Paprocki,0,0,0,0,0,0,0,0
Roland Payne,0,0,0,0,0,0,0,0
James Zikic,0,0,0,0,0,0,0,0
Jason Novelli,0,0,0,0,0,0,0,0
Justin Frazier,0,0,0,0,0,0,0,0
Reyes Cortez Jr.,0,0,0,0,0,0,0,0
Joe Son,0,0,0,0,0,0,0,0
Mikheil Sazhiniani,0,0,0,0,0,0,0,0
Aliev Makhmud,0,0,0,0,0,0,0,0
Jason Ireland,0,0,0,0,0,0,0,0
James Mulheron,0,0,0,0,0,0,0,0
Lucas Fernando,0,0,0,0,0,0,0,0
Jason Thacker,0,0,0,0,0,0,0,0
Eugenio Tadeu,0,0,0,0,0,0,0,0
Edilberto de Oliveira,0,0,0,0,0,0,0,0
Chase Waldon,0,0,0,0,0,0,0,0
Ben Sosoli,0,0,0,0,0,0,0,0
Randall Wallace,0,0,0,0,0,0,0,0
Taylor Moore,0,0,0,0,0,0,0,0
John Kolosci,0,0,0,0,0,0,0,0
Jimmy Lawson,0,0,0,0,0,0,0,0
Alonzo Martinez,0,0,0,0,0,0,0,0
Dylan Potter,0,0,0,0,0,0,0,0
David Baron,0,0,0,0,0,0,0,0
Val Woodburn,0,0,0,0,0,0,0,0
Max Rohskopf,0,0,0,0,0,0,0,0
Hidetaka Monma,0,0,0,0,0,0,0,0
Mark Scanlon,0,0,0,0,0,0,0,0
Jose Daniel Medina,0,0,0,0,0,0,0,0
Yibugele,0,0,0,0,0,0,0,0
Justin Hawes,0,0,0,0,0,0,0,0
Bendy Casimir,0,0,0,0,0,0,0,0
Michael McBride,0,0,0,0,0,0,0,0
Rick Roufus,0,0,0,0,0,0,0,0
Yuya Shirai,0,0,0,0,0,0,0,0
Ray Steinbeiss,0,0,0,0,0,0,0,0
Janaina Silva,0,0,0,0,0,0,0,0
Mario Neto,0,0,0,0,0,0,0,0
Ding Meng,0,0,0,0,0,0,0,0
Colin Robinson,0,0,0,0,0,0,0,0
Thomas Denny,0,0,0,0,0,0,0,0
Azamat Gashimov,0,0,0,0,0,0,0,0
Rony Sefo,0,0,0,0,0,0,0,0
Sanford Alton Meeks,0,0,0,0,0,0,0,0
Alton Cunningham,0,0,0,0,0,0,0,0
Nate Smith,0,0,0,0,0,0,0,0
Jinensibieke Asikeerbai,0,0,0,0,0,0,0,0
Takahiro Oba,0,0,0,0,0,0,0,0
Greg Velasco,0,0,0,0,0,0,0,0
Billy Vaughan,0,0,0,0,0,0,0,0
Brian Gassaway,0,0,0,0,0,0,0,0
Jong Won Kim,0,0,0,0,0,0,0,0
Alexander Poppeck,0,0,0,0,0,0,0,0
Yoshiaki Yatsu,0,0,0,0,0,0,0,0
Chris Avila,0,0,0,0,0,0,0,0
Brandon Foxworth,0,0,0,0,0,0,0,0
Sako Chivitchian,0,0,0,0,0,0,0,0
Victor Valenzuela,0,0,0,0,0,0,0,0
Jack May,0,0,0,0,0,0,0,0
Christian Colombo,0,0,0,0,0,0,0,0
Justin Robbins,0,0,0,0,0,0,0,0
Yuki Ishikawa,0,0,0,0,0,0,0,0
Justin James,0,0,0,0,0,0,0,0
John Halverson,0,0,0,0,0,0,0,0
Koji Oishi,0,0,0,0,0,0,0,0
David Velasquez,0,0,0,0,0,0,0,0
Travis Galbraith,0,0,0,0,0,0,0,0
Sean Lally,0,0,0,0,0,0,0,0
Matt Horwich,0,0,0,0,0,0,0,0
Noah Thomas,0,0,0,0,0,0,0,0
Clint Coronel,0,0,0,0,0,0,0,0
Enrique Marin,0,0,0,0,0,0,0,0
Kotetsu Boku,0,0,0,0,0,0,0,0
John Devine,0,0,0,0,0,0,0,0
Billy Miles,0,0,0,0,0,0,0,0
Brandon Shuey,0,0,0,0,0,0,0,0
Virgil Zwicker,0,0,0,0,0,0,0,0
Lloyd Van Dams,0,0,0,0,0,0,0,0
Vinicius Queiroz,0,0,0,0,0,0,0,0
Nick Aguirre,0,0,0,0,0,0,0,0
Gustavo Gabriel,0,0,0,0,0,0,0,0
Tim Gorman,0,0,0,0,0,0,0,0
Gian Siqueira,0,0,0,0,0,0,0,0
Olaf Alfonso,0,0,0,0,0,0,0,0
Luke Flores,0,0,0,0,0,0,0,0
Shaheen Santana,0,0,0,0,0,0,0,0
Mariusz Ksiazkiewicz,0,0,0,0,0,0,0,0
Valesca Machado,0,0,0,0,0,0,0,0
Jason Riley,0,0,0,0,0,0,0,0
Eddie Ruiz,0,0,0,0,0,0,0,0
John Campetella,0,0,0,0,0,0,0,0
Wes Sims,0,0,0,0,0,0,0,0
Jason Guida,0,0,0,0,0,0,0,0
Dakota Bush,0,0,0,0,0,0,0,0
Ryo Kawamura,0,0,0,0,0,0,0,0
Chris Haseman,0,0,0,0,0,0,0,0
Ross Ebanez,0,0,0,0,0,0,0,0
Charlie Ward,0,0,0,0,0,0,0,0
Chan-Mi Jeon,0,0,0,0,0,0,0,0
Rana Rudra Pratap Singh,0,0,0,0,0,0,0,0
Rickson Zenidim,0,0,0,0,0,0,0,0
James Toney,0,0,0,0,0,0,0,0
Dino Pezao,0,0,0,0,0,0,0,0
Richardson Moreira,0,0,0,0,0,0,0,0
Imani Lee,0,0,0,0,0,0,0,0
Edwin DeWees,0,0,0,0,0,0,0,0
Ryan Thomas,0,0,0,0,0,0,0,0
Victor Rodriguez,0,0,0,0,0,0,0,0
Edson Silva,0,0,0,0,0,0,0,0
Moise Rimbon,0,0,0,0,0,0,0,0
Wulijiburen,0,0,0,0,0,0,0,0
Trenell Young,0,0,0,0,0,0,0,0
Josh Haynes,0,0,0,0,0,0,0,0
Cheyden Leialoha,0,0,0,0,0,0,0,0
Mostapha Al-Turk,0,0,0,0,0,0,0,0
Alex Soto,0,0,0,0,0,0,0,0
Cameron Else,0,0,0,0,0,0,0,0
Gleidson Cutis,0,0,0,0,0,0,0,0
Josh Clopton,0,0,0,0,0,0,0,0
Paul Bradley,0,0,0,0,0,0,0,0
Raimond Magomedaliev,0,0,0,0,0,0,0,0
Josh Shockley,0,0,0,0,0,0,0,0
Ashkan Mokhtarian,0,0,0,0,0,0,0,0
Jose Canseco,0,0,0,0,0,0,0,0
Muhsin Corbbrey,0,0,0,0,0,0,0,0
Yoshihiro Takayama,0,0,0,0,0,0,0,0
Issa Isakov,0,0,0,0,0,0,0,0
Bruno Assis,0,0,0,0,0,0,0,0
Ray Routh,0,0,0,0,0,0,0,0
Shannon Ross,0,0,0,0,0,0,0,0
Justin Sumter,0,0,0,0,0,0,0,0
Motoki Miyazawa,0,0,0,0,0,0,0,0
Ryan McGillivray,0,0,0,0,0,0,0,0
Chris Birchler,0,0,0,0,0,0,0,0
Herman Renting,0,0,0,0,0,0,0,0
Soichi Nishida,0,0,0,0,0,0,0,0
Eiji Ishikawa,0,0,0,0,0,0,0,0
Lewis Gonzalez,0,0,0,0,0,0,0,0
Caio Bittencourt,0,0,0,0,0,0,0,0
Shimon Smotritsky,0,0,0,0,0,0,0,0
Hans Nijman,0,0,0,0,0,0,0,0
Joshua Wang-Kim,0,0,0,0,0,0,0,0
Yasuhiro Urushitani,0,0,0,0,0,0,0,0
John Doyle,0,0,0,0,0,0,0,0
Lance Lawrence,0,0,0,0,0,0,0,0
Jae Suk Lim,0,0,0,0,0,0,0,0
Chris Heatherly,0,0,0,0,0,0,0,0
James Gray,0,0,0,0,0,0,0,0
Ian Murphy,0,0,0,0,0,0,0,0
Fred Ettish,0,0,0,0,0,0,0,0
Jack Cartwright,0,0,0,0,0,0,0,0
Gabriel Silva,0,0,0,0,0,0,0,0
Kengo Watanabe,0,0,0,0,0,0,0,0
Yuhi Sano,0,0,0,0,0,0,0,0
Steve Lopez,0,0,0,0,0,0,0,0
Dominic Waters,0,0,0,0,0,0,0,0
Daisuke Sugie,0,0,0,0,0,0,0,0
Micheal Gillmore,0,0,0,0,0,0,0,0
Daniel Lacerda,0,0,0,0,0,0,0,0
Kyle Prepolec,0,0,0,0,0,0,0,0
Bo Cantrell,0,0,0,0,0,0,0,0
Elias Garcia,0,0,0,0,0,0,0,0
CJ Hamilton,0,0,0,0,0,0,0,0
Stefan Sekulic,0,0,0,0,0,0,0,0
JC Cottrell,0,0,0,0,0,0,0,0
Pat Audinwood,0,0,0,0,0,0,0,0
Jimmy Quinlan,0,0,0,0,0,0,0,0
Hilarie Rose,0,0,0,0,0,0,0,0
Bobby Hoffman,0,0,0,0,0,0,0,0
Jhonoven Pati,0,0,0,0,0,0,0,0
Roberto Romero,0,0,0,0,0,0,0,0
Sung Bin Jo,0,0,0,0,0,0,0,0
Dmitrii Smoliakov,0,0,0,0,0,0,0,0
Hiromitsu Kanehara,0,0,0,0,0,0,0,0
Rubin Williams,0,0,0,0,0,0,0,0
Carter Williams,0,0,0,0,0,0,0,0
Paul Redmond,0,0,0,0,0,0,0,0
Jin Soo Son,0,0,0,0,0,0,0,0
AJ Cunningham,0,0,0,0,0,0,0,0
Raquel Pa'aluhi,0,0,0,0,0,0,0,0
Tom Gallicchio,0,0,0,0,0,0,0,0
Ricky Rainey,0,0,0,0,0,0,0,0
Bharat Kandare,0,0,0,0,0,0,0,0
Matt Andersen,0,0,0,0,0,0,0,0
Brendon Marotte,0,0,0,0,0,0,0,0
Tyler Stinson,0,0,0,0,0,0,0,0
Tony Petarra,0,0,0,0,0,0,0,0
John Lober,0,0,0,0,0,0,0,0
Matt Lee,0,0,0,0,0,0,0,0
Scott Baker,0,0,0,0,0,0,0,0
Nobuhiro Obiya,0,0,0,0,0,0,0,0
Dustin Neace,0,0,0,0,0,0,0,0
Abner Lloveras,0,0,0,0,0,0,0,0
Matthieu Duclos,0,0,0,0,0,0,0,0
Adam Lynn,0,0,0,0,0,0,0,0
Brian Warren,0,0,0,0,0,0,0,0
Clint Godfrey,0,0,0,0,0,0,0,0
Richie Santiago,0,0,0,0,0,0,0,0
Nick Penner,0,0,0,0,0,0,0,0
Chase Gibson,0,0,0,0,0,0,0,0
Dashawn Boatwright,0,0,0,0,0,0,0,0
Chandler Cole,0,0,0,0,0,0,0,0
Delson Heleno,0,0,0,0,0,0,0,0
Doug Evans,0,0,0,0,0,0,0,0
Karl Amoussou,0,0,0,0,0,0,0,0
Scott Carson,0,0,0,0,0,0,0,0
Rilley Dutro,0,0,0,0,0,0,0,0
James Wallace,0,0,0,0,0,0,0,0
Josh Appelt,0,0,0,0,0,0,0,0
Josh Ferguson,0,0,0,0,0,0,0,0
Del Hawkins,0,0,0,0,0,0,0,0
Rodney Wallace,0,0,0,0,0,0,0,0
Dylan Salvador,0,0,0,0,0,0,0,0
Yoji Anjo,0,0,0,0,0,0,0,0
Julian Sanchez,0,0,0,0,0,0,0,0
Jordan Radev,0,0,0,0,0,0,0,0
Jocelyn Jones-Lybarger,0,0,0,0,0,0,0,0
Bentley Syler,0,0,0,0,0,0,0,0
James Hammortree,0,0,0,0,0,0,0,0
Jamey Simmons,0,0,0,0,0,0,0,0
Bojan Mihajlovic,0,0,0,0,0,0,0,0
John Salgado,0,0,0,0,0,0,0,0
Mike Bencic,0,0,0,0,0,0,0,0
Zoila Frausto,0,0,0,0,0,0,0,0
John Adajar,0,0,0,0,0,0,0,0
Achilles Estremadura,0,0,0,0,0,0,0,0
Luan Lacerda,0,0,0,0,0,0,0,0
Masuto Kawana,0,0,0,0,0,0,0,0
Joao Zeferino,0,0,0,0,0,0,0,0
Lee Higgins,0,0,0,0,0,0,0,0
Eduardo Torres Caut,0,0,0,0,0,0,0,0
Besam Yousef,0,0,0,0,0,0,0,0
Yan Pellerin,0,0,0,0,0,0,0,0
Nick Agallar,0,0,0,0,0,0,0,0
Edson Drago,0,0,0,0,0,0,0,0
Ido Pariente,0,0,0,0,0,0,0,0
Icho Larenas,0,0,0,0,0,0,0,0
Wagner Silva,0,0,0,0,0,0,0,0
Achmed Labasanov,0,0,0,0,0,0,0,0
Keisuke Fujiwara,0,0,0,0,0,0,0,0
Paul Herrera,0,0,0,0,0,0,0,0
Stephen Regman,0,0,0,0,0,0,0,0
Asbel Cancio,0,0,0,0,0,0,0,0
Alexis Dufresne,0,0,0,0,0,0,0,0
George Hardwick,0,0,0,0,0,0,0,0
Carls John De Tomas,0,0,0,0,0,0,0,0
Mack Brewer,0,0,0,0,0,0,0,0
Eric Smith,0,0,0,0,0,0,0,0
Melton Bowen,0,0,0,0,0,0,0,0
Jay Silva,0,0,0,0,0,0,0,0
Bazigit Atajev,0,0,0,0,0,0,0,0
Homer Moore,0,0,0,0,0,0,0,0
Nate Schroeder,0,0,0,0,0,0,0,0
Toby Misech,0,0,0,0,0,0,0,0
Allan Begosso,0,0,0,0,0,0,0,0
Chuck Grigsby,0,0,0,0,0,0,0,0
TJ O'Brien,0,0,0,0,0,0,0,0
Joe Brammer,0,0,0,0,0,0,0,0
Dan Barrera,0,0,0,0,0,0,0,0
Bobby Sanchez,0,0,0,0,0,0,0,0
Dan Stittgen,0,0,0,0,0,0,0,0
Jansey Silva,0,0,0,0,0,0,0,0
Rico DiSciullo,0,0,0,0,0,0,0,0
Brandon Jenkins,0,0,0,0,0,0,0,0
Rocky Lee,0,0,0,0,0,0,0,0
Mike Stumpf,0,0,0,0,0,0,0,0
Sean Sharaf,0,0,0,0,0,0,0,0
Anthony Adams,0,0,0,0,0,0,0,0
Mats Nilsson,0,0,0,0,0,0,0,0
Jason Gilliam,0,0,0,0,0,0,0,0
Adrian Serrano,0,0,0,0,0,0,0,0
Nik Theotikos,0,0,0,0,0,0,0,0
Michel Batista,0,0,0,0,0,0,0,0
Alen Amedovski,0,0,0,0,0,0,0,0
Matej Penaz,0,0,0,0,0,0,0,0
Zach Zane,0,0,0,0,0,0,0,0
Gerry Harris,0,0,0,0,0,0,0,0
Brandon Lewis,0,0,0,0,0,0,0,0
Jadson Costa,0,0,0,0,0,0,0,0
Jeff Newton,0,0,0,0,0,0,0,0
Bruno Korea,0,0,0,0,0,0,0,0
Damian Grabowski,0,0,0,0,0,0,0,0
Scott Graham,0,0,0,0,0,0,0,0
Ken Kaneko,0,0,0,0,0,0,0,0
Stefan Klever,0,0,0,0,0,0,0,0
Siala Siliga,0,0,0,0,0,0,0,0
Crezio de Souza,0,0,0,0,0,0,0,0
Manuel Rodriguez,0,0,0,0,0,0,0,0
Antonio Mendes,0,0,0,0,0,0,0,0
Karl Reed,0,0,0,0,0,0,0,0
David Avellan,0,0,0,0,0,0,0,0
Ryuichi Murata,0,0,0,0,0,0,0,0
Dinis Paiva Jr.,0,0,0,0,0,0,0,0
Mando Gutierrez,0,0,0,0,0,0,0,0
Ryan Stonitsch,0,0,0,0,0,0,0,0
Gilles Arsene,0,0,0,0,0,0,0,0
Naoyuki Kotani,0,0,0,0,0,0,0,0
Scott Lighty,0,0,0,0,0,0,0,0
Bu-Kyung Jung,0,0,0,0,0,0,0,0
Oli Thompson,0,0,0,0,0,0,0,0
Ray Rodriguez,0,0,0,0,0,0,0,0
Dorian Price,0,0,0,0,0,0,0,0
Jesse Strader,0,0,0,0,0,0,0,0
Noe Hernandez,0,0,0,0,0,0,0,0
Rob Wilkinson,0,0,0,0,0,0,0,0
Tony Halme,0,0,0,0,0,0,0,0
Hitomi Akano,0,0,0,0,0,0,0,0
Rubens Xavier,0,0,0,0,0,0,0,0
Jesse Fujarczyk,0,0,0,0,0,0,0,0
Mike Rhodes,0,0,0,0,0,0,0,0
Sumit Kumar,0,0,0,0,0,0,0,0
Chad Reiner,0,0,0,0,0,0,0,0
Marnic Mann,0,0,0,0,0,0,0,0
Dashon Johnson,0,0,0,0,0,0,0,0
Rama Supandhi,0,0,0,0,0,0,0,0
Marcos Galvao,0,0,0,0,0,0,0,0
Curtis Stout,0,0,0,0,0,0,0,0
Brad Morris,0,0,0,0,0,0,0,0
Jim Mullen,0,0,0,0,0,0,0,0
Michael Patt,0,0,0,0,0,0,0,0
Chris Indich,0,0,0,0,0,0,0,0
Martin Sano,0,0,0,0,0,0,0,0
Hernani Perpetuo,0,0,0,0,0,0,0,0
Byron Bloodworth,0,0,0,0,0,0,0,0
Ryan Healy,0,0,0,0,0,0,0,0
Bill Mahood,0,0,0,0,0,0,0,0
Phil Johns,0,0,0,0,0,0,0,0
Joe Pardo,0,0,0,0,0,0,0,0
Maiara Amanajas dos Santos,0,0,0,0,0,0,0,0
Luiz Dutra,0,0,0,0,0,0,0,0
Alex Schoenauer,0,0,0,0,0,0,0,0
Stephanie Frausto,0,0,0,0,0,0,0,0
Vince Cachero,0,0,0,0,0,0,0,0
Nick Roehrick,0,0,0,0,0,0,0,0
Carl Toomey,0,0,0,0,0,0,0,0
Maia Stevenson,0,0,0,0,0,0,0,0
Nick Gonzalez,0,0,0,0,0,0,0,0
Cameron Church,0,0,0,0,0,0,0,0
Tai Bowden,0,0,0,0,0,0,0,0
KB Bhullar,0,0,0,0,0,0,0,0
Roman Bogatov,0,0,0,0,0,0,0,0
Brady Fink,0,0,0,0,0,0,0,0
Keith Berish,0,0,0,0,0,0,0,0
Takayuki Okada,0,0,0,0,0,0,0,0
Jeremy Jackson,0,0,0,0,0,0,0,0
Luciano Azevedo,0,0,0,0,0,0,0,0
Emrah Sonmez,0,0,0,0,0,0,0,0
Leo Kuntz,0,0,0,0,0,0,0,0
Marcin Bandel,0,0,0,0,0,0,0,0
SeongChan Hong,0,0,0,0,0,0,0,0
Ednaldo Oliveira,0,0,0,0,0,0,0,0
Vince Murdock,0,0,0,0,0,0,0,0
Cale Yarbrough,0,0,0,0,0,0,0,0
Ricky Johnson,0,0,0,0,0,0,0,0
Carlos Vera,0,0,0,0,0,0,0,0
Nick Urso,0,0,0,0,0,0,0,0
Chris Condo,0,0,0,0,0,0,0,0
Brandon Wolff,0,0,0,0,0,0,0,0
Oscar Cota,0,0,0,0,0,0,0,0
Josh Hendricks,0,0,0,0,0,0,0,0
Cain Carrizosa,0,0,0,0,0,0,0,0
Masakatsu Okuda,0,0,0,0,0,0,0,0
Dennis Bryant,0,0,0,0,0,0,0,0
Rafael Cerqueira,0,0,0,0,0,0,0,0
Brad Gumm,0,0,0,0,0,0,0,0
Alexandre Barros,0,0,0,0,0,0,0,0
John Hosman,0,0,0,0,0,0,0,0
Jimmy Ambriz,0,0,0,0,0,0,0,0
Gilbert Aldana,0,0,0,0,0,0,0,0
Carlton Minus,0,0,0,0,0,0,0,0
Daniel Swain,0,0,0,0,0,0,0,0
Leon Aliu,0,0,0,0,0,0,0,0
Nayara Maia,0,0,0,0,0,0,0,0
Brian Houston,0,0,0,0,0,0,0,0
Mike French,0,0,0,0,0,0,0,0
Edward Faaloloto,0,0,0,0,0,0,0,0
Dequan Townsend,0,0,0,0,0,0,0,0
Kenneth Alexander,0,0,0,0,0,0,0,0
Houston Dorr,0,0,0,0,0,0,0,0
Tae Hyun Lee,0,0,0,0,0,0,0,0
Jonavin Webb,0,0,0,0,0,0,0,0
Osamu Tachihikari,0,0,0,0,0,0,0,0
Joe Cason,0,0,0,0,0,0,0,0
Carlos Huachin,0,0,0,0,0,0,0,0
Everett Sims,0,0,0,0,0,0,0,0
Amaury Bitetti,0,0,0,0,0,0,0,0
Justin Burlinson,0,0,0,0,0,0,0,0
Matt Kovacs,0,0,0,0,0,0,0,0
Michiyoshi Ohara,0,0,0,0,0,0,0,0
Angelo Antonio,0,0,0,0,0,0,0,0
Nate James,0,0,0,0,0,0,0,0
Paul Creighton,0,0,0,0,0,0,0,0
Dave Dalgliesh,0,0,0,0,0,0,0,0
Tsuyoshi Tamakairiki,0,0,0,0,0,0,0,0
Gilbert Smith,0,0,0,0,0,0,0,0
Kris Moutinho,0,0,0,0,0,0,0,0
Rostem Akman,0,0,0,0,0,0,0,0
Donavon Frelow,0,0,0,0,0,0,0,0
Dieusel Berto,0,0,0,0,0,0,0,0
Terrence Mitchell,0,0,0,0,0,0,0,0
Yuji Nagata,0,0,0,0,0,0,0,0
Askar Mozharov,0,0,0,0,0,0,0,0
Kolton Englund,0,0,0,0,0,0,0,0
Isis Verbeek,0,0,0,0,0,0,0,0
Dileno Lopes,0,0,0,0,0,0,0,0
Amilcar Alves,0,0,0,0,0,0,0,0
Artur Oumakhanov,0,0,0,0,0,0,0,0
Bruno Souza,0,0,0,0,0,0,0,0
Kevin Gray,0,0,0,0,0,0,0,0
Tyler Hill,0,0,0,0,0,0,0,0
Stephen Bass,0,0,0,0,0,0,0,0
Jodie Esquibel,0,0,0,0,0,0,0,0
Chad Hanekom,0,0,0,0,0,0,0,0
Tony Sylvester,0,0,0,0,0,0,0,0
Alexander Soldatkin,0,0,0,0,0,0,0,0
Christian Lohsen,0,0,0,0,0,0,0,0
Baru Harn,0,0,0,0,0,0,0,0
Diego Saraiva,0,0,0,0,0,0,0,0
Robbie Ring,0,0,0,0,0,0,0,0
Jim Wallhead,0,0,0,0,0,0,0,0
Kengo Ura,0,0,0,0,0,0,0,0
Joey Gilbert,0,0,0,0,0,0,0,0
Marcelo Aguiar,0,0,0,0,0,0,0,0
Igor Borisov,0,0,0,0,0,0,0,0
Brady Huang,0,0,0,0,0,0,0,0
Lowell Anderson,0,0,0,0,0,0,0,0
Juan Mott,0,0,0,0,0,0,0,0
Rob Yundt,0,0,0,0,0,0,0,0
Thaddeus Luster,0,0,0,0,0,0,0,0
Jacob Kilburn,0,0,0,0,0,0,0,0
Wuziazibieke Jiahefu,0,0,0,0,0,0,0,0
Erick Gonzalez,0,0,0,0,0,0,0,0
Cam Teague,0,0,0,0,0,0,0,0
Ho Bae Myeon,0,0,0,0,0,0,0,0
Milco Voorn,0,0,0,0,0,0,0,0
Valeri Ignatov,0,0,0,0,0,0,0,0
Lina Kvokov,0,0,0,0,0,0,0,0
Cody East,0,0,0,0,0,0,0,0
Bekzat Almakhan,0,0,0,0,0,0,0,0
Aaron Brink,0,0,0,0,0,0,0,0
Jesse Butler,0,0,0,0,0,0,0,0
Craig Zellner,0,0,0,0,0,0,0,0
Marcos Brigagao,0,0,0,0,0,0,0,0
Ivan Lopez,0,0,0,0,0,0,0,0
Dan Evensen,0,0,0,0,0,0,0,0
Jose Henrique,0,0,0,0,0,0,0,0
Rex Holman,0,0,0,0,0,0,0,0
Eperaim Ginting,0,0,0,0,0,0,0,0
Ronal Siahaan,0,0,0,0,0,0,0,0
Kaleio Romero,0,0,0,0,0,0,0,0
Jack Morrison,0,0,0,0,0,0,0,0
Rudyard Moncayo,0,0,0,0,0,0,0,0
Karine Gevorgyan,0,0,0,0,0,0,0,0
Manny Vazquez,0,0,0,0,0,0,0,0
Mike Lullo,0,0,0,0,0,0,0,0
Alexandre Dantas,0,0,0,0,0,0,0,0
Joseph Gigliotti,0,0,0,0,0,0,0,0
Kaitlin Young,0,0,0,0,0,0,0,0
Ivan Erslan,0,0,0,0,0,0,0,0
Mikhail Iloukhine,0,0,0,0,0,0,0,0
James Barnes,0,0,0,0,0,0,0,0
Ralph Dillon,0,0,0,0,0,0,0,0
Anton Berzin,0,0,0,0,0,0,0,0
Jeremiah Billington,0,0,0,0,0,0,0,0
Landon Quinones,0,0,0,0,0,0,0,0
John Allan,0,0,0,0,0,0,0,0
Anvar Boynazarov,0,0,0,0,0,0,0,0
John Matua,0,0,0,0,0,0,0,0
Emmanuel Yarborough,0,0,0,0,0,0,0,0
Chris Mickle,0,0,0,0,0,0,0,0
Yokthai Sithoar,0,0,0,0,0,0,0,0
Claudionor Fontinelle,0,0,0,0,0,0,0,0
Victor Madrigal,0,0,0,0,0,0,0,0
Colley  Bradford,0,0,0,0,0,0,0,0
Christian Ocon,0,0,0,0,0,0,0,0
Jason Fairn,0,0,0,0,0,0,0,0
Yuma Horiuchi,0,0,0,0,0,0,0,0
Kazuhisa Watanabe,0,0,0,0,0,0,0,0
Raheam Forest,0,0,0,0,0,0,0,0
Takenori Sato,0,0,0,0,0,0,0,0
Santo Curatolo,0,0,0,0,0,0,0,0
Chase Gormley,0,0,0,0,0,0,0,0
Tom DeBlass,0,0,0,0,0,0,0,0
Joseph Sandoval,0,0,0,0,0,0,0,0
Antonio Jones,0,0,0,0,0,0,0,0
Sam Adkins,0,0,0,0,0,0,0,0
Andre Gusmao,0,0,0,0,0,0,0,0
Max Mustaki,0,0,0,0,0,0,0,0
Akihito Tanaka,0,0,0,0,0,0,0,0
Jon Manley,0,0,0,0,0,0,0,0
Keith Berry,0,0,0,0,0,0,0,0
Ramiro Hernandez,0,0,0,0,0,0,0,0
Shang Zhifa,0,0,0,0,0,0,0,0
Bob Gilstrap,0,0,0,0,0,0,0,0
Cory Peterson,0,0,0,0,0,0,0,0
Armando Villarreal,0,0,0,0,0,0,0,0
Ivan Valenzuela,0,0,0,0,0,0,0,0
Steve Byrnes,0,0,0,0,0,0,0,0
Todd Butler,0,0,0,0,0,0,0,0
Matt Dixon,0,0,0,0,0,0,0,0
Lazar Stojadinovic,0,0,0,0,0,0,0,0
Ray Perales,0,0,0,0,0,0,0,0
Collin Hart,0,0,0,0,0,0,0,0
James Bochnovic,0,0,0,0,0,0,0,0
Joe Veres,0,0,0,0,0,0,0,0
Eddie Mendez,0,0,0,0,0,0,0,0
Mark Cherico,0,0,0,0,0,0,0,0
Alavutdin Gadjiev,0,0,0,0,0,0,0,0
