name,KO/TKO,Submission,Decision - Unanimous,Decision - Majority,Decision - Split,StrikeBonus,5roundBonus,Value
Alistair Overeem,2250,655,345,75,0,617,250,4192
Anderson Silva,2000,320,715,0,0,600,375,4010
Max Holloway,1025,205,740,0,120,1322,400,3812
Donald Cerrone,1175,950,870,0,25,443,300,3763
Mauricio Rua,2275,165,315,0,165,539,225,3684
Georges St-Pierre,825,565,800,0,140,892,375,3597
Gegard Mousasi,1525,680,530,0,0,670,150,3555
Andrei Arlovski,1375,255,870,0,260,483,225,3468
Dan Henderson,1675,190,525,0,425,274,275,3364
Michael Bisping,1275,140,715,0,165,698,350,3343
Jim Miller,650,1245,755,25,140,292,50,3157
Wanderlei Silva,1825,90,445,0,165,469,100,3094
Jon Jones,600,540,720,0,70,742,400,3072
Dustin Poirier,1175,460,530,75,0,437,350,3027
Mirko Filipovic,2050,295,290,0,25,340,25,3025
Lyoto Machida,975,230,770,0,235,505,300,3015
Rafael Dos Anjos,500,475,1105,0,95,485,350,3010
Nick Diaz,1025,540,285,0,95,781,225,2951
Jose Aldo,1200,0,930,0,50,363,400,2943
Fabricio Werdum,675,990,555,25,50,426,175,2896
Nate Diaz,425,1105,390,25,120,605,200,2870
Neil Magny,700,305,875,0,280,606,100,2866
Vitor Belfort,1650,320,420,0,25,204,225,2844
Kazushi Sakuraba,450,1760,340,0,0,230,0,2780
Robbie Lawler,1475,125,495,0,210,175,300,2780
Rich Franklin,1225,450,345,0,25,534,175,2754
Urijah Faber,375,1080,575,0,0,348,375,2753
Quinton Jackson,1275,50,500,0,280,511,100,2716
Charles Oliveira,500,1540,265,0,25,198,175,2703
Frankie Edgar,525,180,925,0,95,586,350,2661
Derrick Lewis,1675,50,185,0,140,301,300,2651
Cub Swanson,775,330,850,0,120,453,100,2628
Joseph Benavidez,650,385,850,0,145,423,125,2578
Antonio Rodrigo Nogueira,375,1220,635,0,25,201,100,2556
Jessica Andrade,700,370,530,0,165,612,150,2527
Demetrious Johnson,200,540,690,0,95,650,350,2525
Ovince Saint Preux,900,550,420,75,190,246,125,2506
Demian Maia,150,990,840,75,95,179,175,2504
Daniel Cormier,825,360,530,0,70,468,250,2503
Diego Sanchez,675,180,1000,0,235,373,25,2488
Gilbert Melendez,700,25,685,0,190,587,300,2487
Clay Guida,250,650,845,0,405,227,75,2452
BJ Penn,700,565,390,50,25,420,300,2450
Fedor Emelianenko,725,835,400,0,0,427,50,2437
Junior Dos Santos,1175,0,425,0,0,534,300,2434
King Green,400,230,765,0,95,880,50,2420
Amanda Nunes,850,295,400,0,70,488,300,2403
Josh Barnett,775,950,155,0,70,348,100,2398
Matt Brown,1375,305,235,0,50,362,50,2377
Shinya Aoki,175,1440,505,0,70,124,50,2364
Randy Couture,750,385,345,75,0,454,350,2359
Jorge Masvidal,625,90,790,0,170,493,175,2343
Glover Teixeira,750,745,260,0,70,267,250,2342
Robert Whittaker,675,25,825,0,95,458,225,2303
Jacare Souza,575,925,370,0,75,182,175,2302
Sean Strickland,450,90,610,0,330,607,200,2287
Edson Barboza,975,50,660,75,120,267,125,2272
Matt Hughes,700,525,400,0,0,343,300,2268
Chuck Liddell,1250,25,480,0,25,287,175,2242
Rogerio Nogueira,900,360,420,0,235,266,25,2206
Tatsuya Kawajiri,450,590,900,0,0,219,25,2184
Kamaru Usman,425,90,800,50,0,555,250,2170
Benson Henderson,125,475,530,0,280,389,350,2149
Thiago Santos,1175,75,315,0,25,376,175,2141
Aljamain Sterling,250,360,585,0,190,630,125,2140
Alexander Volkanovski,550,0,585,0,70,709,225,2139
Michael Johnson,675,125,740,25,120,390,50,2125
Tim Means,650,330,555,0,145,444,0,2124
Joanna Jedrzejczyk,250,0,610,0,95,894,275,2124
Darren Elkins,475,295,950,0,140,259,0,2119
Cain Velasquez,1250,25,160,0,0,486,175,2096
Alex Caceres,125,485,660,0,285,516,25,2096
Tito Ortiz,825,205,340,0,165,324,225,2084
Carlos Condit,525,435,365,0,120,383,250,2078
Stipe Miocic,1000,0,425,0,0,327,325,2077
Jeremy Stephens,775,75,705,0,145,295,75,2070
Takanori Gomi,1000,420,240,0,165,236,0,2061
Mark Coleman,775,575,345,0,25,322,0,2042
Nate Marquardt,825,270,470,0,50,293,100,2008
TJ Dillashaw,775,90,320,0,120,472,225,2002
Mark Hunt,1125,175,130,0,140,282,150,2002
Igor Vovchanchyn,875,230,555,0,0,337,0,1997
Anthony Pettis,475,655,420,0,120,150,175,1995
Kevin Holland,550,525,260,0,165,367,100,1967
Josh Thomson,425,450,500,75,75,311,125,1961
Frank Mir,700,720,235,0,0,104,200,1959
Tyron Woodley,650,295,315,75,235,174,200,1944
Cristiane Justino,925,0,240,0,0,568,200,1933
Francisco Trinaldo,400,230,870,0,140,292,0,1932
Valentina Shevchenko,400,205,425,0,165,407,325,1927
Rashad Evans,775,0,475,75,330,143,125,1923
Alexander Volkov,625,115,370,0,95,527,175,1907
Ikuhisa Minowa,475,1040,235,0,95,61,0,1906
Thiago Alves,750,165,550,0,70,316,50,1901
Stephen Thompson,650,25,580,25,0,420,200,1900
Gary Goodridge,1350,240,50,0,70,183,0,1893
Derek Brunson,875,180,505,0,0,205,125,1890
Israel Adesanya,525,25,610,0,70,332,325,1887
Yves Edwards,650,345,395,25,145,288,25,1873
Ryan Bader,575,140,640,0,70,346,100,1871
Luke Rockhold,600,540,185,0,0,259,275,1859
Marlon Vera,700,360,520,0,25,146,100,1851
Ben Rothwell,975,295,285,0,140,116,25,1836
Tony Ferguson,350,615,340,0,70,361,100,1836
Islam Makhachev,325,720,400,0,0,204,175,1824
Dominick Cruz,150,25,745,0,210,416,275,1821
Rani Yahya,75,990,525,0,95,107,25,1817
Rob Font,600,115,470,0,0,532,100,1817
Gilbert Burns,375,450,685,0,0,195,100,1805
Beneil Dariush,425,475,480,0,140,255,25,1800
Anthony Smith,650,590,205,0,70,108,175,1798
Raphael Assuncao,275,165,690,0,305,323,25,1783
Brad Tavares,325,0,900,0,235,290,25,1775
Josh Koscheck,675,345,475,0,95,146,25,1761
Jake Shields,125,540,450,75,210,209,150,1759
Dan Hooker,775,205,260,0,210,254,50,1754
Ricardo Lamas,625,270,610,0,25,168,50,1748
Chris Leben,875,320,260,0,95,148,50,1748
Angela Hill,100,140,920,0,100,437,50,1747
Johny Hendricks,675,0,555,75,190,146,100,1741
Jan Blachowicz,525,205,420,0,95,310,175,1730
Vicente Luque,750,540,180,0,70,129,50,1719
Heath Herring,525,475,285,0,140,287,0,1712
Belal Muhammad,225,90,930,0,70,320,75,1710
Anthony Johnson,1125,125,160,0,0,193,100,1703
Curtis Blaydes,800,0,400,0,0,298,200,1698
Ed Herman,500,525,340,0,120,207,0,1692
Kelvin Gastelum,300,255,475,0,285,222,150,1687
Sean O'Malley,725,0,265,0,70,543,75,1678
Gleison Tibau,175,410,580,0,400,106,0,1671
Joe Lauzon,625,655,180,25,95,84,0,1664
Jon Fitch,125,270,770,0,140,326,25,1656
Colby Covington,325,205,610,0,0,314,200,1654
Hayato Sakurai,675,165,530,0,25,232,25,1652
Nik Lentz,325,205,685,0,165,271,0,1651
Khabib Nurmagomedov,200,450,480,0,0,410,100,1640
Drew Dober,925,190,340,0,0,181,0,1636
Ciryl Gane,400,205,265,0,70,518,175,1633
Chris Weidman,575,270,425,0,0,161,200,1631
Rick Story,225,205,450,0,285,440,25,1630
Stefan Struve,700,540,155,75,0,102,50,1622
Leon Edwards,300,90,690,75,95,195,175,1620
Yushin Okami,475,25,715,25,140,188,50,1618
Miesha Tate,125,525,580,75,0,158,150,1613
Jack Hermansson,375,295,425,0,25,364,125,1609
Tim Boetsch,800,125,315,0,140,198,25,1603
Raquel Pennington,25,270,610,0,285,322,75,1587
Chad Mendes,700,90,505,0,0,162,125,1582
Dennis Siver,375,230,555,75,0,315,25,1575
Forrest Griffin,325,270,480,0,95,349,50,1569
Alex Morono,250,180,740,0,120,274,0,1564
Court McGee,75,270,760,0,95,355,0,1555
Gabriel Gonzaga,925,360,130,0,0,90,50,1555
Mike Pyle,675,410,265,0,70,134,0,1554
Merab Dvalishvili,100,25,880,0,25,445,75,1550
John Makdessi,350,25,605,0,165,391,0,1536
Eddie Wineland,925,25,310,0,70,153,50,1533
Patrick Cote,750,75,445,0,95,116,50,1531
Randy Brown,350,320,505,0,95,260,0,1530
Evan Dunham,200,140,450,0,235,502,0,1527
Yoshihiro Akiyama,550,655,130,0,95,97,0,1527
Alexander Gustafsson,575,255,265,0,25,230,175,1525
Rose Namajunas,225,295,370,0,190,162,275,1517
John Lineker,600,115,370,0,95,284,50,1514
Renan Barao,275,450,420,0,25,191,150,1511
Marcin Tybura,500,115,555,75,0,165,100,1510
Chris Lytle,200,540,390,0,120,256,0,1506
Jared Cannonier,675,0,365,0,70,217,175,1502
Thales Leites,225,450,525,0,120,129,50,1499
Jake Matthews,125,525,450,0,95,304,0,1499
Danny Castillo,575,50,425,25,215,199,0,1489
Petr Yan,400,0,505,0,50,383,150,1488
Santiago Ponzinibbio,775,0,425,0,75,163,50,1488
Tim Sylvia,500,100,345,0,0,292,250,1487
Kenny Florian,225,745,235,0,0,207,75,1487
Chael Sonnen,75,330,560,0,0,397,125,1487
Gerald Meerschaert,200,1040,25,0,75,135,0,1475
Ross Pearson,500,25,525,0,215,173,25,1463
Deiveson Figueiredo,400,385,370,0,70,61,175,1461
Scott Jorgensen,250,345,605,0,25,183,50,1458
Alexandre Pantoja,200,450,395,0,140,171,100,1456
Alex Oliveira,450,395,315,0,70,194,25,1449
Li Jingliang,825,50,210,0,120,244,0,1449
Conor McGregor,825,50,80,75,0,141,275,1446
Melvin Guillard,725,150,185,0,165,214,0,1439
Kevin Lee,225,460,315,0,70,218,150,1438
Yair Rodriguez,425,115,265,0,140,288,200,1433
Mark Munoz,675,50,320,0,95,189,100,1429
Nikita Krylov,425,550,185,0,25,244,0,1429
Renato Moicano,175,590,185,0,140,230,100,1420
Michael Chiesa,0,845,425,0,0,99,50,1419
Dong Hyun Kim,475,90,505,0,140,184,25,1419
Sergei Kharitonov,850,320,25,0,70,146,0,1411
Thiago Silva,1025,90,130,0,0,165,0,1410
Cory Sandhagen,400,115,210,0,165,341,175,1406
Marcos Rogerio de Lima,625,305,290,0,0,182,0,1402
Cheick Kongo,650,25,265,75,50,331,0,1396
Zhang Weili,225,180,320,0,95,398,175,1393
Gillian Robertson,225,655,340,0,0,165,0,1385
Kazuhiro Nakamura,275,230,690,0,50,137,0,1382
Corey Anderson,400,0,560,0,25,362,25,1372
Brendan Allen,150,720,265,0,70,114,50,1369
Jairzinho Rozenstruik,850,25,50,0,70,222,150,1367
Andre Fili,475,50,420,0,305,115,0,1365
Francis Ngannou,900,90,130,0,0,95,150,1365
Dan Ige,400,180,440,0,140,155,50,1365
Brian Stann,750,140,210,0,0,183,75,1358
Joanne Wood,100,215,370,0,235,433,0,1353
Matt Lindland,500,165,320,75,25,238,25,1348
Bryan Barberena,450,165,340,25,70,291,0,1341
Tecia Pennington,0,90,765,0,50,432,0,1337
Diego Ferreira,575,180,290,0,25,266,0,1336
Brandon Moreno,200,270,315,0,120,230,200,1335
Henry Cejudo,425,0,345,0,190,217,150,1327
Pedro Munhoz,300,270,495,0,75,161,25,1326
Roy Nelson,850,0,280,0,50,41,100,1321
Joe Stevenson,250,525,390,0,0,125,25,1315
Iuri Alcantara,425,205,445,0,70,168,0,1313
Evan Tanner,475,360,160,0,25,215,75,1310
Antonio Silva,800,90,105,0,70,119,125,1309
Grant Dawson,225,450,400,0,0,208,25,1308
Keith Jardine,425,90,395,25,140,207,25,1307
Sam Alvey,600,140,285,0,190,91,0,1306
Dennis Bermudez,150,230,400,0,215,283,25,1303
Rousimar Palhares,75,990,185,0,0,51,0,1301
Chris Cariaso,100,165,555,0,165,290,25,1300
Karolina Kowalkiewicz,25,140,630,0,140,338,25,1298
Tim Kennedy,350,360,290,0,0,198,100,1298
Martin Kampmann,300,450,185,0,165,148,50,1298
Jens Pulver,600,190,265,75,0,63,100,1293
Holly Holm,225,50,475,0,95,221,225,1291
Elizeu Zaleski dos Santos,425,90,345,0,190,235,0,1285
Ronda Rousey,350,630,0,0,0,44,250,1274
Magomed Ankalaev,600,25,400,0,0,189,50,1264
Krzysztof Jotko,150,50,585,0,235,243,0,1263
Tim Elliott,0,305,710,0,0,222,25,1262
Kennedy Nzechukwu,750,115,80,0,120,194,0,1259
Marina Rodriguez,325,0,345,0,145,367,75,1257
Jake Ellenberger,675,115,210,0,95,111,50,1256
Dustin Jacoby,525,25,395,0,25,285,0,1255
Renato Sobral,125,540,265,75,0,174,75,1254
Takeya Mizugaki,175,50,500,0,280,224,25,1254
Mike Swick,650,205,235,75,0,61,25,1251
Tarec Saffiedine,125,0,635,0,120,290,75,1245
Marvin Vettori,0,180,660,0,25,255,125,1245
Ricco Rodriguez,625,90,260,0,25,194,50,1244
Matt Wiman,300,270,500,0,0,170,0,1240
Arnold Allen,200,180,530,0,70,210,50,1240
Alex Pereira,725,0,80,0,70,215,150,1240
Yan Xiaonan,125,0,585,75,25,380,50,1240
CB Dollaway,325,230,425,0,95,138,25,1238
Royce Gracie,150,900,160,0,0,27,0,1237
Sara McMann,125,370,480,25,70,137,25,1232
Rory MacDonald,350,90,425,0,25,267,75,1232
Yoel Romero,725,0,155,0,95,131,125,1231
Murilo Rua,500,180,235,0,50,213,50,1228
Travis Browne,800,115,130,0,0,106,75,1226
Chan Sung Jung,525,180,105,0,25,136,250,1221
Gian Villante,625,25,180,25,260,103,0,1218
Justin Gaethje,675,50,80,75,0,86,250,1216
Maycee Barber,500,0,290,0,140,278,0,1208
Jonathan Martinez,425,0,555,0,25,199,0,1204
Don Frye,675,295,25,0,70,139,0,1204
Sarah Kaufman,100,75,400,75,25,428,100,1203
Tyson Griffin,250,90,450,0,120,292,0,1202
Katlyn Cerminara,50,0,770,0,190,166,25,1201
Chris Gutierrez,300,25,370,0,140,340,25,1200
Eryk Anders,525,25,315,0,145,139,50,1199
Joaquin Buckley,675,0,185,0,70,241,25,1196
Song Yadong,500,90,290,0,70,170,75,1195
Rafael Natal,200,90,475,0,140,264,25,1194
Mackenzie Dern,25,450,315,25,140,135,100,1190
Daniel Rodriguez,225,115,370,0,140,339,0,1189
Cole Miller,150,630,310,0,25,71,0,1186
Jamahal Hill,575,0,160,0,0,350,100,1185
Cody Garbrandt,700,25,265,0,0,68,125,1183
John Dodson,500,0,365,0,120,123,75,1183
Ben Saunders,475,295,210,0,70,132,0,1182
Paul Craig,425,590,50,0,0,91,25,1181
Louis Smolka,450,255,235,0,25,214,0,1179
Al Iaquinta,425,50,395,0,70,160,75,1175
Dominick Reyes,575,90,105,0,70,234,100,1174
Brandon Vera,600,90,290,0,25,117,50,1172
James Krause,325,205,370,0,50,220,0,1170
Arman Tsarukyan,400,0,370,0,70,273,50,1163
Matt Mitrione,850,50,105,0,0,131,25,1161
Jared Gordon,275,25,425,0,95,339,0,1159
Michelle Waterson-Gomez,25,410,260,0,190,145,125,1155
Paulo Filho,100,630,185,0,70,118,50,1153
Anthony Njokuani,525,50,260,0,25,292,0,1152
Phil Davis,0,270,530,0,25,300,25,1150
Tai Tuivasa,775,75,105,0,25,94,75,1149
Chris Camozzi,100,190,420,0,190,248,0,1148
Gray Maynard,225,0,610,0,210,53,50,1148
Sam Stout,175,50,500,0,260,152,0,1137
Phil Baroni,575,140,255,25,0,114,25,1134
Khalil Rountree Jr.,775,25,130,0,70,108,25,1133
David Abbott,600,330,130,0,0,72,0,1132
Bruno Silva,725,140,150,0,0,115,0,1130
Mike Pierce,400,115,370,0,120,124,0,1129
Josh Emmett,425,25,345,0,165,66,100,1126
Aleksei Oleinik,200,630,50,25,70,72,75,1122
Carla Esparza,150,115,345,75,260,76,100,1121
Uriah Hall,675,0,155,0,145,71,75,1121
Lorenz Larkin,425,0,395,0,95,205,0,1120
Sergio Pettis,25,25,715,0,70,259,25,1119
Gunnar Nelson,25,720,210,0,50,62,50,1117
Akira Shoji,325,320,260,0,165,46,0,1116
Germaine de Randamie,425,90,315,0,70,141,75,1116
Johnny Walker,600,90,210,0,0,140,75,1115
Jorge Rivera,600,75,160,0,95,185,0,1115
Kevin Randleman,275,150,450,0,25,139,75,1114
Miguel Torres,150,295,265,0,0,277,125,1112
Thiago Tavares,225,450,370,0,0,66,0,1111
Manvel Gamburyan,200,295,500,0,0,90,25,1110
Jamie Varner,450,215,25,0,165,155,100,1110
KJ Noons,425,25,365,0,95,121,75,1106
Volkan Oezdemir,450,115,155,0,165,169,50,1104
Matt Hamill,550,0,290,75,25,163,0,1103
Nasrat Haqparast,225,0,555,0,70,253,0,1103
James Vick,300,270,345,0,0,162,25,1102
Charles Jourdain,225,295,210,25,50,295,0,1100
Geoff Neal,600,115,130,0,95,125,25,1090
Alan Jouban,450,25,345,0,25,243,0,1088
Zak Cummings,200,410,370,0,25,82,0,1087
Ken Shamrock,450,475,0,0,50,85,25,1085
Devin Clark,175,100,610,0,0,174,25,1084
Ion Cutelaba,475,100,210,0,70,227,0,1082
Pedro Rizzo,750,0,155,0,70,31,75,1081
Kai Kara-France,325,25,345,0,95,239,50,1079
Jeremy Horn,225,485,290,0,0,53,25,1078
Montel Jackson,400,90,370,0,0,216,0,1076
Alonzo Menifield,575,180,210,0,0,106,0,1071
Mitsuhiro Ishida,50,205,560,0,95,136,25,1071
Mike Brown,275,205,345,0,25,120,100,1070
Alex Perez,350,320,185,0,0,138,75,1068
Billy Quarantillo,450,115,210,0,0,293,0,1068
Chase Hooper,225,360,210,0,0,272,0,1067
Paul Felder,400,90,185,0,240,101,50,1066
Joe Riggs,500,190,210,0,0,158,0,1058
Michel Pereira,225,270,265,0,70,200,25,1055
Guy Mezger,475,90,240,0,75,175,0,1055
Max Griffin,325,25,260,75,215,155,0,1055
Serghei Spivac,400,270,105,75,0,128,75,1053
Duane Ludwig,425,100,240,0,70,216,0,1051
Alexis Davis,125,115,500,25,140,121,25,1051
Dustin Ortiz,400,25,180,0,235,211,0,1051
Cung Le,675,0,80,0,0,220,75,1050
Spencer Fisher,275,180,420,0,25,147,0,1047
Elias Theodorou,200,0,475,0,70,301,0,1046
Rafael Cavalcante,875,0,50,0,0,68,50,1043
Jailton Almeida,325,450,80,0,0,138,50,1043
Hiroyuki Takaya,550,0,185,0,145,135,25,1040
Ilir Latifi,375,180,315,0,95,69,0,1034
Anthony Rocco Martin,100,320,450,25,25,114,0,1034
Brian Ortega,325,360,130,0,0,67,150,1032
Marcus Davis,350,385,105,0,95,95,0,1030
Thiago Moises,250,295,395,0,0,63,25,1028
Tom Aspinall,625,180,0,0,0,96,125,1026
Ryan Spann,375,410,80,0,95,41,25,1026
Michel Prazeres,0,295,395,0,210,125,0,1025
Joachim Hansen,325,345,130,0,165,59,0,1024
Irene Aldana,300,90,340,0,120,121,50,1021
Julian Erosa,350,360,105,0,140,63,0,1018
Amanda Ribas,150,205,345,0,25,242,50,1017
Gabriel Benitez,400,205,210,0,25,177,0,1017
Eddie Alvarez,450,115,105,0,140,131,75,1016
Muhammed Lawal,625,0,160,0,0,179,50,1014
Davey Grant,300,165,185,0,120,243,0,1013
Omari Akhmedov,250,115,425,0,95,124,0,1009
Amanda Lemos,325,230,185,0,70,98,100,1008
Raoni Barcelos,225,180,370,25,0,208,0,1008
Julianna Pena,200,230,265,0,70,142,100,1007
Nathaniel Wood,25,270,450,0,0,261,0,1006
Alan Belcher,425,295,75,0,95,112,0,1002
Brian Kelleher,250,395,290,0,0,64,0,999
Alexa Grasso,0,205,450,25,70,174,75,999
Drakkar Klose,250,0,505,0,70,168,0,993
Ricky Simon,150,270,315,0,140,93,25,993
Liz Carmouche,200,50,420,0,95,152,75,992
John Moraga,225,295,210,0,95,141,25,991
Calvin Kattar,425,0,340,0,25,76,125,991
Julio Arce,425,90,185,0,50,240,0,990
JJ Aldrich,125,25,635,0,95,109,0,989
Niko Price,500,205,210,0,0,70,0,985
Aaron Simpson,350,0,345,0,95,192,0,982
Carlos Newton,75,475,210,0,120,27,75,982
Frank Shamrock,325,450,0,0,0,106,100,981
Vladimir Matyushenko,400,25,345,0,70,115,25,980
Mario Bautista,125,295,320,0,70,168,0,978
Ian Machado Garry,300,0,345,0,70,238,25,978
Sean Sherk,50,90,530,0,70,133,100,973
Nassourdine Imavov,300,0,265,100,0,227,75,967
Norma Dumont,25,0,560,0,95,260,25,965
George Roop,400,25,210,0,120,210,0,965
Trevin Giles,375,75,185,0,140,188,0,963
Caio Borralho,200,90,480,0,0,166,25,961
Marc Diakiese,200,75,475,0,95,115,0,960
Erik Koch,350,180,340,0,0,90,0,960
Carlos Ulberg,525,90,160,0,0,183,0,958
Hideo Tokoro,175,230,370,0,95,86,0,956
Dricus Du Plessis,400,180,80,0,70,174,50,954
Myles Jury,325,115,290,0,70,149,0,949
Jalin Turner,450,270,25,0,50,153,0,948
Stephan Bonnar,225,180,420,25,0,97,0,947
Jussier Formiga,100,270,530,0,25,21,0,946
Mark Kerr,275,450,130,0,0,90,0,945
Paul Daley,725,25,50,0,25,67,50,942
Randa Markos,0,140,445,0,190,166,0,941
Shane Burgos,250,90,265,75,70,190,0,940
Roman Dolidze,500,0,210,25,70,108,25,938
Mark Bocek,25,385,315,0,70,138,0,933
Giga Chikadze,300,25,290,0,140,127,50,932
Brad Pickett,150,255,315,0,190,21,0,931
Anthony Hernandez,225,385,80,0,0,216,25,931
Walt Harris,725,25,25,0,25,104,25,929
Warlley Alves,275,295,235,0,25,98,0,928
Michal Oleksiejczuk,600,125,50,0,70,80,0,925
Mike Perry,425,25,285,0,95,95,0,925
Erick Silva,300,450,50,0,25,74,25,924
Cody Stamann,100,75,420,0,140,189,0,924
Lauren Murphy,225,90,260,0,235,84,25,919
TJ Grant,300,90,290,25,70,144,0,919
Cezar Ferreira,75,270,395,0,140,38,0,918
Ilia Topuria,500,90,160,0,0,92,75,917
Dan Miller,25,540,230,0,70,27,25,917
Rustam Khabilov,100,25,585,0,95,83,25,913
Muslim Salikhov,450,25,185,0,140,113,0,913
Nate Quarry,550,25,160,0,0,151,25,911
Movsar Evloev,0,0,640,0,70,199,0,909
JunYong Park,25,295,160,75,165,189,0,909
Edmen Shahbazyan,575,115,25,0,70,121,0,906
Shawn Jordan,650,90,75,0,0,91,0,906
Jack Della Maddalena,400,90,80,0,140,195,0,905
Alexander Hernandez,375,25,290,0,95,120,0,905
Alejandro Perez,325,115,290,0,70,104,0,904
Brandon Royval,125,295,25,0,210,174,75,904
Ricardo Almeida,25,295,425,0,25,134,0,904
Sean Woodson,300,25,240,0,140,198,0,903
Molly McCann,200,165,395,0,0,142,0,902
Karol Rosa,0,0,420,75,140,267,0,902
Cortney Casey,100,205,260,0,170,166,0,901
Karo Parisyan,150,90,450,0,70,140,0,900
Andrea Lee,100,90,340,0,100,269,0,899
Jordan Mein,350,0,290,0,95,164,0,899
Shane Roller,150,525,185,0,0,31,0,891
Joshua Burkman,150,215,315,25,95,90,0,890
Kyler Phillips,200,90,345,25,0,227,0,887
Patrick Cummins,325,25,265,0,70,201,0,886
Ignacio Bahamondes,400,90,105,0,25,265,0,885
Matt Serra,250,90,260,75,95,64,50,884
Kyung Ho Kang,0,360,180,0,235,108,0,883
Fabio Maldonado,225,0,260,0,70,302,25,882
Bibiano Fernandes,100,270,265,0,140,106,0,881
Nordine Taleb,250,50,345,0,70,166,0,881
Manon Fiorot,200,0,400,0,0,256,25,881
Murilo Bustamante,225,270,235,0,50,50,50,880
Khamzat Chimaev,200,360,80,75,0,114,50,879
Steve Garcia,725,0,25,0,0,128,0,878
Luana Carolina,125,25,400,0,95,231,0,876
Yancy Medeiros,275,295,155,0,70,55,25,875
Antonio Banuelos,75,0,450,0,235,115,0,875
Ricardo Arona,275,90,240,0,165,105,0,875
Gregory Rodrigues,550,0,160,0,25,139,0,874
Mark Hominick,225,320,130,0,95,77,25,872
John Hathaway,125,0,425,0,70,226,25,871
Hakeem Dawodu,100,25,235,0,210,301,0,871
Punahele Soriano,425,25,185,0,25,207,0,867
Scott Holtzman,150,90,395,0,25,207,0,867
Dan Severn,25,525,160,0,70,84,0,864
Sodiq Yusuff,225,90,370,0,0,151,25,861
Denis Kang,275,230,240,0,25,89,0,859
Tanner Boser,325,0,210,0,50,272,0,857
Hermes Franca,225,270,210,25,25,51,50,856
Jonathan Pearce,325,140,185,0,0,204,0,854
Amir Sadollah,125,90,340,0,70,228,0,853
Joel Alvarez,425,270,25,0,0,131,0,851
Kiyoshi Tamura,450,140,160,0,0,101,0,851
Erin Blanchfield,0,270,345,0,0,160,75,850
Alexandr Romanov,125,295,160,25,70,174,0,849
Trevor Smith,100,115,395,0,95,142,0,847
Kendall Grove,275,180,155,0,140,94,0,844
Lerone Murphy,200,0,320,0,70,228,25,843
Kurt Pellegrino,100,410,210,0,25,98,0,843
Kyle Noke,300,230,75,0,95,141,0,841
Miranda Maverick,0,180,450,0,25,185,0,840
Danny Roberts,425,115,105,0,140,54,0,839
Ariane da Silva,75,205,315,0,70,174,0,839
Akihiro Gono,50,360,290,0,95,44,0,839
Pat Healy,0,230,500,0,25,79,0,834
Douglas Silva de Andrade,225,115,420,0,0,72,0,832
Kazuyuki Fujita,375,230,185,0,0,41,0,831
Michael McDonald,225,345,80,0,70,58,50,828
Vinc Pichel,125,25,530,0,0,148,0,828
Chase Sherman,375,50,230,0,0,173,0,828
Jimmie Rivera,125,0,475,0,70,132,25,827
Ryan LaFlare,50,0,585,0,0,167,25,827
Alessio Sakara,500,50,105,0,70,100,0,825
Bryce Mitchell,125,115,400,75,0,109,0,824
Darren Till,225,75,265,0,70,39,150,824
Antonio Carlos Junior,25,450,235,0,25,88,0,823
Paulo Costa,425,0,210,0,25,87,75,822
Stevie Ray,250,0,185,150,95,142,0,822
Ricardo Ramos,250,140,265,0,140,27,0,822
Augusto Sakai,400,0,80,0,140,150,50,820
Aleksandar Rakic,250,0,345,0,25,173,25,818
Umar Nurmagomedov,100,180,265,0,0,222,50,817
Greg Hardy,575,0,105,0,0,137,0,817
Ray Borg,0,205,450,0,50,86,25,816
Macy Chiasson,225,205,185,0,70,130,0,815
Kyoji Horiguchi,200,25,400,0,0,165,25,815
Misha Cirkunov,225,475,0,0,25,89,0,814
Adrian Yanez,650,0,0,0,95,69,0,814
Loopy Godinez,0,180,340,0,165,129,0,814
George Sotiropoulos,150,360,210,0,0,68,25,813
Tatiana Suarez,100,360,160,0,0,193,0,813
Chas Skelly,225,360,185,25,0,17,0,812
Mateusz Gamrot,300,90,185,0,120,66,50,811
Paul Buentello,575,90,0,25,0,70,50,810
Sergio Moraes,175,270,210,0,140,15,0,810
Makwan Amirkhani,175,385,130,0,95,25,0,810
Claudia Gadelha,0,90,420,0,165,109,25,809
Don'Tale Mayes,425,50,235,0,0,98,0,808
Sergei Pavlovich,650,0,25,0,0,82,50,807
Jake Collier,200,90,235,0,120,161,0,806
Olivier Aubin-Mercier,100,360,180,0,95,71,0,806
Nicolas Dalby,100,0,395,0,165,145,0,805
Josh Neer,25,345,260,0,25,146,0,801
Abdul Razak Alhassan,650,25,50,0,50,26,0,801
Cynthia Calvillo,50,270,290,0,50,113,25,798
Bill Algeo,150,90,315,0,25,217,0,797
Jason MacDonald,350,385,25,0,0,36,0,796
Leonard Garcia,200,140,150,0,260,16,25,791
Brock Lesnar,350,115,80,0,0,116,125,786
Gregor Gillespie,425,180,80,0,0,101,0,786
James Thompson,600,25,0,0,25,136,0,786
Christos Giagos,150,280,290,0,0,65,0,785
Ryo Chonan,50,115,340,0,165,115,0,785
Viviane Araujo,100,0,605,0,0,55,25,785
Charles Johnson,200,0,315,0,95,174,0,784
Taylor Lapilus,100,0,450,0,0,234,0,784
Miles Johns,225,25,345,0,70,119,0,784
Chris Curtis,425,0,130,0,95,105,25,780
Sean Brady,25,270,320,0,0,139,25,779
Said Nurmagomedov,200,270,130,0,70,109,0,779
Wilson Reis,50,205,450,0,25,23,25,778
Bryan Battle,300,180,105,0,70,120,0,775
Matheus Nicolau,175,90,265,0,140,79,25,774
Mairbek Taisumov,500,0,210,0,0,63,0,773
Jennifer Maia,0,90,550,0,0,108,25,773
Ketlen Vieira,25,90,370,0,235,3,50,773
Brendan Schaub,400,90,160,0,25,97,0,772
Marion Reneau,225,180,205,0,25,137,0,772
Pat Miletich,125,295,80,0,140,55,75,770
Brian Bowles,225,385,80,0,0,30,50,770
Bryan Caraway,25,475,105,0,145,19,0,769
Daron Cruickshank,300,100,210,0,70,88,0,768
Jessica Penne,150,320,75,0,140,7,75,767
Andre Muniz,25,385,240,0,70,46,0,766
Yana Santos,75,0,425,0,25,213,25,763
Hidehiko Yoshida,50,540,130,0,25,16,0,761
Mac Danzig,150,230,260,0,25,95,0,760
Song Kenan,375,0,290,0,0,95,0,760
Tyson Pedro,425,205,75,0,0,53,0,758
Leonardo Santos,225,205,185,0,70,71,0,756
Marc-Andre Barriault,275,115,210,0,50,106,0,756
Scott Smith,575,100,50,0,0,5,25,755
Diego Nunes,0,0,500,0,140,114,0,754
Roger Huerta,300,90,185,0,25,154,0,754
Lavar Johnson,500,75,25,0,0,153,0,753
Chad Laprise,375,0,160,0,95,122,0,752
Frank Trigg,350,75,160,0,0,117,50,752
Efrain Escudero,100,140,365,0,0,146,0,751
Erik Perez,200,115,240,0,95,99,0,749
Ludovit Klein,200,25,345,0,70,109,0,749
Daniel Pineda,150,360,150,0,0,87,0,747
Marcin Prachnio,175,50,265,0,0,255,0,745
Phil Hawes,425,0,80,75,0,163,0,743
Shavkat Rakhmonov,100,450,80,0,0,86,25,741
Eugene Jackson,350,255,80,0,0,27,25,737
Paige VanZant,200,255,105,0,0,126,50,736
Melvin Manhoef,525,125,0,0,0,85,0,735
Matthew Riddle,125,0,370,0,70,168,0,733
Tatsuro Taira,200,180,160,0,25,118,50,733
Matt Frevola,400,90,105,0,70,68,0,733
Caol Uno,200,90,340,0,0,77,25,732
Tom Lawlor,200,230,185,0,50,67,0,732
Natalia Silva,200,0,320,0,0,211,0,731
Jessica Eye,25,0,335,0,190,131,50,731
John Howard,250,0,155,0,305,20,0,730
Rameau Thierry Sokoudjou,600,50,0,0,0,78,0,728
Mickey Gall,75,450,180,0,0,22,0,727
Mirsad Bektic,250,115,80,75,95,112,0,727
Matt Schnell,125,320,80,0,140,61,0,726
Thomas Almeida,475,0,130,0,0,93,25,723
Waldo Cortes-Acosta,200,0,345,0,0,176,0,721
Semmy Schilt,425,230,25,0,0,41,0,721
Pannie Kianzad,0,50,500,0,0,171,0,721
Terry Etim,125,385,155,0,0,55,0,720
Joselyne Edwards,0,90,260,0,140,230,0,720
Roman Kopylov,500,50,25,0,70,75,0,720
Antonina Shevchenko,225,115,105,0,95,179,0,719
Brock Larson,225,295,130,0,0,44,25,719
Loma Lookboonmee,0,90,370,0,70,187,0,717
Casey O'Neill,200,115,105,0,70,226,0,716
John Alessio,0,345,260,0,0,85,25,715
Jasmine Jasudavicius,0,180,450,0,0,85,0,715
Chidi Njokuani,350,0,80,0,95,189,0,714
Yves Jabouin,100,50,240,0,235,89,0,714
Jeff Monson,125,270,180,0,70,42,25,712
Rafael Fiziev,350,0,240,25,0,46,50,711
Damon Jackson,150,230,210,0,70,50,0,710
Casey Kenney,0,90,425,0,75,120,0,710
Sage Northcutt,200,140,240,0,0,129,0,709
Andre Petroski,150,180,240,0,70,69,0,709
Bethe Correia,150,25,210,0,165,108,50,708
Sijara Eubanks,125,0,420,0,0,163,0,708
Wilson Gouveia,275,360,25,0,0,46,0,706
Youssef Zalal,0,270,290,0,25,119,0,704
Maryna Moroz,0,205,340,0,95,64,0,704
Montana De La Rosa,100,295,180,0,70,59,0,704
Jack Shore,0,320,160,0,70,154,0,704
Marlon Moraes,325,90,0,0,165,23,100,703
James Te Huna,350,75,160,0,0,93,25,703
Ramsey Nijem,275,25,240,0,25,137,0,702
Benoit Saint Denis,325,180,25,0,0,122,50,702
Joshua Van,125,0,240,0,70,265,0,700
Shane Carwin,500,25,25,0,0,96,50,696
Aleksander Emelianenko,325,230,0,0,70,70,0,695
Cody Durden,125,165,345,0,0,60,0,695
Gina Carano,225,90,240,0,0,115,25,695
Ryan Couture,125,180,50,75,140,120,0,690
Jiri Prochazka,450,90,0,0,0,50,100,690
Uros Medic,525,50,0,0,0,112,0,687
Terrance McKinney,400,205,0,0,0,80,0,685
Jamie Mullarkey,300,0,210,0,70,104,0,684
Paulo Thiago,150,90,390,0,0,54,0,684
Constantinos Philippou,325,0,235,0,70,27,25,682
Luke Stewart,325,270,0,0,0,86,0,681
Marcus Aurelio,100,180,260,0,100,41,0,681
Maurice Smith,100,270,105,50,70,85,0,680
Kazuo Misaki,125,25,315,0,140,75,0,680
Fares Ziam,100,25,265,75,70,145,0,680
Darren Stewart,225,140,130,0,120,64,0,679
Dooho Choi,550,0,25,0,0,79,25,679
Joe Solecki,25,270,210,75,25,70,0,675
Krzysztof Soszynski,200,180,185,0,0,108,0,673
Pat Barry,500,75,80,0,0,18,0,673
Joaquim Silva,375,0,130,0,140,27,0,672
Charles Rosa,25,180,230,0,165,72,0,672
Enrique Barzola,0,0,450,0,95,126,0,671
Michael Morales,300,0,240,0,0,130,0,670
Mayra Bueno Silva,0,450,155,0,0,40,25,670
Abel Trujillo,300,140,130,0,0,99,0,669
Khaos Williams,400,0,105,0,95,68,0,668
Sam Sicilia,350,75,210,0,0,31,0,666
Shamil Abdurakhimov,350,0,160,0,70,59,25,664
Paul Kelly,125,140,265,0,0,133,0,663
Bart Palaszewski,325,115,75,0,120,27,0,662
Roxanne Modafferi,125,25,335,0,95,30,50,660
Dan Hardy,225,25,210,0,140,35,25,660
Nina Nunes,0,115,315,0,70,158,0,658
Karl Roberson,150,280,80,0,70,77,0,657
Zabit Magomedsharipov,0,270,240,0,0,147,0,657
Anthony Perosh,300,270,50,0,0,37,0,657
Manel Kape,300,0,210,0,25,121,0,656
Francisco Rivera,325,75,130,0,25,100,0,655
Justin Scoggins,100,75,240,0,50,189,0,654
Christian Rodriguez,0,115,345,0,70,123,0,653
Matthew Semelsberger,250,0,315,0,25,62,0,652
Francis Carmont,25,180,290,0,70,86,0,651
Tony Gravely,325,25,105,0,95,98,0,648
Denise Gomes,200,0,210,0,70,163,0,643
Jared Rosholt,125,0,425,0,0,90,0,640
Roosevelt Roberts,25,320,210,0,0,85,0,640
Tracy Cortez,0,0,425,0,70,119,25,639
Jason High,75,295,105,0,140,24,0,639
Muhammad Mokaev,0,360,240,0,0,39,0,639
Daniel Kelly,175,90,265,0,70,38,0,638
Felipe Arantes,125,180,235,0,50,46,0,636
Tom Breese,425,25,80,0,25,81,0,636
William Knight,325,0,235,0,0,73,0,633
Alex White,225,25,260,0,0,122,0,632
Seth Baczynski,175,180,155,0,70,51,0,631
Katsunori Kikuno,275,115,160,0,25,55,0,630
Dusko Todorovic,400,0,105,0,0,125,0,630
Taila Santos,0,90,345,0,50,118,25,628
Godofredo Pepey,175,270,75,0,70,38,0,628
Cyrille Diabate,125,165,80,75,0,182,0,627
Jimmy Crute,325,230,0,0,0,72,0,627
Virna Jandiroba,0,270,315,0,0,16,25,626
Chris Daukaus,500,0,0,0,0,76,50,626
Brian Ebersole,125,0,265,0,165,70,0,625
Aiemann Zahabi,225,0,345,0,0,53,0,623
Frankie Saenz,75,0,265,0,165,116,0,621
Jimi Manuwa,425,0,105,0,0,65,25,620
Jason Miller,125,180,180,0,0,84,50,619
Andrew Sanchez,200,0,345,0,0,73,0,618
Lando Vannata,100,140,205,0,70,100,0,615
Pat Sabatini,50,270,240,0,0,54,0,614
Dustin Hazelett,75,410,80,0,0,46,0,611
Diego Brandao,150,205,185,0,0,46,25,611
Armen Petrosyan,125,25,185,0,70,205,0,610
Joe Pyfer,425,90,25,0,0,45,25,610
Marius Zaromskis,350,0,160,0,0,74,25,609
Tabatha Ricci,25,90,345,0,95,54,0,609
Mike Kyle,275,165,80,0,0,89,0,609
Robert Peralta,200,25,130,0,140,112,0,607
Hector Lombard,275,0,180,0,50,101,0,606
Ricky Glenn,150,0,180,0,140,136,0,606
Steve Cantwell,225,180,125,0,0,50,25,605
Steven Siler,125,90,315,0,0,74,0,604
Ode Osbourne,250,165,105,0,70,14,0,604
Jose Quinonez,50,115,345,0,0,92,0,602
Jacob Volkmann,0,165,265,0,140,31,0,601
Nate Landwehr,175,180,105,75,0,65,0,600
Paddy Pimblett,100,270,160,0,0,70,0,600
SeungWoo Choi,150,50,265,0,25,109,0,599
Igor Pokrajac,275,115,180,0,0,29,0,599
Paul Taylor,200,25,155,0,95,123,0,598
Ivan Salaverry,225,205,50,0,0,117,0,597
John Castaneda,125,90,290,0,0,92,0,597
Rob McCullough,125,115,50,75,95,62,75,597
Luis Pena,100,115,160,0,120,101,0,596
Keita Nakamura,0,180,150,0,235,31,0,596
Charlie Valencia,150,140,185,0,70,49,0,594
Michihiro Omigawa,125,180,255,0,0,32,0,592
Alex Garcia,225,90,180,0,70,25,0,590
Drew Fickett,50,385,105,0,0,50,0,590
Siyar Bahadurzada,300,90,100,0,0,98,0,588
Terry Martin,525,0,25,0,0,37,0,587
Trevor Prangley,50,230,210,0,0,97,0,587
Jason Lambert,375,115,0,0,0,96,0,586
Ivan Menjivar,125,205,205,0,0,50,0,585
Kenny Robertson,125,180,105,25,50,100,0,585
Azamat Murzakanov,400,0,80,0,0,103,0,583
Jordan Espinosa,100,140,210,0,0,133,0,583
Ron Waterman,175,180,160,0,0,68,0,583
Lina Lansberg,50,25,395,25,0,61,25,581
Albert Tumenov,300,50,80,0,95,55,0,580
Diego Lopes,200,90,210,0,0,80,0,580
Oleg Taktarov,25,450,105,0,0,0,0,580
Peter Sobotta,150,90,260,0,0,80,0,580
Norman Parke,100,0,370,0,25,84,0,579
Martin Buday,125,90,160,0,140,63,0,578
Nate Maness,200,115,185,0,0,78,0,578
Rashid Magomedov,100,0,265,0,70,141,0,576
Marco Ruas,150,360,25,0,0,39,0,574
David Onama,200,90,185,25,0,73,0,573
Rich Clementi,0,370,130,0,70,1,0,571
Zubaira Tukhugov,200,0,160,0,145,66,0,571
Joanderson Brito,200,180,105,0,25,59,0,569
Jordan Leavitt,200,230,25,0,70,44,0,569
Maximo Blanco,100,75,265,0,25,99,0,564
Guido Cannetti,125,190,160,0,25,64,0,564
Antoni Hardonk,450,25,25,0,0,64,0,564
Marloes Coenen,25,385,0,0,0,53,100,563
Soa Palelei,450,25,25,0,0,63,0,563
Bo Nickal,100,360,80,0,0,23,0,563
Mateusz Rebecki,125,180,80,0,70,108,0,563
Anthony Hamilton,275,50,130,0,0,105,0,560
Drew McFedries,425,100,0,0,0,34,0,559
Jessica-Rose Clark,100,75,210,0,70,104,0,559
Cameron Saaiman,325,0,25,75,0,133,0,558
Polyana Viana,125,320,50,0,25,37,0,557
Dustin Stoltzfus,250,140,105,0,0,62,0,557
Damir Hadzovic,225,25,155,0,70,80,0,555
Leslie Smith,225,0,185,0,0,145,0,555
Felice Herrig,0,230,210,0,95,19,0,554
Damir Ismagulov,0,0,370,0,70,114,0,554
Javid Basharat,0,90,265,0,0,198,0,553
Charlie Brenneman,100,75,320,0,0,58,0,553
Daniel Omielanczuk,200,25,75,150,25,78,0,553
Rinya Nakamura,200,90,185,0,0,78,0,553
Marco Polo Reyes,400,0,0,0,70,82,0,552
Alan Patrick,175,0,345,0,0,32,0,552
Priscila Cachoeira,300,100,130,0,0,22,0,552
Alessio Di Chirico,250,25,100,0,140,36,0,551
Din Thomas,25,205,210,0,70,40,0,550
Tamdan McCrory,150,230,80,0,25,65,0,550
Ali Bagautinov,100,0,315,0,0,110,25,550
Dhiego Lima,200,25,130,0,140,55,0,550
Yoshiro Maeda,200,165,80,0,25,54,25,549
Luiz Cane,375,0,105,0,0,69,0,549
Dean Lister,0,270,235,0,25,19,0,549
Carlos Prates,500,0,0,0,0,24,25,549
Ben Nguyen,125,205,105,0,0,114,0,549
Jason Knight,125,90,155,0,95,83,0,548
Payton Talbott,200,90,105,0,0,152,0,547
Aspen Ladd,325,0,130,0,0,41,50,546
Makhmud Muradov,200,25,185,0,0,135,0,545
Brett Rogers,450,25,0,0,0,45,25,545
Amir Albazi,100,180,105,0,70,39,50,544
Rongzhu,200,115,105,0,0,123,0,543
Lucie Pudilova,100,25,285,0,50,83,0,543
Gavin Tucker,25,205,185,0,0,127,0,542
Rafa Garcia,25,90,315,0,0,112,0,542
Luke Sanders,125,165,105,0,0,146,0,541
Luigi Fioravanti,250,25,210,0,0,56,0,541
David Teymur,200,25,240,0,0,76,0,541
DaMarques Johnson,275,255,0,0,0,10,0,540
Dwight Grant,250,0,25,0,190,74,0,539
TJ Brown,0,255,130,0,70,83,0,538
Dennis Hallman,175,180,130,0,0,28,25,538
Claudio Silva,0,270,155,0,70,43,0,538
Alex Karalexis,250,50,80,75,0,81,0,536
Sabina Mazo,0,140,130,0,70,196,0,536
Ian Heinisch,225,0,235,0,0,75,0,535
Ryan Gracie,225,180,25,0,70,35,0,535
Mike Malott,125,270,80,0,0,59,0,534
Hatsu Hioki,25,25,290,0,95,98,0,533
Ailin Perez,0,115,320,0,0,97,0,532
Doug Marshall,325,90,0,0,0,42,75,532
Rodrigo Nascimento,50,180,105,0,140,30,25,530
Vitor Petrino,225,115,160,0,0,30,0,530
Ramazan Emeev,25,0,345,0,95,65,0,530
Claudio Puelles,50,270,160,0,25,25,0,530
Julian Marquez,175,270,0,0,25,59,0,529
Roan Carneiro,150,140,105,0,95,38,0,528
Farid Basharat,0,90,320,0,0,118,0,528
CJ Vergara,225,25,130,0,70,77,0,527
Brandon Davis,25,115,210,0,75,102,0,527
Miguel Baeza,250,90,130,0,0,56,0,526
Ji Yeon Kim,100,0,125,0,190,111,0,526
Josh Parisian,350,25,50,0,70,30,0,525
,125,0,0,0,0,0,400,525
Jamie Pickett,150,75,260,0,0,40,0,525
Veronica Hardy,25,115,235,0,70,79,0,524
Phil Rowe,400,0,50,0,25,48,0,523
Kyle Nelson,275,25,185,0,0,37,0,522
Vince Morales,125,25,285,0,0,87,0,522
Tafon Nchukwi,150,0,185,25,0,162,0,522
Brad Katona,0,0,420,0,0,102,0,522
Sam Hughes,100,0,180,75,70,96,0,521
David Branch,175,50,160,0,70,40,25,520
Desmond Green,100,0,235,0,70,114,0,519
Justin Tafa,425,0,50,0,25,19,0,519
Ian McCall,100,25,260,0,0,134,0,519
Andre Ewell,50,25,130,0,210,103,0,518
Mitch Gagnon,0,320,130,0,0,67,0,517
Yuta Sasaki,25,435,25,0,0,32,0,517
Joe Proctor,250,115,105,0,0,45,0,515
Vaughan Lee,25,140,185,0,25,139,0,514
Elise Reed,50,50,240,0,70,104,0,514
Omar Morales,125,25,265,0,25,74,0,514
Ryan Hall,25,90,320,0,0,79,0,514
Mick Parkin,100,90,240,0,0,84,0,514
Josefine Knutsson,0,0,345,0,0,168,0,513
Viacheslav Borshchev,300,25,50,0,70,66,0,511
Daniel Marcos,100,0,160,0,140,111,0,511
Alexander Otsuka,175,115,180,0,0,40,0,510
Brett Johns,0,180,290,0,0,39,0,509
Mike Rodriguez,325,50,50,0,0,84,0,509
Jake Hadley,100,180,180,0,0,48,0,508
Jacob Malkoun,125,0,265,0,0,116,0,506
Daiju Takase,175,90,155,0,70,16,0,506
Raul Rosas Jr.,100,180,185,0,0,39,0,504
Jorge Gurgel,25,115,235,0,70,58,0,503
Johnny Case,100,115,185,0,0,103,0,503
Josh Grispi,125,295,50,0,0,32,0,502
Aaron Riley,125,0,265,0,25,85,0,500
Rodolfo Vieira,0,475,25,0,0,0,0,500
Themba Gorimbo,100,50,240,0,0,110,0,500
Jon Tuck,100,180,155,0,50,13,0,498
Chris Wade,0,180,290,0,0,28,0,498
Joey Beltran,225,0,180,0,25,68,0,498
Esteban Ribovics,200,0,105,0,70,122,0,497
Melsik Baghdasaryan,100,25,240,0,0,131,0,496
Jack Jenkins,225,0,80,0,70,121,0,496
Renzo Gracie,50,115,210,0,25,95,0,495
Nam Phan,0,0,230,0,145,120,0,495
Parker Porter,175,25,240,0,0,55,0,495
Joe Duffy,125,205,130,0,0,35,0,495
Vanessa Demopoulos,0,115,235,0,140,4,0,494
Shara Magomedov,200,0,160,0,0,134,0,494
Tsuyoshi Kohsaka,300,0,160,0,0,33,0,493
Da Woon Jung,225,115,130,0,0,22,0,492
Karine Silva,0,360,105,0,0,27,0,492
Austin Hubbard,0,50,315,0,25,100,0,490
Cesar Almeida,200,0,160,0,25,104,0,489
Jared Hamman,275,25,105,0,0,83,0,488
Maurice Greene,150,205,25,0,70,37,0,487
Joe Doerksen,100,205,130,0,25,2,25,487
Paul Varelans,275,115,80,0,0,17,0,487
Kajan Johnson,125,25,160,0,95,82,0,487
Ashlee Evans-Smith,100,50,180,0,70,86,0,486
Ashley Yoder,0,0,310,0,120,55,0,485
Rony Jason,225,90,130,0,25,14,0,484
Chris Gruetzemacher,125,75,160,0,0,124,0,484
Brad Riddell,25,50,240,0,70,98,0,483
Batgerel Danaa,350,0,50,0,0,83,0,483
Jerry Bohlander,25,360,80,0,0,18,0,483
TJ Waldburger,75,270,105,0,0,32,0,482
Jamall Emmers,150,25,160,0,50,97,0,482
Sumudaerji,100,75,185,0,0,122,0,482
Victor Henry,100,25,105,0,70,181,0,481
Cody Brundage,250,140,50,0,0,40,0,480
Rinat Fakhretdinov,0,90,240,0,70,79,0,479
Adriano Martins,250,90,0,0,120,19,0,479
Marcus Brimage,175,0,160,0,95,48,0,478
Alatengheili,100,0,290,0,70,17,0,477
Impa Kasanganay,50,90,240,0,0,97,0,477
Yoshihisa Yamamoto,275,115,50,0,0,37,0,477
Marcus McGhee,200,90,80,0,0,106,0,476
Felicia Spencer,200,90,50,0,25,85,25,475
Brunno Ferreira,425,25,0,0,0,22,0,472
Cat Zingano,225,25,105,0,25,67,25,472
Gilbert Yvel,300,50,100,0,0,21,0,471
Carlston Harris,175,180,80,0,0,36,0,471
Ihor Potieria,300,25,105,0,0,39,0,469
Jeremiah Wells,200,115,0,0,95,59,0,469
Zak Ottow,175,0,0,0,235,57,0,467
Adlan Amagov,325,0,80,0,0,62,0,467
Jorge Santiago,375,0,75,0,0,17,0,467
Vitor Miranda,300,0,100,0,0,67,0,467
Caio Magalhaes,200,115,105,0,25,22,0,467
Eric Schafer,175,180,75,0,0,36,0,466
Josh Culibao,25,90,105,0,120,126,0,466
Tyson Nam,300,25,50,0,50,41,0,466
Francimar Barroso,0,25,345,0,50,42,0,462
Davi Ramos,0,270,155,0,0,36,0,461
Manuel Torres,325,90,0,0,0,46,0,461
Todd Duffee,375,0,0,0,0,60,25,460
Sean Spencer,25,50,185,0,95,104,0,459
James Irvin,400,50,0,0,0,8,0,458
Johnny Eduardo,225,75,105,0,0,52,0,457
Lyman Good,300,25,25,0,25,82,0,457
Daniel Zellhuber,0,90,265,0,25,76,0,456
Luiz Firmino,0,180,210,0,25,41,0,456
Hyun Gyu Lim,350,0,50,0,0,31,25,456
Kyle Kingsbury,100,25,235,0,70,25,0,455
Jake O'Brien,150,50,160,0,70,25,0,455
Cheyanne Vlismas,100,0,210,0,0,144,0,454
Michael Trizano,125,25,105,0,140,58,0,453
Cody Gibson,100,115,180,0,0,58,0,453
Mike Davis,100,115,185,0,0,53,0,453
Ryan Benoit,200,50,50,0,120,33,0,453
Modestas Bukauskas,175,90,160,0,25,3,0,453
Lucas Martins,250,90,0,0,95,17,0,452
Bob Sapp,350,50,0,0,0,52,0,452
Nick Hein,25,25,345,0,25,31,0,451
Daisuke Nakamura,100,270,75,0,0,6,0,451
Christian Leroy Duncan,300,0,50,0,0,101,0,451
Nikolas Motta,250,0,160,0,0,40,0,450
Jeff Molina,100,0,160,0,70,119,0,449
Sarah Moras,125,90,205,0,0,28,0,448
Oban Elliott,100,0,160,75,0,112,0,447
Sean Pierson,25,0,265,75,0,81,0,446
Tagir Ulanbekov,0,180,185,0,70,11,0,446
George Sullivan,125,75,160,0,0,86,0,446
Chris Duncan,125,115,80,0,70,56,0,446
Roger Gracie,25,270,105,0,0,45,0,445
Pete Spratt,0,420,0,0,0,25,0,445
Kevin Ferguson,350,0,80,0,0,15,0,445
Patrick Smith,125,295,0,0,0,23,0,443
Timothy Johnson,125,0,185,0,95,38,0,443
Devonte Smith,350,0,0,0,25,67,0,442
Ismail Naurdiev,0,0,290,0,0,152,0,442
Ryan Jimmo,250,0,130,0,0,61,0,441
Jason Brilz,150,0,160,0,50,80,0,440
Pete Williams,150,205,50,0,0,10,25,440
Steven Peterson,100,0,180,0,120,40,0,440
Carlos Hernandez,25,25,105,0,210,74,0,439
Naoya Ogawa,100,320,0,0,0,19,0,439
Alex Serdyukov,100,230,25,0,0,83,0,438
Alexander Yakovlev,100,140,180,0,0,17,0,437
Luke Cummo,200,0,155,25,0,56,0,436
Justin Willis,100,0,265,0,0,70,0,435
Bevon Lewis,250,0,105,0,0,80,0,435
Riki Fukuda,0,0,315,0,0,120,0,435
Victor Altamirano,100,0,130,0,120,85,0,435
Frank Camacho,175,25,50,0,70,113,0,433
Aoriqileng,125,0,235,0,0,73,0,433
Gabriel Bonfim,25,270,80,0,0,57,0,432
Philipe Lins,125,0,265,0,0,41,0,431
Trevor Peek,200,0,155,0,0,75,0,430
Kazuyuki Miyata,0,50,240,0,95,45,0,430
Dave Menne,75,0,210,0,0,95,50,430
Kenji Osawa,0,25,130,0,210,64,0,429
Cory McKenna,0,115,240,0,50,24,0,429
Wagnney Fabiano,0,140,240,0,0,48,0,428
Pablo Garza,100,165,105,0,0,58,0,428
Mark Madsen,125,25,160,0,70,48,0,428
Kyle Daukaus,50,90,210,0,0,77,0,427
Teruto Ishihara,225,25,155,0,0,21,0,426
Mario Sperry,225,90,25,0,0,84,0,424
Russell Doane,100,165,50,0,70,39,0,424
Joe Soto,75,205,80,0,25,14,25,424
Magnus Cedenblad,125,205,80,0,0,12,0,422
Nick Catone,0,140,80,0,165,37,0,422
Da'Mon Blackshear,125,180,50,0,0,66,0,421
HyunSung Park,200,180,0,0,0,39,0,419
Piera Rodriguez,0,25,320,0,0,74,0,419
Rodrigo Gracie,0,90,265,0,0,63,0,418
Poliana Botelho,100,50,185,0,25,58,0,418
Raulian Paiva,125,0,105,75,95,18,0,418
Sedriques Dumas,25,115,240,0,0,38,0,418
Justin Salas,175,25,80,0,70,66,0,416
Hunter Azure,25,0,240,0,25,126,0,416
Karl Williams,0,0,345,0,0,70,0,415
Tomasz Drwal,225,115,25,0,0,49,0,414
Eddie Sanchez,350,0,25,0,0,38,0,413
Chepe Mariscal,100,0,160,0,70,83,0,413
Gerald Harris,300,0,25,0,70,17,0,412
Lukasz Brzeski,75,90,105,0,25,117,0,412
Brad Blackburn,125,0,105,0,70,112,0,412
Clint Hester,150,25,80,0,70,86,0,411
Juan Adams,250,0,25,0,0,136,0,411
Yizha,0,180,105,0,95,30,0,410
Iasmin Lucindo,0,90,185,0,70,65,0,410
Jonathan Goulet,200,115,0,75,0,19,0,409
Matt Grice,50,50,80,0,95,134,0,409
Ildemar Alcantara,0,90,155,0,140,24,0,409
Elias Silverio,25,90,185,0,0,109,0,409
Justine Kish,0,25,265,0,50,68,0,408
Chad Anheliger,100,25,130,0,70,83,0,408
Nicolae Negumereanu,225,0,25,0,140,17,0,407
Damacio Page,100,215,80,0,0,11,0,406
Richard Walsh,25,0,210,0,25,145,0,405
Brad Scott,25,180,75,0,95,29,0,404
JeongYeong Lee,125,90,80,0,70,39,0,404
Jon Madsen,100,0,160,0,70,73,0,403
Valerie Letourneau,25,0,185,0,95,73,25,403
Luke Barnatt,100,90,105,0,50,58,0,403
Blagoy Ivanov,0,0,315,0,50,11,25,401
Neil Seery,0,115,235,0,0,50,0,400
Megan Anderson,200,140,25,0,0,10,25,400
Rodrigo Damm,50,90,130,0,95,10,25,400
Richard Crunkilton,125,90,130,0,0,30,25,400
Charles Byrd,75,270,0,0,0,54,0,399
Chase Beebe,25,50,160,0,25,64,75,399
Reza Madadi,100,180,50,0,50,19,0,399
Andrew Craig,125,25,130,0,70,49,0,399
Alessandro Costa,225,0,25,0,70,79,0,399
Rei Tsuruya,100,90,160,0,0,48,0,398
Javier Vazquez,0,180,105,0,50,62,0,397
Jared Vanderaa,175,25,105,0,25,66,0,396
Ismael Bonfim,100,25,160,0,0,111,0,396
Joby Sanchez,125,25,105,0,95,46,0,396
Mike Easton,100,0,155,75,25,40,0,395
Shane Young,125,25,155,0,0,90,0,395
Sanae Kikuta,25,115,240,0,0,14,0,394
Justin Ledet,50,90,130,0,70,54,0,394
David Loiseau,225,0,100,0,0,44,25,394
Stephanie Egger,100,230,50,0,0,14,0,394
Juliana Lima,0,25,315,0,0,53,0,393
Brian Foster,200,140,0,0,0,53,0,393
Xiao Long,100,0,25,75,95,97,0,392
Johnny Bedford,225,50,0,0,0,117,0,392
Wellington Turman,50,115,130,0,95,1,0,391
Hugo Viana,150,0,105,0,70,66,0,391
Leandro Silva,0,90,235,0,25,40,0,390
Daniel Puder,0,270,80,0,0,40,0,390
Jai Herbert,150,25,185,0,0,30,0,390
Mariya Agapova,25,255,25,0,0,85,0,390
Fabiano Iha,150,180,50,0,0,9,0,389
Nick Ring,0,90,210,0,25,63,0,388
Asu Almabayev,0,90,240,0,0,58,0,388
Jesus Aguilar,100,205,0,0,70,12,0,387
Cathal Pendred,25,90,160,0,95,17,0,387
Tucker Lutz,0,25,290,0,0,72,0,387
Yan Cabral,25,180,130,0,0,51,0,386
Yazmin Jauregui,125,25,160,0,0,76,0,386
Mu Bae Choi,25,270,80,0,0,11,0,386
Jaqueline Amorim,100,180,25,0,0,80,0,385
Herbert Burns,200,180,0,0,0,5,0,385
Dave Beneteau,200,75,80,0,0,29,0,384
Jeka Saragih,325,25,0,0,0,33,0,383
Ed Ratcliff,200,50,80,0,25,28,0,383
Dong Hyun Ma,175,0,105,0,70,32,0,382
William Gomis,100,0,80,0,140,62,0,382
Jack Marshman,125,50,130,0,70,6,0,381
Ryan Jensen,50,305,0,0,0,26,0,381
Tim Credeur,225,90,25,0,0,40,0,380
Charles Bennett,200,165,0,0,0,14,0,379
Vinicius Oliveira,200,0,80,0,0,98,0,378
Marcus Hicks,25,270,25,25,0,7,25,377
Shonie Carter,150,0,185,0,0,42,0,377
Michael Chandler,225,25,50,0,0,27,50,377
Gina Mazany,200,25,105,0,0,47,0,377
Maki Pitolo,225,50,50,0,0,51,0,376
Hyder Amil,200,0,80,0,0,95,0,375
Chico Camus,0,25,235,0,70,45,0,375
Jimy Hettes,25,180,105,0,0,65,0,375
Masakazu Imanari,25,180,75,0,95,0,0,375
Cody McKenzie,25,230,105,0,0,15,0,375
Zach Makovsky,0,0,315,0,25,35,0,375
Curtis Millender,100,25,185,0,0,64,0,374
Chad Griggs,300,50,0,0,0,24,0,374
Josh Samman,225,115,0,0,0,34,0,374
Justin Eilers,300,0,0,0,0,24,50,374
Luis Saldana,100,0,185,0,0,89,0,374
Bartosz Fabinski,0,75,240,0,0,58,0,373
Josiane Nunes,100,0,185,0,25,63,0,373
Nicholas Musoke,25,90,210,0,0,47,0,372
Jordan Johnson,0,90,160,0,70,52,0,372
Chris Horodecki,25,115,0,0,140,91,0,371
Ian Freeman,225,25,80,0,0,40,0,370
Kurt Holobaugh,25,115,180,0,0,50,0,370
Shin Haraguchi,100,25,160,0,25,60,0,370
Kleydson Rodrigues,100,25,105,0,25,115,0,370
Shamil Gaziev,125,90,80,0,0,49,25,369
Tony Fryklund,175,140,0,0,0,54,0,369
Alex Stiebling,100,0,185,0,25,59,0,369
Jason Saggo,225,0,25,0,95,24,0,369
Zachary Reese,150,90,80,0,0,48,0,368
Steve Erceg,125,0,185,0,0,33,25,368
Shane del Rosario,150,180,0,0,0,38,0,368
David Dvorak,0,90,235,0,0,43,0,368
Ronnie Lawrence,100,0,185,0,0,82,0,367
Rob Kimmons,50,230,80,0,0,7,0,367
Enson Inoue,25,295,25,0,0,21,0,366
Tony DeSouza,75,180,80,0,0,30,0,365
Blas Avena,175,180,0,0,0,10,0,365
Rob Emerson,100,25,130,0,70,39,0,364
Evangelista Santos,175,140,0,0,0,21,25,361
Hannah Goldy,25,90,155,0,0,90,0,360
Ibo Aslan,300,0,0,0,0,59,0,359
Aleksa Camur,100,0,130,0,25,104,0,359
Forrest Petz,25,25,185,0,50,74,0,359
Ramiz Brahimaj,125,180,50,0,0,3,0,358
Bogdan Guskov,200,115,0,0,0,43,0,358
Abus Magomedov,125,90,105,0,0,13,25,358
Sean O'Connell,275,0,25,0,25,33,0,358
Ikram Aliskerov,225,90,0,0,0,17,25,357
Malcolm Gordon,150,75,80,0,0,52,0,357
Kamal Shalorus,125,50,80,0,70,31,0,356
Garrett Armfield,100,50,80,0,25,101,0,356
Jamal Pogues,0,0,345,0,0,10,0,355
Hacran Dias,0,0,285,0,70,0,0,355
Diana Belbita,0,50,235,0,0,70,0,355
Jimmy Flick,50,270,25,0,0,10,0,355
Ruslan Magomedov,0,0,240,0,0,115,0,355
Shayilan Nuerdanbieke,125,25,185,0,0,20,0,355
Artem Lobov,0,0,285,0,0,45,25,355
Logan Clark,200,0,105,0,0,49,0,354
Ricky Turcios,0,25,75,0,140,114,0,354
Eduarda Moura,100,90,80,0,25,58,0,353
Edimilson Souza,200,25,0,0,70,58,0,353
Rich Attonito,125,0,185,0,0,43,0,353
Matt Sayles,100,140,25,0,0,88,0,353
Julia Avila,100,115,105,0,0,33,0,353
Dalcha Lungiambula,175,25,105,0,0,48,0,353
Daniel Roberts,25,180,75,0,70,3,0,353
Katsuyori Shibata,150,50,105,0,0,47,0,352
Darrick Minner,50,140,105,0,0,57,0,352
Jose Johnson,0,140,130,0,0,81,0,351
Brandon Thatch,200,100,0,0,0,26,25,351
Will Brooks,125,50,80,0,0,95,0,350
Luana Pinheiro,125,25,105,0,70,24,0,349
Mike Russow,150,25,160,0,0,14,0,349
Kevin Aguilar,25,0,210,0,95,18,0,348
Kuniyoshi Hironaka,175,0,130,0,0,43,0,348
Eric Shelton,0,0,130,0,120,97,0,347
Tom Nolan,225,0,80,0,0,41,0,346
Jacqueline Cavalcanti,0,0,80,0,140,126,0,346
Yuki Kondo,150,25,75,0,50,21,25,346
Jean Silva,200,0,105,0,0,41,0,346
Bruna Brasil,125,0,185,0,0,35,0,345
Houston Alexander,250,25,25,0,0,45,0,345
Natan Levy,0,115,185,0,0,44,0,344
Tom Watson,100,0,155,0,50,39,0,344
Trey Ogden,0,0,290,0,25,29,0,344
ChangHo Lee,200,0,0,0,70,73,0,343
Dave Herman,275,25,0,0,0,43,0,343
Luana Santos,100,90,105,0,0,48,0,343
Manny Bermudez,0,295,25,0,0,21,0,341
Takashi Sato,225,50,50,0,0,16,0,341
Marco Tulio,200,0,80,0,0,60,0,340
Dong Sik Yoon,50,25,180,0,70,15,0,340
Roland Delorme,0,205,105,0,25,4,0,339
Gan McGee,250,25,0,0,25,14,25,339
Remco Pardoel,100,230,0,0,0,9,0,339
Billy Evangelista,0,0,130,0,140,68,0,338
Viktoriia Dudakova,125,0,160,0,25,28,0,338
Roger Bowling,175,0,105,0,0,58,0,338
Tom Erikson,0,230,80,0,0,28,0,338
SeungGuk Choi,0,25,265,0,0,48,0,338
Dongi Yang,200,0,50,0,25,63,0,338
Jared Gooden,100,90,125,0,0,23,0,338
Viscardi Andrade,100,0,185,0,0,52,0,337
Emily Ducote,0,0,210,0,25,102,0,337
Piotr Hallmann,25,180,25,0,25,82,0,337
Francis Marshall,125,0,80,0,95,36,0,336
Mizuto Hirota,0,25,205,0,25,81,0,336
Danny Barlow,200,0,0,0,70,65,0,335
Livinha Souza,25,90,130,0,70,20,0,335
Makoto Takimoto,0,90,210,0,0,34,0,334
Nobuhiko Takada,50,255,25,0,0,4,0,334
Maxim Grishin,100,0,155,0,0,79,0,334
Scott Askham,200,0,50,0,50,34,0,334
Eliot Marshall,25,90,105,0,95,19,0,334
Julija Stoliarenko,50,205,50,0,25,3,0,333
Andre Fialho,300,0,25,0,0,8,0,333
Caio Machado,0,0,130,0,25,177,0,332
Joey Villasenor,250,0,25,0,25,7,25,332
Rafaello Oliveira,75,25,210,0,0,22,0,332
Clayton Carpenter,0,180,105,0,0,47,0,332
Muhammad Naimov,200,25,105,0,0,1,0,331
Hannah Cifers,50,75,80,0,70,56,0,331
Henrique da Silva,150,115,50,0,0,15,0,330
Marco Beltran,25,115,105,0,70,14,0,329
Jafel Filho,100,205,0,0,0,24,0,329
Randy Costa,250,50,0,0,0,29,0,329
Elves Brener,225,0,25,0,70,8,0,328
Paddy Holohan,0,115,185,0,0,28,0,328
Pascal Krauss,25,0,185,0,0,117,0,327
Amanda Cooper,100,75,80,0,25,47,0,327
Preston Parsons,50,0,185,0,25,67,0,327
Johnny Munoz,25,90,155,0,0,57,0,327
Mitch Clarke,50,115,105,0,25,32,0,327
Maheshate,125,0,130,0,70,1,0,326
Kimo Leopoldo,125,165,25,0,0,9,0,324
Zhang Mingyang,300,0,0,0,0,24,0,324
Charles Radtke,225,0,80,0,0,19,0,324
Paul Sass,0,295,25,0,0,3,0,323
James Moontasri,100,115,50,0,25,33,0,323
Hiromitsu Miura,250,0,25,0,0,23,25,323
Claude Patrick,0,90,160,0,25,47,0,322
Bec Rawlings,25,90,155,0,25,27,0,322
Dennis Buzukja,125,0,130,0,25,42,0,322
Ryan Janes,100,25,105,0,0,92,0,322
Luis Henrique,50,180,50,0,0,42,0,322
Ronny Markes,50,0,160,0,70,39,0,319
Karlos Vemola,100,140,50,0,0,29,0,319
Antonio Arroyo,25,90,130,0,0,73,0,318
Josh Fremd,25,115,130,0,0,48,0,318
Zelg Galesic,100,165,0,0,0,52,0,317
Mike Massenzio,25,165,105,0,0,22,0,317
Jeff Curran,0,25,230,0,25,12,25,317
Sergey Morozov,0,50,240,0,0,26,0,316
Pete Sell,100,90,105,0,0,21,0,316
Junior Assuncao,0,140,105,0,0,70,0,315
Nick Maximov,0,25,185,0,70,35,0,315
Junior Tafa,225,25,25,0,0,40,0,315
Melissa Gatto,200,0,25,0,25,64,0,314
Jhonata Diniz,200,0,80,0,0,34,0,314
Eric Spicely,50,230,25,0,0,8,0,313
Daijiro Matsui,25,25,210,0,25,28,0,313
Andre Soukhamthath,100,0,155,0,50,8,0,313
Alberto Mina,200,0,25,0,70,17,0,312
Ebenezer Fontes Braga,25,115,105,0,0,67,0,312
Devin Cole,125,0,105,0,0,82,0,312
Shana Dobson,250,0,50,0,0,12,0,312
Askar Askarov,0,0,265,0,0,47,0,312
Tyler Toner,200,0,50,0,0,62,0,312
Edwin Figueroa,125,0,75,0,70,42,0,312
Manny Tapia,125,0,50,0,70,41,25,311
Jeremy Kennedy,25,0,240,0,0,46,0,311
Dominique Steele,125,0,155,0,0,31,0,311
Jinh Yu Frey,25,25,235,0,25,0,0,310
Lucas Almeida,125,25,105,0,0,55,0,310
Mohammed Usman,100,0,210,0,0,0,0,310
Kenichi Yamamoto,50,115,105,0,0,15,25,310
Gloria de Paula,25,0,185,0,25,74,0,309
Anthony Ruiz,100,50,50,0,0,84,25,309
Ottman Azaitar,275,0,0,0,0,34,0,309
Anthony Birchak,150,50,0,0,70,38,0,308
Markus Perez,25,180,100,0,0,2,0,307
Masaaki Satake,150,50,50,0,25,32,0,307
Matthew Lopez,150,25,105,0,0,27,0,307
Oskar Piechota,125,50,80,0,0,52,0,307
Takeshi Inoue,200,0,50,0,0,31,25,306
Benji Radach,125,0,105,0,0,76,0,306
Brian Johnston,250,50,0,0,0,6,0,306
Torrez Finney,100,90,80,0,0,35,0,305
Luiz Azeredo,150,0,50,0,70,35,0,305
Mara Romero Borella,25,140,50,0,70,18,0,303
Nurullo Aliev,100,0,80,75,0,47,0,302
Mark De La Rosa,25,115,75,0,70,17,0,302
Justin Edwards,25,115,130,0,25,7,0,302
Xie Bin,100,25,80,0,25,72,0,302
Steven Nguyen,125,0,105,0,0,71,0,301
Mauricio Ruffy,200,0,80,0,0,21,0,301
Claudio Ribeiro,275,0,0,0,0,26,0,301
Daniel Sarafian,125,115,0,0,50,10,0,300
Albert Duraev,0,115,80,0,70,35,0,300
Carlos Felipe,0,0,105,25,140,30,0,300
Brady Hiestand,100,90,80,0,25,4,0,299
Sam Patterson,25,270,0,0,0,4,0,299
Ange Loosa,0,0,235,0,0,63,0,298
Nah-Shon Burrell,25,0,105,0,70,98,0,298
Scott Ferrozzo,125,25,80,0,0,68,0,298
Muin Gafurov,0,25,185,0,25,62,0,297
LC Davis,0,25,105,75,70,22,0,297
Tatsuya Mizuno,175,115,0,0,0,6,0,296
Jordan Griffin,0,180,100,0,0,16,0,296
Deron Winn,25,25,160,0,25,61,0,296
Andrews Nakahara,200,25,25,0,0,45,0,295
Isaac Vallie-Flagg,0,0,75,0,140,80,0,295
Assuerio Silva,100,115,25,25,25,4,0,294
Mounir Lazzez,25,25,160,0,0,84,0,294
Tae Hyun Bang,100,25,50,0,70,48,0,293
Jonathan Brookins,125,50,105,0,0,13,0,293
Chris Beal,100,25,105,0,25,38,0,293
Gabe Green,125,0,130,0,0,38,0,293
Andre Winner,100,25,155,0,0,12,0,292
Melquizael Costa,25,115,80,0,0,72,0,292
Cyril Asker,175,90,0,0,0,26,0,291
Robert Whiteford,100,25,105,0,25,36,0,291
Yorgan De Castro,225,0,50,0,0,16,0,291
AJ Dobson,25,90,130,0,0,45,0,290
Travis Lutter,125,140,25,0,0,0,0,290
Gadzhimurad Antigulov,75,205,0,0,0,10,0,290
John Cholish,100,115,25,0,0,50,0,290
Bas Rutten,200,0,0,0,70,20,0,290
Jess Liaudin,125,90,25,0,25,25,0,290
Andre Galvao,125,90,0,0,25,49,0,289
Nick Osipczak,100,90,25,0,50,24,0,289
Allan Goes,50,90,105,0,0,44,0,289
Julia Polastri,0,90,50,0,70,79,0,289
Garreth McLellan,150,0,25,0,25,89,0,289
Billy Ray Goff,200,0,25,0,0,64,0,289
Laureano Staropoli,0,0,260,0,0,28,0,288
Khama Worthy,175,90,0,0,0,23,0,288
Mackens Semerzier,0,230,25,0,25,7,0,287
Marcio Cruz,125,90,0,0,25,47,0,287
Lauren Mueller,0,25,210,0,0,51,0,286
Chris Barnett,225,25,25,0,0,11,0,286
Zhang Tiequan,25,180,75,0,0,6,0,286
Chris Brennan,25,205,50,0,0,6,0,286
Isaac Dulgarian,100,90,0,0,25,71,0,286
Jason Witt,100,90,0,75,0,20,0,285
Andre Lima,0,0,160,0,70,55,0,285
Dokonjonosuke Mishima,0,165,25,0,70,24,0,284
Leandro Issa,0,205,50,0,0,28,0,283
Jay Hieron,150,0,105,0,0,28,0,283
Micah Miller,125,90,50,0,0,17,0,282
Damian Stasiak,25,180,75,0,0,2,0,282
Tony Kelley,125,0,105,0,0,51,0,281
Kailin Curran,25,140,75,0,0,41,0,281
Keith Hackney,100,140,0,0,0,41,0,281
Emily Whitmire,0,190,80,0,0,11,0,281
WonBin Ki,225,0,0,0,0,55,0,280
Aaron Rosa,75,90,0,75,0,40,0,280
Benito Lopez,0,50,160,0,70,0,0,280
Christian Wellisch,50,90,80,0,25,34,0,279
Mike de la Torre,150,25,0,0,95,9,0,279
Yaotzin Meza,25,90,155,0,0,9,0,279
Guangyou Ning,100,0,105,0,25,48,0,278
Chris Clements,125,0,25,0,70,58,0,278
Aleksei Kunchenko,0,0,210,0,0,67,0,277
Atsushi Yamamoto,100,0,80,0,50,47,0,277
Victoria Leonardo,175,0,80,0,0,22,0,277
Tra Telligman,75,90,105,0,0,7,0,277
Damien Brown,125,0,25,0,120,7,0,277
Katsuhisa Fujii,125,115,0,0,0,36,0,276
Kyle Bochniak,0,0,180,0,95,0,0,275
Jason Von Flue,25,205,25,0,0,20,0,275
Cole Escovedo,150,25,75,0,0,0,25,275
Daniel Acacio,100,25,105,0,0,44,0,274
Fernando Padilla,125,90,25,0,0,34,0,274
Amar Suloev,25,50,105,0,70,23,0,273
Rizvan Kuniev,200,0,0,0,0,73,0,273
Joseph Holmes,25,205,25,0,0,18,0,273
AJ Fletcher,100,115,50,0,0,7,0,272
Bobby Southworth,0,115,105,0,0,2,50,272
Bojan Velickovic,100,0,105,0,50,15,0,270
Arjan Bhullar,0,25,240,0,0,4,0,269
Austen Lane,175,0,80,0,0,14,0,269
Lance Benoist,0,0,185,0,25,59,0,269
Orion Cosce,150,0,80,0,0,38,0,268
Magomed Mustafaev,200,25,0,0,25,18,0,268
Kevin Jousset,25,90,80,0,0,72,0,267
Chelsea Chandler,100,0,130,0,0,37,0,267
Gaston Bolanos,25,0,160,0,0,82,0,267
Austin Lingo,0,25,210,0,0,31,0,266
Antonio Schembri,100,90,75,0,0,1,0,266
Ken Stone,75,90,0,0,70,31,0,266
Kevin Burns,150,90,25,0,0,0,0,265
Rodolfo Bellato,225,0,0,0,0,40,0,265
Allan Nascimento,0,90,80,0,50,45,0,265
SuYoung You,0,0,160,0,70,34,0,264
Dylan Andrews,225,25,0,0,0,14,0,264
Noad Lahat,50,0,80,75,0,59,0,264
Philip De Fries,75,90,80,0,0,17,0,262
Felipe Colares,25,0,130,0,95,12,0,262
Nad Narimani,25,0,185,0,0,51,0,261
Tereza Bleda,25,0,160,0,0,75,0,260
Bolaji Oki,100,25,0,0,70,65,0,260
Mike van Arsdale,0,140,80,0,0,39,0,259
Jutaro Nakao,200,0,50,0,0,8,0,258
Hector Sandoval,125,25,80,0,0,28,0,258
Shungo Oyama,100,50,105,0,0,3,0,258
Kevin Jackson,100,140,0,0,0,18,0,258
Rafael Alves,25,180,25,25,0,3,0,258
Adam Fugitt,125,25,0,0,70,38,0,258
Zhalgas Zhumagulov,25,90,50,0,75,18,0,258
Jordan Rinaldi,25,90,130,0,0,12,0,257
Fredy Serrano,200,0,25,0,25,7,0,257
Shannon Gugerty,0,255,0,0,0,2,0,257
Falaniko Vitale,225,0,25,0,0,7,0,257
Yoshiyuki Yoshida,50,180,25,0,0,2,0,257
Frank Gomez,0,115,105,0,0,36,0,256
Jordan Wright,175,25,25,0,0,31,0,256
Jean Matsumoto,0,90,160,0,0,6,0,256
Dustin Kimura,0,205,50,0,0,0,0,255
Michinori Tanaka,0,0,130,0,95,30,0,255
Evan Elder,0,90,105,0,0,59,0,254
Lyle Beerbohm,0,115,25,0,70,44,0,254
Sam Hoger,0,90,130,0,25,9,0,254
Mikey Burnett,100,0,80,0,25,49,0,254
Nora Cornolle,100,0,80,0,25,47,0,252
David Terrell,125,90,0,0,0,12,25,252
James Head,25,140,0,0,70,16,0,251
Darren Uyenoyama,25,90,105,0,25,6,0,251
Blake Bilder,0,90,130,0,0,31,0,251
Andy Ologun,100,25,80,0,0,45,0,250
Jesse Taylor,0,230,0,0,0,20,0,250
Norifumi Yamamoto,100,25,75,0,25,25,0,250
Kayla Harrison,0,90,80,0,0,80,0,250
Morgan Charriere,200,0,0,0,25,25,0,250
Jake Rosholt,100,140,0,0,0,9,0,249
Daniel Santos,100,0,105,0,0,44,0,249
Loik Radzhabov,125,0,105,0,0,19,0,249
Will Campuzano,25,50,155,0,0,18,0,248
Danny Henry,0,140,80,0,0,28,0,248
Mallory Martin,0,140,105,0,0,3,0,248
Aisling Daly,0,90,105,0,0,53,0,248
Yohan Lainesse,125,50,0,0,70,3,0,248
James Wilks,25,90,105,0,0,27,0,247
Rory Singer,50,90,80,0,0,27,0,247
Sergey Khandozhko,100,0,105,0,0,41,0,246
Wu Yanan,25,90,75,0,25,31,0,246
Herschel Walker,200,0,0,0,0,46,0,246
Nathan Coy,25,50,80,0,25,65,0,245
John Maguire,0,90,155,0,0,0,0,245
Ketlen Souza,0,115,80,0,0,49,0,244
Thibault Gouti,125,50,50,0,0,19,0,244
Jessamyn Duke,25,0,130,0,0,89,0,244
Baergeng Jieleyisi,0,90,105,0,25,23,0,243
Cristian Quinonez,100,50,80,0,0,13,0,243
Charlie Campbell,125,0,80,0,0,37,0,242
Rogerio Bontorin,25,90,25,0,95,7,0,242
Danielle Taylor,0,0,130,0,95,17,0,242
Mana Martinez,0,25,25,25,140,26,0,241
Kalib Starnes,25,90,105,0,0,21,0,241
Che Mills,225,0,0,0,0,16,0,241
Fredson Paixao,25,90,50,0,70,5,0,240
Elvis Sinosic,75,90,50,0,0,0,25,240
Ivan Jorge,0,25,185,0,0,30,0,240
William Macario,50,25,80,0,0,85,0,240
Saidyokub Kakhramonov,0,115,80,0,0,45,0,240
Marcelo Guimaraes,50,0,0,0,140,50,0,240
Paulo Cesar Silva,100,140,0,0,0,0,0,240
Nursulton Ruziboev,200,0,25,0,0,14,0,239
Trey Waters,0,25,160,0,0,54,0,239
Shane Campbell,50,25,105,0,0,59,0,239
Martin Bravo,150,0,0,0,25,64,0,239
Gerard Gordeau,200,25,0,0,0,14,0,239
Jiniushiyue,125,0,80,0,0,33,0,238
Magomed Gadzhiyasulov,0,0,105,75,0,58,0,238
Denis Tiuliulin,150,50,25,0,0,13,0,238
JP Buys,100,90,25,0,0,22,0,237
Timur Valiev,0,0,105,75,0,57,0,237
David Heath,25,115,25,0,70,1,0,236
Melissa Mullins,125,0,80,0,0,30,0,235
Jason DeLucia,25,205,0,0,0,5,0,235
Laverne Clark,100,25,0,75,0,33,0,233
Danilo Marques,50,90,80,0,0,13,0,233
Juan Espino,0,180,0,0,25,28,0,233
Brendson Ribeiro,125,0,0,25,70,12,0,232
Sheymon Moraes,25,25,105,0,70,7,0,232
Bea Malecki,25,90,80,0,0,37,0,232
Tiago dos Santos e Silva,25,0,105,0,70,32,0,232
Tresean Gore,25,180,25,0,0,1,0,231
Oumar Sy,0,90,80,0,0,61,0,231
Abubakar Nurmagomedov,0,25,160,0,25,21,0,231
Roman Zentsov,200,25,0,0,0,6,0,231
Johnny Rhodes,100,115,0,0,0,16,0,231
Eric Esch,100,115,0,0,0,16,0,231
Steve Jennum,100,115,0,0,0,16,0,231
Aleksandra Albu,0,115,80,0,25,10,0,230
Edgar Garcia,125,50,0,0,25,30,0,230
Diego Rivas,100,0,130,0,0,0,0,230
Andy Ogle,25,25,130,0,25,25,0,230
Anshul Jubli,125,0,0,0,70,35,0,230
James Llontop,0,25,105,0,25,75,0,230
Mike Wilkinson,100,25,105,0,0,0,0,230
Akitoshi Tamura,0,25,80,0,25,100,0,230
John Phillips,100,75,25,0,25,4,0,229
Hirotaka Yokoi,75,115,0,0,0,38,0,228
Masanori Kanehara,0,25,160,0,25,18,0,228
Chris Wilson,0,25,105,0,25,73,0,228
Seth Petruzelli,125,50,25,0,0,27,0,227
Valentijn Overeem,50,165,0,0,0,12,0,227
Jessica Aguilar,0,25,155,0,0,47,0,227
Lumumba Sayers,100,115,0,0,0,12,0,227
Chris Kelades,0,25,105,0,70,27,0,227
Jason Day,175,0,0,0,0,26,25,226
Rafael Estevam,100,0,80,0,0,45,0,225
Alexander Munoz,0,0,185,0,25,15,0,225
Hiroshi Izumi,125,0,80,0,0,20,0,225
Akira Corassani,75,0,80,0,70,0,0,225
Chance Rencountre,25,90,105,0,0,4,0,224
Austin Arnett,25,0,155,0,0,44,0,224
Zhu Kangjie,0,0,80,0,70,74,0,224
Sarah Frota,125,0,0,0,25,74,0,224
John Albert,100,100,0,0,0,24,0,224
Bryan Baker,100,0,25,0,70,28,0,223
Zac Pauga,50,0,105,0,0,68,0,223
Andrew Holbrook,75,0,0,0,140,8,0,223
Ramon Taveras,125,0,25,0,70,3,0,223
Antonio Carvalho,125,0,25,0,70,3,0,223
Toshiomi Kazama,50,90,80,0,0,3,0,223
Ernesta Kareckaite,0,0,25,0,140,58,0,223
Victor Hugo,0,90,105,0,0,27,0,222
Daermisi Zhawupasi,25,90,80,0,25,2,0,222
Shane Nelson,100,0,50,0,70,1,0,221
Francisco Figueiredo,0,115,105,0,0,1,0,221
Jeff Hughes,100,25,25,0,25,45,0,220
Daniel Gracie,0,90,25,0,70,35,0,220
Phillipe Nover,25,0,75,0,120,0,0,220
Guram Kutateladze,25,0,80,0,95,20,0,220
Ariane Carnelossi,100,90,25,0,0,5,0,220
Estevan Payan,50,0,105,0,0,64,0,219
Steve Bosse,125,0,80,0,0,13,0,218
Jarred Brooks,25,0,0,0,165,28,0,218
Yanal Ashmouz,100,0,105,0,0,13,0,218
Satoshi Ishii,25,0,185,0,0,8,0,218
Mike Santiago,125,25,25,0,0,42,0,217
Jamey-Lyn Horth,0,0,105,0,95,17,0,217
Carmelo Marrero,0,50,25,0,140,0,0,215
Thomas Petersen,0,90,105,0,0,20,0,215
Mario Miranda,125,0,50,0,0,40,0,215
Dustin Pague,50,90,25,0,50,0,0,215
Bruno Lopes,125,0,80,0,0,9,0,214
Nazim Sadykhov,100,90,0,0,0,24,0,214
Nick Thompson,50,25,80,0,0,34,25,214
Marvin Eastman,100,25,80,0,0,9,0,214
Kiichi Kunimoto,0,115,0,0,95,4,0,214
Saparbeg Safarov,25,50,80,0,0,59,0,214
Igor Araujo,25,0,185,0,0,3,0,213
Pingyuan Liu,25,0,80,0,95,13,0,213
Jerome Rivera,50,25,105,0,0,32,0,212
Mike Breeden,150,0,50,0,0,12,0,212
Dave Terrel,125,0,80,0,0,7,0,212
Casey Olson,0,90,80,0,0,42,0,212
Myktybek Orolbai,0,90,80,0,25,17,0,212
Gabriella Fernandes,0,90,50,0,70,2,0,212
Serhiy Sidey,100,0,0,0,95,17,0,212
Oluwale Bamgbose,175,0,25,0,0,12,0,212
Bobby Voelker,125,0,75,0,0,11,0,211
Luke Jumeau,0,0,185,0,25,0,0,210
Jordan Williams,125,25,25,0,25,10,0,210
Justin McCully,0,25,185,0,0,0,0,210
Adam Wieczorek,0,90,105,0,0,14,0,209
Leonardo Mafra,50,25,80,0,0,54,0,209
Reuben Duran,25,90,25,0,25,44,0,209
Genki Sudo,0,180,25,0,0,4,0,209
Qiu Lun,0,0,130,0,0,78,0,208
Dan Bobish,75,115,0,0,0,17,0,207
Don Madge,100,0,80,0,0,27,0,207
Mike Guymon,0,75,80,0,0,52,0,207
Felipe Silva,125,25,0,0,0,56,0,206
Henry Miller,150,25,25,0,0,6,0,206
Khalid Taha,125,0,75,0,0,5,0,205
Tom Duquesnoy,100,0,80,0,25,0,0,205
Christian Morecraft,75,90,0,0,0,39,0,204
Zhang Lipeng,0,0,130,0,70,4,0,204
Waylon Lowe,25,25,80,0,70,3,0,203
Satoshi Honma,125,0,25,0,0,53,0,203
Luan Chagas,25,115,0,0,0,63,0,203
Maria Oliveira,25,0,75,0,70,32,0,202
Fernie Garcia,125,0,75,0,0,2,0,202
Daniel Teymur,25,50,105,0,0,22,0,202
Junior Albini,150,25,25,0,0,2,0,202
Trevin Jones,100,25,75,0,0,2,0,202
Nyamjargal Tumendemberel,0,90,0,0,95,17,0,202
Shanna Young,125,25,50,0,0,1,0,201
MarQuel Mederos,100,0,80,0,0,21,0,201
Felipe Lima,0,90,80,0,0,31,0,201
Kevin Casey,100,0,80,0,0,21,0,201
Kaiwen,100,0,80,0,0,21,0,201
Kazula Vargas,0,25,105,0,0,71,0,201
Viviane Pereira,0,0,130,0,70,0,0,200
Tim Hague,50,90,25,25,0,10,0,200
Joachim Christensen,125,50,0,0,0,25,0,200
Journey Newson,25,25,130,0,0,20,0,200
Ike Villanueva,200,0,0,0,0,0,0,200
Nate Mohr,25,50,80,0,0,44,0,199
Justin Wilcox,0,25,80,0,25,69,0,199
Cody Donovan,175,0,0,0,0,24,0,199
Renee Forte,25,25,105,0,0,44,0,199
Alex Nicholson,125,25,25,0,0,23,0,198
Marcelo Golm,25,90,50,0,0,33,0,198
Akiyo Nishiura,100,0,50,0,25,23,0,198
Walel Watson,100,25,25,0,25,23,0,198
Viktor Pesta,50,25,105,0,0,18,0,198
Vinny Magalhaes,50,90,50,0,0,7,0,197
Sean Soriano,0,75,50,0,0,72,0,197
Martin Day,25,25,50,0,25,72,0,197
Mark Eddiva,25,25,80,0,25,42,0,197
Jarno Errens,0,25,130,0,0,42,0,197
Lucas Alexander,25,25,80,0,0,66,0,196
Alvin Robinson,25,50,80,0,0,41,0,196
Zarrukh Adashev,50,0,105,0,0,41,0,196
Willie Gates,125,50,0,0,0,21,0,196
Dione Barbosa,0,90,105,0,0,1,0,196
Frankie Perez,125,0,50,0,0,21,0,196
David Mitchell,25,0,155,0,0,15,0,195
Fabricio Camoes,0,165,25,0,0,5,0,195
Mike Whitehead,25,0,130,0,0,15,25,195
Ronaldo Rodriguez,0,90,105,0,0,0,0,195
Danny Martinez,0,0,180,0,0,14,0,194
Rickson Gracie,0,180,0,0,0,14,0,194
Vinicius Moreira,75,115,0,0,0,4,0,194
Wesley Correira,175,0,0,0,0,18,0,193
Aliaskhab Khizriev,0,180,0,0,0,13,0,193
Vik Grujic,125,0,50,0,0,18,0,193
James McSweeney,150,0,0,0,0,42,0,192
Eddie Gordon,125,25,0,0,25,17,0,192
Brok Weaver,0,50,80,0,0,62,0,192
Darko Stosic,100,0,75,0,0,15,0,190
Samandar Murodov,0,90,80,0,0,20,0,190
Aalon Cruz,150,0,0,0,0,40,0,190
David Zawada,25,90,25,0,50,0,0,190
Alex Chambers,0,165,25,0,0,0,0,190
Henry Briones,25,115,50,0,0,0,0,190
Bibulatov Magomed,25,0,80,0,25,59,0,189
Clay Collard,25,0,105,0,25,34,0,189
Deividas Taurosevicius,0,0,80,25,70,14,0,189
Jonny Parsons,100,0,0,0,70,19,0,189
Yui Chul Nam,0,0,0,0,120,69,0,189
Yousri Belgaroui,100,0,25,0,0,64,0,189
Reinier de Ridder,0,180,0,0,0,9,0,189
Corey Hill,125,25,0,0,0,39,0,189
Thiago Perpetuo,125,25,0,0,0,39,0,189
Tainara Lisboa,0,90,80,0,0,19,0,189
Silvana Gomez Juarez,100,50,25,0,0,13,0,188
Jeremy Kimball,150,25,0,0,0,13,0,188
Emil Meek,0,0,155,0,0,33,0,188
Carlos Candelario,0,25,105,0,25,33,0,188
Mark Weir,150,25,0,0,0,13,0,188
Dan Argueta,0,25,130,0,0,33,0,188
Poppies Martinez,0,180,0,0,0,7,0,187
Albert Morales,25,25,50,0,70,17,0,187
Justin Jaynes,125,25,0,0,25,12,0,187
Vinicius Salvador,125,0,50,0,0,12,0,187
Mike Grundy,100,25,25,0,25,11,0,186
Luigi Vendramini,150,0,0,25,0,11,0,186
Devin Powell,100,0,50,0,25,11,0,186
Jeff Hougland,25,0,130,0,0,30,0,185
Geraldo de Freitas,0,0,80,0,50,55,0,185
Chris de la Rocha,175,0,0,0,0,10,0,185
Gilbert Urbina,125,25,0,0,0,35,0,185
Syuri Kondo,25,0,50,0,70,40,0,185
Nicco Montano,0,0,105,0,0,54,25,184
Mizuki,0,0,105,0,70,8,0,183
Charalampos Grigoriou,100,25,25,0,0,33,0,183
Hong Man Choi,125,50,0,0,0,8,0,183
Anton Turkalj,50,25,105,0,0,2,0,182
Elizabeth Phillips,0,0,105,0,50,27,0,182
Michael Kuiper,100,50,25,0,0,7,0,182
Sheldon Westcott,125,0,25,0,0,32,0,182
Jenel Lausa,0,25,130,0,0,27,0,182
Gesias Cavalcante,0,0,75,0,95,12,0,182
Caolan Loughran,0,0,130,0,0,52,0,182
Justin Levens,150,25,0,0,0,5,0,180
Wagner da Conceicao Martins,125,50,0,0,0,5,0,180
Zachary Micklewright,50,0,80,0,0,50,0,180
Shohei Nose,125,0,25,0,25,5,0,180
Mateus Mendonca,125,0,25,0,25,5,0,180
Kay Hansen,0,90,75,0,0,15,0,180
Daniel Spitz,125,0,50,0,0,5,0,180
Matt Dwyer,125,0,50,0,0,5,0,180
Wallid Ismail,25,90,50,0,0,15,0,180
Ralek Gracie,0,90,80,0,0,10,0,180
Jonathan Wilson,125,0,50,0,0,4,0,179
Humberto Bandenay,125,0,50,0,0,4,0,179
Kyle Bradley,150,0,25,0,0,4,0,179
Chris Spang,100,0,50,0,0,29,0,179
David Bielkheden,25,25,105,0,0,24,0,179
Tamires Vidal,125,25,0,0,25,4,0,179
Allen Crowder,150,0,0,0,0,28,0,178
Talita Bernardo,50,0,105,0,0,23,0,178
Branden Lee Hinkle,125,25,0,0,0,27,0,177
Josh Quinlan,125,0,25,0,25,2,0,177
Mark Hall,125,50,0,0,0,2,0,177
Alvaro Herrera Mendoza,125,50,0,0,0,2,0,177
Augusto Montano,125,0,25,0,0,27,0,177
Mario Sousa,25,25,80,0,0,47,0,177
Tokimitsu Ishizawa,150,25,0,0,0,2,0,177
Cristiano Marcello,25,0,75,0,70,6,0,176
Abdul-Kerim Edilov,100,0,0,0,0,76,0,176
Sasha Palatnikov,100,50,0,0,0,26,0,176
Yoshiki Takahashi,75,0,80,0,0,21,0,176
Royston Wee,25,0,80,0,70,0,0,175
Josh Sampo,0,115,50,0,0,10,0,175
Sultan Aliev,25,0,80,0,70,0,0,175
Goran Reljic,100,0,50,0,25,0,0,175
Genaro Valdez,125,0,50,0,0,0,0,175
Yusaku Kinoshita,150,0,0,0,0,25,0,175
Pawel Nastula,25,140,0,0,0,10,0,175
Marcin Held,25,0,105,0,25,20,0,175
Geane Herrera,100,0,75,0,0,0,0,175
Jason Black,100,50,0,0,25,0,0,175
Rob Broughton,0,90,50,0,0,35,0,175
Francisco Prado,100,0,50,0,0,24,0,174
Kevin Borjas,25,0,105,0,0,44,0,174
Danny Downes,0,25,130,0,0,19,0,174
Juliana Miller,125,0,25,0,0,24,0,174
Jason Gonzalez,25,140,0,0,0,9,0,174
Mark Godbeer,0,50,80,0,0,43,0,173
Jon Delos Reyes,25,140,0,0,0,8,0,173
Renato Verissimo,50,0,105,0,0,18,0,173
Tiki Ghosn,50,100,0,0,0,23,0,173
Tony Sims,100,25,25,0,0,22,0,172
Chris Fishgold,25,115,25,0,0,7,0,172
Richie Vaculik,50,0,105,0,0,16,0,171
Chris Holdsworth,0,90,80,0,0,1,0,171
Coty Wheeler,25,90,50,0,0,6,0,171
Teemu Packalen,50,90,25,0,0,6,0,171
Phillip Miller,0,90,80,0,0,1,0,171
Top Noi Kiwram,0,25,80,0,25,41,0,171
Michael Graves,0,90,80,0,0,1,0,171
Justin Lawrence,125,25,0,0,0,21,0,171
Cory Devela,125,25,0,0,0,20,0,170
Patrick Williams,50,90,25,0,0,5,0,170
Seo Hee Ham,0,0,130,0,25,15,0,170
Edgar Chairez,0,90,75,0,0,5,0,170
Jason Young,25,0,130,0,0,15,0,170
Tor Troeng,0,90,75,0,0,4,0,169
Bobby Moffett,0,90,25,0,25,29,0,169
Adam Milstead,125,0,0,0,25,19,0,169
Shamar Bailey,25,0,130,0,0,14,0,169
Jesse Lennox,100,25,0,0,25,18,0,168
Spike Carlyle,100,0,50,0,0,18,0,168
Kaue Fernandes,100,0,0,0,25,43,0,168
Miranda Granger,0,50,105,0,0,13,0,168
Jessin Ayari,25,0,50,0,70,23,0,168
Vagner Rocha,25,115,25,0,0,3,0,168
Mike Budnik,0,115,25,0,25,3,0,168
HanSeul Kim,25,90,25,0,0,27,0,167
Justin Gonzales,0,0,80,0,0,87,0,167
Eduardo Garagorri,0,50,80,0,0,37,0,167
Guto Inocente,25,25,80,0,0,37,0,167
Vanessa Melo,0,0,155,0,0,12,0,167
Anderson Dos Santos,25,90,50,0,0,2,0,167
Nick Pace,0,90,75,0,0,2,0,167
Alex Hunter,0,90,0,0,70,6,0,166
Rachael Ostovich,25,140,0,0,0,1,0,166
Abu Azaitar,25,0,105,0,0,36,0,166
Jake Hecht,100,25,25,0,0,16,0,166
Cody Haddon,0,0,80,0,0,86,0,166
Collin Anglin,50,0,80,0,0,36,0,166
Dave Strasser,0,50,80,0,0,36,0,166
Louis Gaudinot,25,90,50,0,0,0,0,165
Gabriel Santos,25,0,80,0,25,35,0,165
Crafton Wallace,100,50,0,0,0,15,0,165
Darrius Flowers,0,140,25,0,0,0,0,165
Marcio Alexandre Junior,0,115,25,0,25,0,0,165
Abongo Humphrey,25,115,25,0,0,0,0,165
Kron Gracie,25,90,50,0,0,0,0,165
Dan Lauzon,25,115,25,0,0,0,0,165
Ben Askren,25,115,0,0,0,0,25,165
Jason Dent,0,115,50,0,0,0,0,165
Mike Rio,25,140,0,0,0,0,0,165
Justin Buchholz,0,140,25,0,0,0,0,165
Peter Barrett,0,25,105,0,0,34,0,164
Gil Castillo,0,0,105,0,0,9,50,164
Stanislav Nedkov,125,25,0,0,0,14,0,164
Kevin Syler,0,0,105,0,0,59,0,164
Ben Alloway,100,25,25,0,0,13,0,163
Andreas Michailidis,50,0,105,0,0,8,0,163
Kamuela Kirk,25,25,105,0,0,8,0,163
Reginaldo Vieira,0,25,105,0,0,33,0,163
Robelis Despaigne,100,0,50,0,0,13,0,163
Francisco Trevino,25,0,105,0,0,33,0,163
Brandon Visher,125,0,25,0,0,13,0,163
Jan Nortje,125,25,0,0,0,12,0,162
Pete Rodriguez,150,0,0,0,0,12,0,162
Ricardo Morais,125,0,25,0,0,12,0,162
Erik Silva,125,25,0,0,0,12,0,162
Tristan Connelly,0,0,130,0,0,32,0,162
Marcel Fortuna,100,0,50,0,0,12,0,162
Wang Cong,100,25,0,0,0,37,0,162
Robert McDaniel,0,115,25,0,0,21,0,161
Jonathan Meunier,0,25,80,0,0,56,0,161
Louis Cosce,125,0,25,0,0,11,0,161
Victor Martinez,50,0,80,0,0,31,0,161
Marcos Vinicius,150,0,0,0,0,11,0,161
Rashad Coulter,75,0,80,0,0,6,0,161
Colton Smith,25,50,80,0,0,6,0,161
Maria Silva,0,0,105,0,0,56,0,161
Daiki Hata,0,0,130,0,0,30,0,160
Eiji Mitsuoka,50,25,80,0,0,5,0,160
Cal Worsham,150,0,0,0,0,10,0,160
Harold Howard,150,0,0,0,0,9,0,159
Kevin Vallejos,100,0,25,0,0,34,0,159
Brendan O'Reilly,25,0,130,0,0,4,0,159
Issei Tamura,150,0,0,0,0,9,0,159
John Gunderson,0,0,130,0,0,29,0,159
Pedro Falcao,100,0,25,0,0,34,0,159
Joseph Morales,25,90,0,0,25,18,0,158
Phil Harris,25,25,105,0,0,3,0,158
Taiei Kin,25,25,80,0,0,28,0,158
Egan Inoue,125,0,25,0,0,8,0,158
Alex Da Silva,0,25,105,25,0,2,0,157
Danny Silva,0,0,80,0,70,7,0,157
Abel Cullum,0,50,80,0,0,27,0,157
Christian Aguilera,100,50,0,0,0,6,0,156
Jamie Moyle,0,0,130,0,0,26,0,156
Anton Kuivanen,0,25,25,0,70,36,0,156
Gasan Umalatov,0,0,130,0,25,0,0,155
Kazuki Tokudome,0,25,105,0,25,0,0,155
Rafael Rebello,0,90,25,0,25,15,0,155
Anthony Figueroa,100,25,25,0,0,5,0,155
Cody Pfister,0,50,105,0,0,0,0,155
Valmir Lazaro,0,0,25,0,95,35,0,155
Matt Hobar,25,0,105,0,0,25,0,155
Montserrat Conejo Ruiz,75,0,80,0,0,0,0,155
Papy Abedi,25,50,0,0,70,10,0,155
Rolando Delgado,25,90,25,0,0,14,0,154
Brianna Fortino,0,0,105,0,0,49,0,154
Yao Zhikui,25,0,25,0,95,9,0,154
Connor Matthews,25,0,105,0,0,23,0,153
Ian Loveland,0,0,105,0,25,23,0,153
Cole Smith,0,0,105,0,25,23,0,153
Ivana Petrovic,0,90,25,0,25,12,0,152
Chris Dempsey,75,0,0,0,70,7,0,152
Lu Kai,150,0,0,0,0,2,0,152
Tommy Speer,125,25,0,0,0,2,0,152
Sherron Leggett,125,0,0,0,0,26,0,151
Simeon Thoresen,25,90,25,0,0,11,0,151
Te Edwards,125,0,25,0,0,1,0,151
Erick Montano,25,25,0,0,70,31,0,151
Kaynan Kruschewsky,25,90,25,0,0,10,0,150
Dale Hartt,100,50,0,0,0,0,0,150
Daichi Abe,0,0,130,0,0,20,0,150
Andrei Semenov,125,0,25,0,0,0,0,150
Chris Tuchscherer,75,0,0,75,0,0,0,150
James Terry,100,0,25,0,25,0,0,150
Matt Veach,100,50,0,0,0,0,0,150
Rory Markham,150,0,0,0,0,0,0,150
Tonya Evinger,50,25,50,0,0,0,25,150
Kyle Stewart,100,25,25,0,0,0,0,150
Nate Moore,125,25,0,0,0,0,0,150
John Salter,125,25,0,0,0,0,0,150
Keisuke Sasu,25,25,80,0,0,20,0,150
Naoyuki Kotani,75,25,50,0,0,0,0,150
Gustavo Lopez,25,90,25,0,0,9,0,149
Greg Soto,0,25,80,0,0,44,0,149
Tom Niinimaki,0,75,0,0,70,4,0,149
Chris Cope,50,0,80,0,0,19,0,149
Gadzhi Omargadzhiev,0,90,50,0,0,8,0,148
Per Eklund,25,90,25,0,0,8,0,148
Rob MacDonald,0,140,0,0,0,7,0,147
Luke Zachrich,25,25,80,0,0,17,0,147
Steve Steinbeiss,0,25,25,0,25,72,0,147
Akbarh Arreola,0,90,50,0,0,7,0,147
Ricky Palacios,0,0,80,0,0,67,0,147
Satoru Kitaoka,25,0,25,0,70,0,25,145
Gokhan Saki,125,0,0,0,0,20,0,145
Alptekin Ozkilic,50,0,25,0,70,0,0,145
Sarah Alpar,25,90,25,0,0,5,0,145
Darrell Horcher,25,25,25,0,70,0,0,145
Glaico Franca Moreira,0,90,50,0,0,5,0,145
Bobby Lashley,125,0,0,0,0,19,0,144
Jesse Ronson,25,25,0,0,75,19,0,144
Khalid Murtazaliev,100,0,0,0,0,44,0,144
Conor Heun,25,0,80,0,25,14,0,144
Igor Severino,100,0,0,0,0,44,0,144
Seth Dikun,0,90,50,0,0,3,0,143
Mike Ricci,0,0,105,0,25,13,0,143
Pawel Pawlak,0,0,130,0,0,13,0,143
Tim McKenzie,25,115,0,0,0,3,0,143
Matt Arroyo,25,90,0,0,25,3,0,143
Drako Rodriguez,25,90,25,0,0,2,0,142
Bassil Hafez,25,0,80,0,25,12,0,142
Mark Climaco,0,0,105,0,0,37,0,142
Will Kerr,50,90,0,0,0,2,0,142
Robert Sanchez,0,115,0,0,25,1,0,141
Cameron Smotherman,25,0,80,0,0,36,0,141
Niklas Backstrom,25,90,0,25,0,1,0,141
Kyle Watson,25,0,80,0,0,36,0,141
Gabriel Miranda,50,90,0,0,0,1,0,141
Joe Pearson,25,90,0,0,0,1,25,141
Edson Berto,50,90,0,0,0,1,0,141
Masakatsu Funaki,25,115,0,0,0,1,0,141
Antonio Braga Neto,25,90,0,0,25,1,0,141
Dylan Budka,25,0,105,0,0,11,0,141
Cortavious Romious,25,0,105,0,0,11,0,141
Charles McCarthy,50,90,0,0,0,0,0,140
Steve Bruno,0,90,50,0,0,0,0,140
Hector Urbina,25,90,25,0,0,0,0,140
Liana Jojua,25,90,25,0,0,0,0,140
Ricardo Romero,50,90,0,0,0,0,0,140
Felipe dos Santos,0,0,50,0,70,20,0,140
Westin Wilson,50,90,0,0,0,0,0,140
Mandy Bohm,0,0,50,0,70,20,0,140
Ian Entwistle,50,90,0,0,0,0,0,140
Domingo Pilarte,0,90,25,0,25,0,0,140
Sean McCorkle,25,115,0,0,0,0,0,140
Maciej Jewtuszko,100,0,25,0,0,15,0,140
Luis Pajuelo,100,25,0,0,0,15,0,140
Carlos Eduardo Rocha,0,90,25,0,25,0,0,140
Rolando Dy,25,0,105,0,0,9,0,139
Josh Stansbury,25,0,25,75,0,14,0,139
Istela Nunes,50,25,0,25,0,39,0,139
Fatima Kline,100,0,25,0,0,14,0,139
Mason Jones,0,0,130,0,0,9,0,139
Karen Darabedyan,0,50,0,0,70,19,0,139
Clifford Starks,25,25,80,0,0,8,0,138
Mickael Lebout,0,0,130,0,0,8,0,138
Klidson Abreu,0,0,105,0,25,8,0,138
Daria Zhelezniakova,0,25,80,0,0,32,0,137
Marcus LeVesseur,25,25,0,0,70,17,0,137
Carlos Barreto,0,0,130,0,0,7,0,137
Katsuhiko Nagata,25,25,80,0,0,7,0,137
Nadia Kassem,25,25,80,0,0,7,0,137
Naoki Inoue,0,0,80,0,25,32,0,137
Takashi Sugiura,100,0,0,0,25,12,0,137
Sam Spengler,125,0,0,0,0,11,0,136
Rafael Dias,25,0,105,0,0,6,0,136
Danny Chavez,25,0,105,0,0,6,0,136
Brian Melancon,100,25,0,0,0,11,0,136
John Lewis,125,0,0,0,0,11,0,136
Dwayne Cason,100,25,0,0,0,10,0,135
Yoshihiro Nakao,0,90,25,0,0,20,0,135
Kazuhiro Hamanaka,25,0,80,0,0,30,0,135
Troy Mandaloniz,100,0,25,0,0,10,0,135
Chad George,0,25,105,0,0,5,0,135
Clay Harvison,25,25,0,0,70,15,0,135
Raphael Pessoa,25,25,80,0,0,5,0,135
Yan Qihui,0,25,25,0,70,15,0,135
Julie Kedzie,0,25,25,0,50,35,0,135
Junie Browning,0,115,0,0,0,19,0,134
Brad Kohler,100,25,0,0,0,9,0,134
Roger Narvaez,50,0,0,0,70,14,0,134
Francisco Bueno,125,0,0,0,0,9,0,134
Hans Stringer,50,0,0,0,70,13,0,133
Jarjis Danho,100,0,0,25,0,8,0,133
Nick Denis,100,25,0,0,0,8,0,133
Mike Nickels,0,115,0,0,0,18,0,133
Dave Jansen,0,0,130,0,0,2,0,132
SangWon Kim,100,0,25,0,0,7,0,132
Shinsho Anzai,25,25,80,0,0,2,0,132
Sai Wang,0,0,80,0,25,27,0,132
David Michaud,0,25,80,0,25,2,0,132
KyeungPyo Kim,100,0,0,0,25,7,0,132
Galore Bofando,125,0,0,0,0,7,0,132
Lance Gibson,125,0,0,0,0,6,0,131
Orlando Wiet,125,0,0,0,0,6,0,131
Ricardo Abreu,0,90,0,0,25,16,0,131
Mike Hayes,0,0,80,0,0,51,0,131
Rolando Bedoya,0,0,50,0,25,56,0,131
Julia Budd,25,25,80,0,0,1,0,131
Peter Danesoe,100,25,0,0,0,6,0,131
Carl Malenko,0,25,105,0,0,1,0,131
Daniel Spohn,0,90,25,0,0,15,0,130
Curt Warburton,0,25,105,0,0,0,0,130
Travis Fulton,0,25,80,0,0,25,0,130
John Franchi,0,25,25,0,70,10,0,130
Heather Clark,0,0,130,0,0,0,0,130
Lara Procopio,0,25,80,0,25,0,0,130
Cole Province,25,0,105,0,0,0,0,130
Mads Burnell,0,50,80,0,0,0,0,130
Daniel Barez,0,25,80,0,25,0,0,130
Timmy Cuamba,0,0,105,0,25,0,0,130
Yusup Saadulaev,100,0,25,0,0,5,0,130
Boston Salmon,50,0,80,0,0,0,0,130
Kai Kamaka,25,0,80,0,25,0,0,130
Callan Potter,50,0,80,0,0,0,0,130
Jerome LeBanner,100,0,25,0,0,5,0,130
Dan Christison,0,90,25,0,0,15,0,130
Shamil Gamzatov,25,0,0,0,70,35,0,130
Patrick Kaase,100,0,0,0,0,29,0,129
Carlo Pedersoli Jr.,50,0,0,0,70,9,0,129
Kevin Rosier,125,0,0,0,0,3,0,128
Jeremiah Metcalf,0,115,0,0,0,13,0,128
Tom Murphy,100,0,0,0,0,28,0,128
Julius Anglickas,0,90,0,0,0,37,0,127
Koya Kanda,0,0,105,0,0,22,0,127
Azunna Anyanwu,100,0,0,0,25,1,0,126
Mansur Abdul-Malik,100,0,0,0,0,26,0,126
Austin Springer,0,115,0,0,0,11,0,126
Sam Oropeza,100,0,0,0,0,26,0,126
Bertrand Amoussou,100,0,0,0,0,26,0,126
Navajo Stirling,0,0,80,0,0,46,0,126
Brendan Loughnane,0,0,105,0,0,21,0,126
Tedd Williams,100,0,25,0,0,0,0,125
Jonathan Wiezorek,100,25,0,0,0,0,0,125
Carlo Prater,25,25,25,0,25,0,25,125
Shayna Baszler,75,0,50,0,0,0,0,125
Daniel Lacerda,75,50,0,0,0,0,0,125
Lucas Rocha,100,25,0,0,0,0,0,125
Andre Roberts,125,0,0,0,0,0,0,125
Kazuki Okubo,0,90,25,0,0,10,0,125
Jose Torres,125,0,0,0,0,0,0,125
War Machine,100,25,0,0,0,0,0,125
Sammy Morgan,100,0,25,0,0,0,0,125
SangHoon Yoo,100,0,25,0,0,0,0,125
Mike Cook,100,25,0,0,0,0,0,125
Masio Fullen,0,25,25,0,70,5,0,125
Taiyilake Nueraji,100,0,0,0,0,24,0,124
Irina Alekseeva,0,90,25,0,0,9,0,124
Keith Rockel,0,115,0,0,0,9,0,124
Royler Gracie,0,115,0,0,0,8,0,123
Blood Diamond,0,25,50,0,0,47,0,122
Ernest Chavez,25,25,0,0,70,2,0,122
Sherrard Blackledge,0,0,105,0,0,17,0,122
Augusto Mendes,25,0,25,0,70,2,0,122
Jay Perrin,0,25,75,0,0,21,0,121
Ariel Gandulla,0,25,0,0,70,1,25,121
Jim Alers,25,0,0,0,95,0,0,120
Bruno Santos,0,0,50,0,70,0,0,120
Milana Dudieva,50,0,0,0,70,0,0,120
Irwin Rivera,0,0,25,0,95,0,0,120
Henry Martinez,25,0,0,0,95,0,0,120
Saimon Oliveira,25,0,25,0,70,0,0,120
Abdul-Kareem Al-Selwady,25,0,80,0,0,15,0,120
Tulio Palhares,100,0,0,0,0,20,0,120
Quinn Mulhern,25,0,25,0,70,0,0,120
Jeff Bedard,0,25,80,0,0,14,0,119
Eric Lawson,0,115,0,0,0,4,0,119
Eric Schambari,0,0,80,0,25,14,0,119
Crosley Gracie,0,90,25,0,0,4,0,119
Michael Page,0,0,105,0,0,14,0,119
Ramazan Temirov,100,0,0,0,0,19,0,119
Terrion Ware,0,0,100,0,0,18,0,118
Ray Sefo,0,115,0,0,0,3,0,118
Buddy Roberts,25,0,80,0,0,13,0,118
Todd Medina,25,90,0,0,0,3,0,118
James Lee,25,90,0,0,0,3,0,118
Geza Kalman,100,0,0,0,0,18,0,118
Kim Couture,100,0,0,0,0,17,0,117
Shelton Graves,100,0,0,0,0,17,0,117
Kazunari Murakami,25,90,0,0,0,2,0,117
Rodolfo Marques Diniz,0,0,105,0,0,11,0,116
Scott Morris,25,90,0,0,0,1,0,116
Danni McCormack,0,0,80,0,0,36,0,116
Felipe Bunes,25,90,0,0,0,0,0,115
Valter Walker,0,90,25,0,0,0,0,115
Yasuhito Namekawa,25,90,0,0,0,0,0,115
Levan Makashvili,0,0,0,0,95,20,0,115
Lee Murray,0,90,25,0,0,0,0,115
Shuya Kamikubo,0,0,0,25,70,20,0,115
Sangwook Kim,0,90,25,0,0,0,0,115
Anthony Torres,25,90,0,0,0,0,0,115
Roman Mitichyan,25,90,0,0,0,0,0,115
Ricardo Funch,25,50,25,0,0,15,0,115
Shauna Bannon,0,0,25,0,70,20,0,115
Wayne Cole,25,90,0,0,0,0,0,115
Mike Joy,0,115,0,0,0,0,0,115
Steven Graham,25,90,0,0,0,0,0,115
Ahmad Hassanzada,25,90,0,0,0,0,0,115
Jon Hess,100,0,0,0,0,15,0,115
Nicolle Caliari,0,90,0,0,25,0,0,115
Jamie Colleen,25,90,0,0,0,0,0,115
Zarah Fairn,25,25,50,0,0,15,0,115
Mike Ciesnolevicz,25,90,0,0,0,0,0,115
Nate Loughran,25,90,0,0,0,0,0,115
Michael Lombardo,0,0,105,0,0,9,0,114
Joe Moreira,0,0,105,0,0,9,0,114
Kenny Ento,0,90,0,0,0,23,0,113
Jerrel Venetiaan,0,25,0,0,70,18,0,113
Melissa Martinez,0,0,105,0,0,7,0,112
Stephanie Luciano,0,0,80,0,0,31,0,111
Jenna Castillo,100,0,0,0,0,11,0,111
Leah Letson,25,0,0,0,70,16,0,111
Chalid Arrab,0,25,80,0,0,6,0,111
Seth Kleinbeck,100,0,0,0,0,11,0,111
Romie Aram,0,0,105,0,0,5,0,110
Carlos Zevallos,100,0,0,0,0,10,0,110
Jack Nilson,100,0,0,0,0,10,0,110
Brendan Seguin,0,0,80,0,0,30,0,110
Paul Jones,0,90,0,0,0,20,0,110
Jerrod Sanders,0,25,80,0,0,5,0,110
Khadis Ibragimov,25,25,50,0,0,10,0,110
Georgi Karakhanyan,0,0,0,0,70,39,0,109
Eddy Ellis,0,0,80,0,0,28,0,108
Anthony Romero,0,0,80,0,0,28,0,108
Ramazan Kuramagomedov,0,0,0,0,70,38,0,108
Azamat Bekoev,100,0,0,0,0,8,0,108
Benardo Sopaj,25,0,80,0,0,3,0,108
Rafael Carino,100,0,0,0,0,8,0,108
Kanako Murata,0,0,105,0,0,3,0,108
Danillo Villefort,100,0,0,0,0,8,0,108
Danny Sabatello,0,0,80,0,0,28,0,108
Marcelo Mello,100,0,0,0,0,7,0,107
Keith Wisniewski,0,25,50,0,25,7,0,107
Jesus Pinedo,0,0,105,0,0,2,0,107
Rex Richards,100,0,0,0,0,7,0,107
Ron Stallings,0,0,80,0,0,27,0,107
Tadao Yasuda,0,0,0,0,70,37,0,107
Karolina Wojcik,0,0,80,0,0,27,0,107
Joe Slick,100,0,0,0,0,6,0,106
Daniel Allen,0,0,80,0,0,26,0,106
Darian Weeks,0,0,50,0,25,31,0,106
Sirwan Kakai,0,0,80,0,25,0,0,105
Takeshi Yamazaki,0,0,105,0,0,0,0,105
Ralph Gracie,25,0,80,0,0,0,0,105
Jonas Bilharinho,100,0,0,0,0,5,0,105
Matt Ricehouse,0,0,105,0,0,0,0,105
Patrick Walsh,0,0,105,0,0,0,0,105
JJ Okanovich,0,0,80,0,0,25,0,105
Danyelle Wolf,0,0,105,0,0,0,0,105
Jacobe Smith,100,0,0,0,0,5,0,105
Erisson Ferreira,0,25,80,0,0,0,0,105
Tokitaka Nakanishi,0,0,105,0,0,0,0,105
Bobby Stack,0,25,80,0,0,0,0,105
Montserrat Rendon,0,0,25,0,70,9,0,104
John Polakowski,0,25,0,0,70,9,0,104
Chibwikem Onyenegecha,0,0,0,0,70,33,0,103
Dan Cramer,0,0,25,0,70,8,0,103
Hailey Cowan,0,0,25,0,70,7,0,102
Ross Pointon,0,75,0,0,0,2,25,102
Takafumi Otsuka,0,25,25,0,50,1,0,101
Fabio Cherant,50,25,25,0,0,1,0,101
Seichi Ikemoto,0,25,75,0,0,1,0,101
Thanh Le,100,0,0,0,0,1,0,101
Jodie Esquibel,0,0,100,0,0,0,0,100
Will Ribeiro,0,25,0,0,70,5,0,100
Liang Na,75,25,0,0,0,0,0,100
John Gunther,0,25,0,75,0,0,0,100
Yoji Anjo,25,50,25,0,0,0,0,100
Curtis Stout,50,25,25,0,0,0,0,100
Shannon Ross,100,0,0,0,0,0,0,100
Yosuke Nishijima,25,75,0,0,0,0,0,100
Aaron Phillips,0,25,75,0,0,0,0,100
Wulijiburen,50,0,50,0,0,0,0,100
Alen Amedovski,50,25,25,0,0,0,0,100
Jesse Forbes,50,25,0,0,25,0,0,100
Vernon White,25,25,50,0,0,0,0,100
Harry Hunsucker,100,0,0,0,0,0,0,100
Edwin DeWees,75,25,0,0,0,0,0,100
Jameel Massouh,0,0,50,0,25,25,0,100
Carli Judice,0,0,0,0,50,50,0,100
Thomas Denny,50,25,25,0,0,0,0,100
Dequan Townsend,50,0,50,0,0,0,0,100
Bryan Pardoe,50,25,0,0,0,0,25,100
Rhys McKee,25,0,50,0,25,0,0,100
Travis Wiuff,50,50,0,0,0,0,0,100
Kevin Croom,25,0,50,0,0,22,0,97
Quillan Salkilld,0,0,80,0,0,17,0,97
Maiquel Falcao,0,0,80,0,0,17,0,97
Igor Gracie,0,90,0,0,0,7,0,97
Daniel McWilliams,0,90,0,0,0,7,0,97
Yosdenis Cedeno,0,0,50,0,25,22,0,97
Kalindra Faria,0,50,0,0,25,21,0,96
Rayanne dos Santos,0,0,25,0,50,21,0,96
Donnie Liles,0,90,0,0,0,6,0,96
Joe Warren,0,25,0,0,70,0,0,95
Joe Ellenberger,25,0,0,0,70,0,0,95
Eddie Yagin,0,0,25,0,70,0,0,95
Talita Alencar,0,0,25,0,70,0,0,95
Koyomi Matsushima,0,0,0,0,95,0,0,95
Nick Ertl,25,0,0,0,70,0,0,95
Bogdan Grad,25,0,0,0,70,0,0,95
Azat Maksum,0,0,25,0,70,0,0,95
Isaiah Hill,0,90,0,0,0,4,0,94
Cameron Olson,0,0,80,0,0,14,0,94
Alan Baudot,50,0,25,0,0,19,0,94
Dmitry Sosnovskiy,0,90,0,0,0,4,0,94
Trevor Harris,0,90,0,0,0,3,0,93
Megumi Fujii,0,90,0,0,0,3,0,93
Nolan Ticman,0,0,25,0,25,43,0,93
Ken Cross,0,0,80,0,0,12,0,92
Frank Hamaker,0,90,0,0,0,2,0,92
Rulon Gardner,0,0,80,0,0,12,0,92
Zelim Imadaev,25,25,0,25,0,17,0,92
Hector Ramirez,25,0,50,0,0,17,0,92
Wang Guan,0,0,0,0,70,22,0,92
Tomoya Miyashita,0,0,80,0,0,11,0,91
Philip Perez,0,90,0,0,0,1,0,91
Jeremy Larsen,75,0,0,0,0,16,0,91
Alberto Montes,0,90,0,0,0,1,0,91
Shi Ming,0,0,80,0,0,11,0,91
Scott Bessac,0,90,0,0,0,0,0,90
Bob Cook,0,90,0,0,0,0,0,90
Chris Padilla,0,90,0,0,0,0,0,90
Ron Keslar,0,90,0,0,0,0,0,90
Koji Kitao,0,90,0,0,0,0,0,90
Collin Huckbody,0,90,0,0,0,0,0,90
Dan Molina,0,90,0,0,0,0,0,90
Scott Adams,0,90,0,0,0,0,0,90
Austin Vanderford,0,90,0,0,0,0,0,90
J.T Taylor,0,90,0,0,0,0,0,90
Takeru Uchida,0,90,0,0,0,0,0,90
Alex Gilpin,0,90,0,0,0,0,0,90
Mo Miller,0,0,80,0,0,8,0,88
Sabah Homasi,75,0,0,0,0,12,0,87
Ricky Steele,0,0,0,0,70,17,0,87
Rami Hamed,0,0,80,0,0,7,0,87
Tyrone Roberts,0,0,80,0,0,6,0,86
Denys Bondar,25,25,25,0,0,11,0,86
Yoislandy Izquierdo,0,25,25,0,0,35,0,85
Todd Moore,0,50,25,0,0,10,0,85
Jon Olav Einemo,25,0,50,0,0,10,0,85
Mark Hughes,0,0,80,0,0,5,0,85
Tony Johnson,0,0,80,0,0,5,0,85
Kevin Jordan,25,50,0,0,0,9,0,84
Alan Omer,0,25,0,0,25,34,0,84
Matt Van Buren,50,0,0,0,0,34,0,84
Marcelo Rojo,50,25,0,0,0,8,0,83
Ben Earwood,0,0,80,0,0,3,0,83
Anthony Macias,0,75,0,0,0,8,0,83
Johnny Rees,0,50,0,0,0,32,0,82
Kyle Driscoll,0,0,80,0,0,2,0,82
Hector Aldana,50,0,25,0,0,7,0,82
Puja Tomar,0,0,0,0,70,11,0,81
Joey Gomez,25,0,25,0,25,6,0,81
Kelly Faszholz,25,0,0,0,25,31,0,81
Kris McCray,0,50,0,0,25,6,0,81
Adam Antolin,0,0,0,0,70,11,0,81
Ricky Legere Jr.,0,0,80,0,0,0,0,80
Zach Skinner,0,0,80,0,0,0,0,80
Lemont Davis,0,0,80,0,0,0,0,80
Bahatebole Batebolati,0,0,80,0,0,0,0,80
Jaime Alvarez,0,0,80,0,0,0,0,80
Dwight Joseph,0,0,80,0,0,0,0,80
Sidney Outlaw,0,0,80,0,0,0,0,80
Carlton Jones,75,0,0,0,0,5,0,80
Stefan Leko,25,50,0,0,0,4,0,79
Niklas Stolze,25,25,25,0,0,4,0,79
Michael Aswell,0,0,0,0,25,53,0,78
Bobby Nash,75,0,0,0,0,3,0,78
Jake Lindsey,50,25,0,0,0,3,0,78
Tuco Tokkos,25,25,25,0,0,3,0,78
Victor Reyna,25,0,25,0,0,28,0,78
Lisa Ellis,25,50,0,0,0,2,0,77
Yuri Villefort,0,0,25,0,50,2,0,77
Jared Papazian,0,25,25,25,0,1,0,76
Lukasz Sajewski,25,25,25,0,0,1,0,76
Sean Salmon,50,25,0,0,0,1,0,76
Olivier Murad,0,0,0,0,70,6,0,76
Jumabieke Tuerxun,25,25,25,0,0,1,0,76
Antwain Britt,50,0,25,0,0,1,0,76
Josh Haynes,50,0,25,0,0,0,0,75
Andy Enz,25,0,25,0,25,0,0,75
Justin McElfresh,50,0,0,0,0,0,25,75
Jason Reinhardt,25,50,0,0,0,0,0,75
Salim Touahri,0,0,50,0,25,0,0,75
Hitomi Akano,25,0,50,0,0,0,0,75
John Allan,0,25,25,0,25,0,0,75
Chance Farrar,25,25,0,0,0,0,25,75
Damian Grabowski,50,0,25,0,0,0,0,75
Mike Rhodes,0,25,50,0,0,0,0,75
Bu-Kyung Jung,25,0,50,0,0,0,0,75
Ray Rodriguez,25,50,0,0,0,0,0,75
Dominic Waters,25,0,50,0,0,0,0,75
Ruan Potts,75,0,0,0,0,0,0,75
Roque Martinez,0,25,25,0,25,0,0,75
Dan Moret,25,0,50,0,0,0,0,75
Marnic Mann,25,0,50,0,0,0,0,75
Mostapha Al-Turk,50,0,25,0,0,0,0,75
Charlie Ontiveros,50,25,0,0,0,0,0,75
Lodune Sincaid,50,25,0,0,0,0,0,75
Kit Cope,0,50,0,0,0,0,25,75
Bill Mahood,25,50,0,0,0,0,0,75
Bojan Mihajlovic,75,0,0,0,0,0,0,75
Darrell Montague,50,0,25,0,0,0,0,75
Ryuta Sakurai,0,25,50,0,0,0,0,75
Angela Magana,25,25,25,0,0,0,0,75
Kevin Natividad,50,0,0,0,25,0,0,75
Jorge Patino,25,0,50,0,0,0,0,75
Joe Hurley,0,50,0,0,0,0,25,75
Luke Caudillo,25,0,50,0,0,0,0,75
Gabe Ruediger,50,25,0,0,0,0,0,75
Garett Whiteley,25,0,50,0,0,0,0,75
Brian Camozzi,50,25,0,0,0,0,0,75
Steve Berger,25,0,50,0,0,0,0,75
Travis Galbraith,75,0,0,0,0,0,0,75
Hu Yaozong,0,50,25,0,0,0,0,75
Jocelyn Jones-Lybarger,0,25,50,0,0,0,0,75
Brad Imes,0,25,25,0,25,0,0,75
Ramona Pascual,25,0,50,0,0,0,0,75
Bristol Marunde,50,25,0,0,0,0,0,75
Josh McDonald,0,0,0,75,0,0,0,75
Eric Wisely,0,25,50,0,0,0,0,75
Rosi Sexton,25,0,50,0,0,0,0,75
Yusuke Imamura,25,50,0,0,0,0,0,75
Iliarde Santos,50,0,25,0,0,0,0,75
Wes Sims,75,0,0,0,0,0,0,75
Matt Horwich,0,0,75,0,0,0,0,75
Dmitrii Smoliakov,50,25,0,0,0,0,0,75
Olaf Alfonso,50,0,0,0,25,0,0,75
Diego Saraiva,0,0,75,0,0,0,0,75
Andre Amado,50,0,25,0,0,0,0,75
Yoshihiro Takayama,50,25,0,0,0,0,0,75
Muhsin Corbbrey,50,0,25,0,0,0,0,75
Jacob Kilburn,0,50,25,0,0,0,0,75
Erick Gonzalez,50,25,0,0,0,0,0,75
Edward Faaloloto,50,25,0,0,0,0,0,75
Fernando Gonzalez,25,0,25,0,0,25,0,75
Paul Bradley,25,0,25,0,25,0,0,75
Hiromitsu Kanehara,50,0,25,0,0,0,0,75
Jan Finney,50,0,0,0,0,0,25,75
Ronald Jhun,0,50,0,0,0,0,25,75
Rodney Wallace,0,0,75,0,0,0,0,75
Jimmy Ambriz,50,25,0,0,0,0,0,75
Alex Reyes,50,0,25,0,0,0,0,75
Yuhi Sano,25,50,0,0,0,0,0,75
Jeremy Jackson,25,50,0,0,0,0,0,75
Akira Kikuchi,0,0,0,0,25,49,0,74
Victor Valimaki,25,0,0,0,25,22,0,72
Juan Puerta,0,0,0,0,70,0,0,70
Alice Ardelean,0,0,25,0,25,20,0,70
Gisele Moreira,0,0,0,0,70,0,0,70
Lucrezia Ria,0,0,0,0,70,0,0,70
Yusuke Kawaguchi,0,0,0,0,70,0,0,70
Jeff Joslin,0,0,25,0,25,18,0,68
Willamy Freire,0,0,25,0,25,18,0,68
Ruben Villareal,50,0,0,0,0,16,0,66
Antonio McKee,25,0,0,0,25,15,0,65
Phil Cardella,0,0,25,0,25,15,0,65
Patrick Murphy,0,0,0,25,0,39,0,64
Colin Fletcher,0,0,50,0,0,14,0,64
Steve Montgomery,25,0,25,0,0,14,0,64
Ali AlQaisi,0,0,25,0,25,14,0,64
Antonio Dos Santos,50,0,0,0,0,13,0,63
JR Coughran,0,25,0,0,0,38,0,63
Kultar Gill,0,25,25,0,0,13,0,63
Roldan Sangcha'an,0,25,25,0,0,13,0,63
Joe Lowry,25,0,25,0,0,12,0,62
Barb Honchak,25,0,0,0,25,12,0,62
Joshua Weems,25,25,0,0,0,12,0,62
TJ Laramie,0,25,25,0,0,12,0,62
Nohelin Hernandez,0,50,0,0,0,12,0,62
Brodie Farber,25,0,25,0,0,12,0,62
Denis Stojnic,25,25,0,0,0,12,0,62
Malik Lewis,25,0,25,0,0,11,0,61
Kiefer Crosbie,0,50,0,0,0,10,0,60
Taneisha Tennant,0,0,25,0,0,34,0,59
Eduardo Neves,25,25,0,0,0,9,0,59
Dylan Mantello,0,50,0,0,0,9,0,59
Jessica Rakoczy,25,0,25,0,0,8,0,58
Sergio Gomez,0,25,25,0,0,8,0,58
Bernardo Magalhaes,0,0,25,0,25,8,0,58
Paulo Renato Junior,25,0,25,0,0,8,0,58
Nandor Guelmino,25,25,0,0,0,7,0,57
Leonardo Guimaraes,0,25,25,0,0,7,0,57
Kestutis Smirnovas,25,25,0,0,0,7,0,57
Gideon Ray,25,25,0,0,0,7,0,57
Allan Zuniga,0,0,0,25,0,32,0,57
Jacob Silva,0,25,25,0,0,7,0,57
Aaron Jeffery,0,25,25,0,0,7,0,57
Danny Mitchell,0,0,50,0,0,6,0,56
Jose Landi-Jons,0,25,25,0,0,6,0,56
Razak Al-Hassan,0,25,0,0,25,6,0,56
Cesar Arzamendia,50,0,0,0,0,6,0,56
Nissen Osterneck,25,0,0,0,25,6,0,56
Anton Zafir,50,0,0,0,0,6,0,56
Joey Gambino,0,25,25,0,0,6,0,56
Grigory Popov,25,0,0,0,25,5,0,55
Steve Judson,50,0,0,0,0,5,0,55
Anthony Morrison,0,50,0,0,0,5,0,55
Larry Cureton,0,50,0,0,0,5,0,55
Cristina Stanciu,25,0,25,0,0,4,0,54
Wagner Prado,0,50,0,0,0,4,0,54
Michal Figlak,0,0,50,0,0,4,0,54
Kwan Ho Kwak,25,0,25,0,0,4,0,54
Juan Manuel Puig,50,0,0,0,0,4,0,54
JunYoung Hong,0,0,25,0,25,4,0,54
Anthony Lapsley,25,0,25,0,0,3,0,53
Vitor Ribeiro,0,0,25,0,25,3,0,53
Nikolay Veretennikov,0,0,25,0,25,3,0,53
Scott Shaffer,0,0,25,0,0,28,0,53
Kyle Dietz,0,50,0,0,0,3,0,53
Hayder Hassan,0,50,0,0,0,3,0,53
Royce Alger,25,25,0,0,0,3,0,53
Oliver Enkamp,25,0,25,0,0,3,0,53
Elaina Maxwell,0,0,50,0,0,3,0,53
Yuki Sasaki,0,0,50,0,0,2,0,52
Mike Campbell,25,25,0,0,0,2,0,52
Juancamilo Ronderos,0,50,0,0,0,2,0,52
Fernando Bruno,0,25,25,0,0,2,0,52
Felipe Olivieri,0,25,0,0,0,27,0,52
Cameron VanCamp,50,0,0,0,0,2,0,52
Ulysses Gomez,25,0,25,0,0,2,0,52
Mike King,0,25,0,0,0,27,0,52
John Cofer,25,25,0,0,0,1,0,51
Joe Charles,0,50,0,0,0,1,0,51
Paul Rodriguez,0,50,0,0,0,1,0,51
David Lee,0,50,0,0,0,1,0,51
Leonardo Morales,0,25,25,0,0,1,0,51
Alex Ricci,25,0,25,0,0,1,0,51
Wes Combs,0,50,0,0,0,1,0,51
Jorge Lopez,0,0,25,0,25,1,0,51
Greg Rebello,50,0,0,0,0,1,0,51
Tommy Hayden,0,50,0,0,0,1,0,51
Emily Kagan,0,25,25,0,0,1,0,51
Tim Lajcik,25,0,25,0,0,1,0,51
Naho Sugiyuma,0,25,0,0,0,1,25,51
Kristof Midoux,25,25,0,0,0,1,0,51
Amir Rahnavardi,25,25,0,0,0,1,0,51
Mark Holst,0,25,25,0,0,1,0,51
Flavio Luiz Moura,0,50,0,0,0,1,0,51
Tim Williams,50,0,0,0,0,1,0,51
Caros Fodor,0,25,0,0,25,1,0,51
Mike Jackson,25,25,0,0,0,1,0,51
Siala Siliga,0,50,0,0,0,0,0,50
Ramiro Hernandez,0,25,25,0,0,0,0,50
Stefan Sekulic,0,0,25,0,25,0,0,50
Andre Gusmao,25,0,25,0,0,0,0,50
Brandon Wolff,25,25,0,0,0,0,0,50
Karl Reed,0,25,25,0,0,0,0,50
Dan Stittgen,25,0,0,0,25,0,0,50
Elias Garcia,0,25,25,0,0,0,0,50
Cole Williams,0,50,0,0,0,0,0,50
Ednaldo Oliveira,0,25,25,0,0,0,0,50
Yoshiaki Yatsu,50,0,0,0,0,0,0,50
Edson Drago,0,50,0,0,0,0,0,50
Bobby Hoffman,25,0,0,0,25,0,0,50
Chase Gormley,25,25,0,0,0,0,0,50
KB Bhullar,25,0,25,0,0,0,0,50
Takenori Sato,50,0,0,0,0,0,0,50
Tom DeBlass,0,0,25,25,0,0,0,50
Joe Brammer,0,25,25,0,0,0,0,50
Micheal Gillmore,25,25,0,0,0,0,0,50
Motonobu Tezuka,0,0,25,0,25,0,0,50
Quang Le,25,0,25,0,0,0,0,50
Carlos Huachin,25,0,25,0,0,0,0,50
Daniel Jolly,50,0,0,0,0,0,0,50
Cody East,50,0,0,0,0,0,0,50
Joe Veres,50,0,0,0,0,0,0,50
Rostem Akman,0,0,50,0,0,0,0,50
Samy Schiavo,25,25,0,0,0,0,0,50
Brian Houston,0,25,0,0,25,0,0,50
Carlton Minus,0,0,50,0,0,0,0,50
Tae Hyun Lee,50,0,0,0,0,0,0,50
Jonavin Webb,0,0,25,0,25,0,0,50
Dileno Lopes,0,0,25,0,25,0,0,50
Mike Stumpf,0,25,25,0,0,0,0,50
Clint Godfrey,0,25,25,0,0,0,0,50
Rob Yundt,0,50,0,0,0,0,0,50
Steve Kennedy,0,25,25,0,0,0,0,50
Bruno Souza,0,0,50,0,0,0,0,50
Jesse Butler,25,0,25,0,0,0,0,50
Amilcar Alves,0,25,25,0,0,0,0,50
Doug Evans,25,0,25,0,0,0,0,50
Edilberto de Oliveira,50,0,0,0,0,0,0,50
Mitch Raposo,0,25,0,0,25,0,0,50
Josh Ferguson,0,25,25,0,0,0,0,50
Dae Won Kim,25,25,0,0,0,0,0,50
Shane Howell,0,25,25,0,0,0,0,50
YeDam Seo,0,0,50,0,0,0,0,50
Anthony Adams,0,0,25,0,25,0,0,50
Jason Gilliam,0,50,0,0,0,0,0,50
Brandon Jenkins,50,0,0,0,0,0,0,50
Pat Audinwood,0,25,25,0,0,0,0,50
Ryan McGivern,0,25,0,0,0,0,25,50
John Hosman,0,25,25,0,0,0,0,50
Nobuhiro Obiya,0,0,50,0,0,0,0,50
Emmanuel Yarborough,50,0,0,0,0,0,0,50
Alexandre Dantas,50,0,0,0,0,0,0,50
Dan Evensen,50,0,0,0,0,0,0,50
Cain Carrizosa,0,25,25,0,0,0,0,50
Mike Lullo,25,0,25,0,0,0,0,50
Joseph Sandoval,50,0,0,0,0,0,0,50
Moti Horenstein,50,0,0,0,0,0,0,50
Gabe Lemley,25,0,0,0,0,0,25,50
Justin Haskins,50,0,0,0,0,0,0,50
CJ Keith,25,25,0,0,0,0,0,50
Keith Berry,50,0,0,0,0,0,0,50
James Bochnovic,25,25,0,0,0,0,0,50
Antonio Trocoli,25,25,0,0,0,0,0,50
Josh Copeland,25,0,25,0,0,0,0,50
Ronys Torres,0,0,25,0,25,0,0,50
Angel Pacheco,0,0,50,0,0,0,0,50
Mohammad Yahya,25,0,25,0,0,0,0,50
Todd Brown,25,0,25,0,0,0,0,50
Tim Gorman,0,0,50,0,0,0,0,50
Alberto Uda,25,25,0,0,0,0,0,50
Craig White,25,0,25,0,0,0,0,50
Colin Robinson,50,0,0,0,0,0,0,50
Ericka Almeida,0,0,50,0,0,0,0,50
Townsend Saunders,0,0,25,0,25,0,0,50
Jeff Cox,0,50,0,0,0,0,0,50
Matt Bessette,0,0,25,0,25,0,0,50
Jim Wallhead,0,25,0,0,25,0,0,50
Ryuki Ueyama,0,0,25,0,25,0,0,50
Vince Cachero,25,0,25,0,0,0,0,50
Milton Vieira,0,0,25,0,25,0,0,50
Liudvik Sholinian,0,0,50,0,0,0,0,50
Roman Salazar,0,50,0,0,0,0,0,50
Mitch Ramirez,50,0,0,0,0,0,0,50
Miika Mehmet,25,0,0,0,0,0,25,50
Reese Andy,25,0,25,0,0,0,0,50
Christophe Leninger,25,0,25,0,0,0,0,50
Ozzy Diaz,50,0,0,0,0,0,0,50
Carl Deaton,0,25,25,0,0,0,0,50
Steve Vigneault,25,25,0,0,0,0,0,50
Anthony Ivy,25,0,25,0,0,0,0,50
Jorge de Oliveira,0,25,25,0,0,0,0,50
Zach Light,0,50,0,0,0,0,0,50
Rolando Perez,25,25,0,0,0,0,0,50
Shannon Ritch,0,50,0,0,0,0,0,50
Yibugele,0,0,50,0,0,0,0,50
John Halverson,25,0,25,0,0,0,0,50
Jose Daniel Medina,0,0,50,0,0,0,0,50
Fabio Nascimento,0,25,25,0,0,0,0,50
Ryan MacDonald,25,0,25,0,0,0,0,50
Koji Oishi,25,0,0,25,0,0,0,50
Larissa Pacheco,25,25,0,0,0,0,0,50
Don Shainis,0,25,25,0,0,0,0,50
Brogan Walker,25,0,25,0,0,0,0,50
Ben Wall,50,0,0,0,0,0,0,50
Brock Jardine,0,25,25,0,0,0,0,50
Mark Striegl,50,0,0,0,0,0,0,50
Chris Price,25,25,0,0,0,0,0,50
Michael McBride,25,0,25,0,0,0,0,50
Courtney Buck,25,25,0,0,0,0,0,50
Roger Hollett,0,0,50,0,0,0,0,50
Harris Sarmiento,25,25,0,0,0,0,0,50
Zane Frazier,50,0,0,0,0,0,0,50
Horacio Gutierrez,25,0,25,0,0,0,0,50
Alton Cunningham,25,0,25,0,0,0,0,50
Donny Walker,0,25,25,0,0,0,0,50
Yusuke Kasuya,25,0,25,0,0,0,0,50
Danny Abbadi,0,25,0,0,25,0,0,50
Johil de Oliveira,0,25,25,0,0,0,0,50
Tetsuji Kato,0,0,50,0,0,0,0,50
Reyes Cortez Jr.,0,0,50,0,0,0,0,50
Mike French,0,0,50,0,0,0,0,50
Alberto Crane,50,0,0,0,0,0,0,50
Chris Avila,0,0,50,0,0,0,0,50
Fabiano Scherner,50,0,0,0,0,0,0,50
Brian Gassaway,25,25,0,0,0,0,0,50
Ricky Rainey,50,0,0,0,0,0,0,50
Kris Moutinho,50,0,0,0,0,0,0,50
Jacob Rosales,25,0,25,0,0,0,0,50
Yuji Nagata,50,0,0,0,0,0,0,50
Terrence Mitchell,50,0,0,0,0,0,0,50
Thomas Gifford,25,0,25,0,0,0,0,50
Luan Lacerda,25,0,25,0,0,0,0,50
AJ Cunningham,50,0,0,0,0,0,0,50
Michael Patt,50,0,0,0,0,0,0,50
Jin Soo Son,0,0,50,0,0,0,0,50
Hernani Perpetuo,0,0,25,0,25,0,0,50
Alex Schoenauer,25,0,25,0,0,0,0,50
Dashon Johnson,0,50,0,0,0,0,0,50
Oli Thompson,25,25,0,0,0,0,0,50
Paul Redmond,25,0,25,0,0,0,0,50
Rob Wilkinson,50,0,0,0,0,0,0,50
Michiyoshi Ohara,0,0,50,0,0,0,0,50
Jesse Fujarczyk,25,25,0,0,0,0,0,50
Chad Reiner,25,0,25,0,0,0,0,50
Tyler Stinson,0,0,25,0,25,0,0,50
Enrique Marin,0,0,25,0,25,0,0,50
Ivan Serati,50,0,0,0,0,0,0,50
Greg McIntyre,25,25,0,0,0,0,0,50
Andreas Stahl,25,0,25,0,0,0,0,50
Sheila Gaff,50,0,0,0,0,0,0,50
Mehdi Baghdad,0,25,0,0,25,0,0,50
John Marsh,0,0,50,0,0,0,0,50
Takayo Hashi,0,0,25,0,0,0,25,50
Jason Novelli,25,0,0,0,25,0,0,50
Gaetano Pirrello,25,25,0,0,0,0,0,50
Yanis Ghemmouri,50,0,0,0,0,0,0,50
Jose Maria,50,0,0,0,0,0,0,50
Justin Jones,0,0,50,0,0,0,0,50
TJ Cook,25,25,0,0,0,0,0,50
Michel Quinones,25,0,25,0,0,0,0,50
David Dodd,0,0,50,0,0,0,0,50
James Zikic,0,0,50,0,0,0,0,50
Wendell Oliveira Marques,50,0,0,0,0,0,0,50
Xavier Foupa-Pokam,25,0,25,0,0,0,0,50
Virgil Zwicker,25,0,25,0,0,0,0,50
Valeri Ignatov,25,0,25,0,0,0,0,50
Elvis Mutapcic,25,0,25,0,0,0,0,50
Derrick Krantz,25,0,25,0,0,0,0,50
Ansar Chalangov,25,25,0,0,0,0,0,50
Pearl Gonzalez,0,25,25,0,0,0,0,50
Anna Elmose,25,0,25,0,0,0,0,50
Suman Mokhtarian,25,0,25,0,0,0,0,50
Dakota Bush,25,0,25,0,0,0,0,50
JC Cottrell,0,25,25,0,0,0,0,50
Mike Bencic,50,0,0,0,0,0,0,50
Charlie Ward,50,0,0,0,0,0,0,50
Bendy Casimir,25,25,0,0,0,0,0,50
Azamat Gashimov,25,25,0,0,0,0,0,50
Chris Heatherly,25,25,0,0,0,0,0,50
Christian Colombo,0,50,0,0,0,0,0,50
Yasuhiro Urushitani,25,0,25,0,0,0,0,50
Nick Penner,50,0,0,0,0,0,0,50
Carls John De Tomas,0,25,25,0,0,0,0,50
Josh Clopton,0,0,50,0,0,0,0,50
Joe Vedepo,25,25,0,0,0,0,0,50
Jamey Simmons,25,25,0,0,0,0,0,50
Nick Aguirre,0,25,25,0,0,0,0,50
Marcos Mariano,0,25,25,0,0,0,0,50
Anthony Christodoulou,25,25,0,0,0,0,0,50
Jesse Strader,50,0,0,0,0,0,0,50
Dion Staring,25,25,0,0,0,0,0,50
Besam Yousef,0,25,0,0,25,0,0,50
Chan-Mi Jeon,0,0,25,0,25,0,0,50
David Baron,0,50,0,0,0,0,0,50
Shimon Smotritsky,25,25,0,0,0,0,0,50
Val Woodburn,25,0,25,0,0,0,0,50
Wagner Silva,0,50,0,0,0,0,0,50
Byron Bloodworth,50,0,0,0,0,0,0,50
Jay Silva,0,0,50,0,0,0,0,50
Landon Quinones,0,0,50,0,0,0,0,50
Julio Paulino,0,0,50,0,0,0,0,50
Brandon Lewis,0,0,50,0,0,0,0,50
Justin Sumter,50,0,0,0,0,0,0,50
Mats Nilsson,25,0,25,0,0,0,0,50
Joao Zeferino,0,0,50,0,0,0,0,50
Ashkan Mokhtarian,25,0,25,0,0,0,0,50
Keisuke Fujiwara,0,0,50,0,0,0,0,50
Jordan Radev,25,0,25,0,0,0,0,50
Cameron Else,50,0,0,0,0,0,0,50
Gabriel Silva,0,0,50,0,0,0,0,50
Leo Kuntz,0,25,0,0,25,0,0,50
Konstantin Erokhin,0,0,50,0,0,0,0,50
Rin Nakai,0,0,50,0,0,0,0,50
Danilo Belluardo,50,0,0,0,0,0,0,50
Alex Soto,25,0,25,0,0,0,0,50
Canaan Kawaihae,25,0,25,0,0,0,0,50
Rodrigo de Lima,25,0,25,0,0,0,0,50
Jason Godsey,0,50,0,0,0,0,0,50
Jakob Lovstad,25,0,0,0,0,0,25,50
Steve Lopez,25,0,0,0,25,0,0,50
Bruno Korea,25,25,0,0,0,0,0,50
Marcos Galvao,50,0,0,0,0,0,0,50
TJ O'Brien,25,25,0,0,0,0,0,50
Ryan Thomas,0,50,0,0,0,0,0,50
Dos Caras Jr.,25,0,25,0,0,0,0,50
Josh Shockley,25,0,25,0,0,0,0,50
Kyle Prepolec,0,0,50,0,0,0,0,50
Kai Asakura,0,25,0,0,0,0,25,50
Victor Rodriguez,50,0,0,0,0,0,0,50
Noah Thomas,25,25,0,0,0,0,0,50
Jack May,50,0,0,0,0,0,0,50
Antonio Mendes,50,0,0,0,0,0,0,50
Joseph Gigliotti,0,25,25,0,0,0,0,50
Trenell Young,25,25,0,0,0,0,0,50
David Kaplan,0,25,0,0,25,0,0,50
Chris Indich,25,0,25,0,0,0,0,50
Solomon Renfro,0,0,0,0,25,25,0,50
Luis Ramos,50,0,0,0,0,0,0,50
Brad Morris,50,0,0,0,0,0,0,50
Jason Tan,50,0,0,0,0,0,0,50
Richardson Moreira,25,0,0,0,25,0,0,50
Luke Flores,0,50,0,0,0,0,0,50
Marcin Bandel,50,0,0,0,0,0,0,50
Brendon Marotte,25,25,0,0,0,0,0,50
Nick Fiore,0,0,50,0,0,0,0,50
Lolohea Mahe,50,0,0,0,0,0,0,50
Pat Schilling,0,25,25,0,0,0,0,50
Alexis Dufresne,0,0,50,0,0,0,0,50
Tateki Matsuda,0,0,25,0,25,0,0,50
Mateo Vogel,0,0,25,0,0,24,0,49
Micol Di Segni,0,0,25,0,0,24,0,49
Duda Santana,0,25,0,0,0,23,0,48
Patrik White,25,0,0,0,0,20,0,45
Mike Seal,25,0,0,0,0,17,0,42
Shoji Maruyama,0,0,25,0,0,17,0,42
Dave Galera,0,0,25,0,0,17,0,42
Sam Greco,0,0,0,0,25,16,0,41
Jose Palacios,0,0,25,0,0,15,0,40
Tiffany Masters,0,25,0,0,0,14,0,39
Davi Bittencourt,25,0,0,0,0,14,0,39
Brandon Cash,0,25,0,0,0,14,0,39
Alejandro Flores,0,25,0,0,0,13,0,38
Tyler Diamond,0,0,0,25,0,13,0,38
Jean Francois Lenogue,0,0,25,0,0,13,0,38
Joe Merritt,0,0,25,0,0,12,0,37
Jared Rollins,25,0,0,0,0,11,0,36
Jaime Jara,0,0,25,0,0,11,0,36
Jorge Ortiz,0,0,25,0,0,11,0,36
Scott Junk,0,25,0,0,0,11,0,36
Yuri Panferov,0,25,0,0,0,11,0,36
Wade Shipp,25,0,0,0,0,10,0,35
KyuSung Kim,0,0,25,0,0,10,0,35
Cameron Dollar,0,25,0,0,0,10,0,35
Mike Polchlopek,0,0,25,0,0,10,0,35
Michael Cora,0,0,25,0,0,10,0,35
Louis Taylor,25,0,0,0,0,10,0,35
Angelo Trevino,0,25,0,0,0,10,0,35
Steve Nelmark,25,0,0,0,0,9,0,34
Nazareno Malegarie,0,0,0,0,25,9,0,34
Al Matavao,25,0,0,0,0,8,0,33
Anying Wang,25,0,0,0,0,8,0,33
Taylor Johnson,0,25,0,0,0,7,0,32
Yurij Kiseliov,0,25,0,0,0,7,0,32
Rodney Faverus,0,0,25,0,0,7,0,32
Brian Sleeman,0,25,0,0,0,7,0,32
Robert Densley,0,25,0,0,0,7,0,32
George Bush,0,25,0,0,0,7,0,32
Jesse Juarez,0,25,0,0,0,7,0,32
Teddy Ash,0,0,25,0,0,7,0,32
Derrick Noble,25,0,0,0,0,7,0,32
Brian Schwartz,0,0,25,0,0,6,0,31
Shonte Barnes,0,25,0,0,0,6,0,31
Brian Lo-A-Njoe,0,25,0,0,0,6,0,31
Kenneth Seegrist,0,25,0,0,0,6,0,31
Alex Andrade,0,0,25,0,0,6,0,31
Bob Schrijber,0,25,0,0,0,6,0,31
Corinne Laframboise,0,25,0,0,0,6,0,31
Dayana Silva,0,0,0,0,25,6,0,31
Marilia Santos,0,0,0,0,25,5,0,30
Stewart Nicoll,0,25,0,0,0,5,0,30
Kazuma Maruyama,0,25,0,0,0,5,0,30
Roybert Echeverria,25,0,0,0,0,5,0,30
Jason Jackson,25,0,0,0,0,5,0,30
Jamie Yager,25,0,0,0,0,5,0,30
Nasrudin Nasrudinov,0,25,0,0,0,5,0,30
Lisa Kyriacou,0,0,0,0,25,4,0,29
Christina Marks,0,25,0,0,0,4,0,29
Jordan Vucenic,0,0,25,0,0,4,0,29
Cam Rowston,0,0,25,0,0,4,0,29
Juan Andres Luna,0,0,0,0,25,4,0,29
Rafael  Del Real,0,25,0,0,0,4,0,29
Mychal Clark,0,0,0,0,0,29,0,29
Rodrigo Lidio,0,25,0,0,0,3,0,28
Lucasz Sudolski,25,0,0,0,0,3,0,28
Mike Moreno,0,0,25,0,0,3,0,28
Eli Aronov,0,25,0,0,0,3,0,28
Errol Zimmerman,0,25,0,0,0,3,0,28
Alexander Morgan,0,25,0,0,0,3,0,28
Gary Padilla,0,0,0,0,25,3,0,28
Bobby McAndrews,0,25,0,0,0,3,0,28
Vinicius Cenci,0,25,0,0,0,2,0,27
Kyle Sturgeon,0,25,0,0,0,2,0,27
Won Sik Park,25,0,0,0,0,2,0,27
Lucio Linhares,0,25,0,0,0,2,0,27
Masanori Suda,0,25,0,0,0,2,0,27
Ernie Verdicia,0,25,0,0,0,2,0,27
Lucas Gamaza,25,0,0,0,0,2,0,27
Luis Santos,25,0,0,0,0,2,0,27
Ren Ozaki,0,0,25,0,0,2,0,27
Brandon Melendez,0,25,0,0,0,2,0,27
Bryan Vetell,25,0,0,0,0,2,0,27
Chris Hofmann,25,0,0,0,0,2,0,27
Scott Norton,0,25,0,0,0,2,0,27
Drew Dimanlig,0,25,0,0,0,2,0,27
Rodolfo Rubio Perez,0,0,25,0,0,2,0,27
Joao Roque,0,0,25,0,0,1,0,26
Amiran Gogoladze,0,25,0,0,0,1,0,26
David Hood,0,25,0,0,0,1,0,26
Alvin Cacdac,0,25,0,0,0,1,0,26
Leonardo Silva de Oliveira,0,25,0,0,0,1,0,26
Won Jin Eoh,25,0,0,0,0,1,0,26
Emiliano Sordi,0,25,0,0,0,1,0,26
Philip Preece,0,0,25,0,0,1,0,26
Harry Moskowitz,0,0,0,0,25,1,0,26
Alejandro Garcia,0,25,0,0,0,1,0,26
Clay French,0,25,0,0,0,1,0,26
Marcus Bossett,0,25,0,0,0,1,0,26
Nathan Jones,0,25,0,0,0,1,0,26
Dennis Reed,0,25,0,0,0,1,0,26
Minoki Ichihara,0,25,0,0,0,1,0,26
Liliya Shakirova,0,25,0,0,0,1,0,26
Paul Georgieff,0,25,0,0,0,1,0,26
Maurice Mitchell,0,25,0,0,0,1,0,26
Kyron Bowen,0,25,0,0,0,1,0,26
Tom Blackledge,0,25,0,0,0,1,0,26
Ariel Beck,25,0,0,0,0,1,0,26
Scott Fiedler,25,0,0,0,0,1,0,26
Branko Cikatic,0,25,0,0,0,1,0,26
Lee Kwan Bum,0,25,0,0,0,1,0,26
Dmitri Stepanov,0,25,0,0,0,1,0,26
Sarah D'alelio,0,25,0,0,0,1,0,26
Joe Martin,0,0,25,0,0,0,0,25
Julian Sanchez,0,25,0,0,0,0,0,25
Jarrod Kwitty,25,0,0,0,0,0,0,25
Khadzhi Bestaev,25,0,0,0,0,0,0,25
Balajin,0,0,25,0,0,0,0,25
Helio Dipp,0,25,0,0,0,0,0,25
Ray Steinbeiss,0,25,0,0,0,0,0,25
Carl Toomey,0,25,0,0,0,0,0,25
Frank Caracci,25,0,0,0,0,0,0,25
Gregory Bouchelaghem,0,0,25,0,0,0,0,25
Neil Grove,0,25,0,0,0,0,0,25
Gugun Gusman,0,25,0,0,0,0,0,25
Chris Birchler,25,0,0,0,0,0,0,25
Lloyd Van Dams,25,0,0,0,0,0,0,25
Josh Thornburg,0,0,25,0,0,0,0,25
Yuya Shirai,0,25,0,0,0,0,0,25
Jhonata Silva,25,0,0,0,0,0,0,25
Magno Almeida,0,0,25,0,0,0,0,25
Gauge Young,0,0,25,0,0,0,0,25
Matt Lucas,0,0,0,25,0,0,0,25
Ron van Clief,0,25,0,0,0,0,0,25
Mike Bourke,0,25,0,0,0,0,0,25
Billy Miles,0,25,0,0,0,0,0,25
Carlos Vera,0,0,25,0,0,0,0,25
Jesse Sanders,0,25,0,0,0,0,0,25
Kenji Arai,25,0,0,0,0,0,0,25
Min Soo Kim,25,0,0,0,0,0,0,25
Ashe Bowman,25,0,0,0,0,0,0,25
Kotetsu Boku,0,0,25,0,0,0,0,25
Oron Kahlon,0,25,0,0,0,0,0,25
Alex Gorgees,0,0,25,0,0,0,0,25
Brian Cobb,25,0,0,0,0,0,0,25
Peter Petties,25,0,0,0,0,0,0,25
Tom Tuggle,0,25,0,0,0,0,0,25
Hidetaka Monma,25,0,0,0,0,0,0,25
Bruno Assis,0,0,25,0,0,0,0,25
Devin Smyth,0,0,25,0,0,0,0,25
Carlos Mota,0,0,25,0,0,0,0,25
Bazigit Atajev,25,0,0,0,0,0,0,25
Andy Wang,25,0,0,0,0,0,0,25
Rickson Zenidim,0,0,25,0,0,0,0,25
Harvey Park,25,0,0,0,0,0,0,25
Justin Wren,0,0,0,0,25,0,0,25
Melchor Manibusan,25,0,0,0,0,0,0,25
Brandon Foxworth,25,0,0,0,0,0,0,25
Humberto Brown Morrison,0,25,0,0,0,0,0,25
Donovan Beard,0,25,0,0,0,0,0,25
Chris Mierzwiak,0,0,25,0,0,0,0,25
Sherman Pendergarst,25,0,0,0,0,0,0,25
Nick Urso,0,25,0,0,0,0,0,25
Kim In Seok,25,0,0,0,0,0,0,25
Kevin Knabjian,25,0,0,0,0,0,0,25
Victor Valenzuela,0,25,0,0,0,0,0,25
Yoshinori Horie,25,0,0,0,0,0,0,25
Alfred Khashakyan,25,0,0,0,0,0,0,25
Sandra Lavado,0,0,25,0,0,0,0,25
Don Carlo-Clauss,25,0,0,0,0,0,0,25
Ray Seraille,25,0,0,0,0,0,0,25
Aaron Wetherspoon,0,0,25,0,0,0,0,25
Vernon Ramos Ho,25,0,0,0,0,0,0,25
Donald Sanchez,0,25,0,0,0,0,0,25
Khusein Askhabov,0,0,25,0,0,0,0,25
Jair Farias,0,0,25,0,0,0,0,25
Manolo Zecchini,25,0,0,0,0,0,0,25
John Dowdy,25,0,0,0,0,0,0,25
Jamelle Jones,25,0,0,0,0,0,0,25
Bubba Bush,25,0,0,0,0,0,0,25
Jose Canseco,25,0,0,0,0,0,0,25
Emiliano Linares,25,0,0,0,0,0,0,25
Issa Isakov,25,0,0,0,0,0,0,25
Mike Aina,0,0,0,0,25,0,0,25
Edivan Santos,25,0,0,0,0,0,0,25
Colleen Schneider,0,0,25,0,0,0,0,25
Rodrigo Ruas,25,0,0,0,0,0,0,25
Andre Mussi,25,0,0,0,0,0,0,25
Herdem Alacabek,25,0,0,0,0,0,0,25
Bret Bergmark,0,25,0,0,0,0,0,25
Denis Sobolev,0,25,0,0,0,0,0,25
Richard Dalton,0,0,25,0,0,0,0,25
Justin Bruckmann,0,25,0,0,0,0,0,25
Victor Dias,0,0,25,0,0,0,0,25
Jae Hyun Park,0,0,25,0,0,0,0,25
Francois Botha,0,25,0,0,0,0,0,25
Eiji Ishikawa,0,0,25,0,0,0,0,25
Mayana Kellem,0,25,0,0,0,0,0,25
Cale Yarbrough,25,0,0,0,0,0,0,25
Nick Rossborough,0,0,25,0,0,0,0,25
Phil Caracappa,0,0,0,0,25,0,0,25
Leiticia Pestova,25,0,0,0,0,0,0,25
Christian Lohsen,0,0,25,0,0,0,0,25
Kali Robbins,0,0,25,0,0,0,0,25
Carlos Calderon,0,25,0,0,0,0,0,25
Joe Jordan,0,25,0,0,0,0,0,25
Yukio Sakaguchi,25,0,0,0,0,0,0,25
Bruno Carvalho,0,0,25,0,0,0,0,25
Felix Lee Mitchell,0,25,0,0,0,0,0,25
John Teixeira,0,0,0,0,25,0,0,25
Josh Wick,25,0,0,0,0,0,0,25
Cory Hendricks,0,0,0,25,0,0,0,25
David Levicki,25,0,0,0,0,0,0,25
Jimmy Quinlan,25,0,0,0,0,0,0,25
Jesse Murray,25,0,0,0,0,0,0,25
Jesse Moreng,0,25,0,0,0,0,0,25
Teila Tuli,25,0,0,0,0,0,0,25
Joao Pierini,25,0,0,0,0,0,0,25
Ryan McGillivray,0,0,25,0,0,0,0,25
Joe Camacho,0,25,0,0,0,0,0,25
Kevin Szaflarski,0,0,25,0,0,0,0,25
Yoko Takahashi,0,0,25,0,0,0,0,25
Neil Wain,25,0,0,0,0,0,0,25
Eldari Kurtanidze,25,0,0,0,0,0,0,25
Matt Skelton,0,25,0,0,0,0,0,25
Thomas Paull,25,0,0,0,0,0,0,25
Trent Jenkins,0,25,0,0,0,0,0,25
Raul Castillo,0,0,25,0,0,0,0,25
Fabio Silva,25,0,0,0,0,0,0,25
Aurelijus Kerpe,25,0,0,0,0,0,0,25
Pawan Maan,25,0,0,0,0,0,0,25
Herman Renting,0,25,0,0,0,0,0,25
Hugo Cunha,25,0,0,0,0,0,0,25
Mike Altman,25,0,0,0,0,0,0,25
Ashiek Ajim,25,0,0,0,0,0,0,25
Richie Smullen,0,25,0,0,0,0,0,25
Nick Newell,0,0,25,0,0,0,0,25
Mitchell Sipe,25,0,0,0,0,0,0,25
Bruno Oliveira,25,0,0,0,0,0,0,25
Tomomi Iwama,25,0,0,0,0,0,0,25
Nicdali Rivera-Calanoc,0,25,0,0,0,0,0,25
Wallen Del Rosario,0,0,25,0,0,0,0,25
Acacio Dos Santos,0,0,25,0,0,0,0,25
Ray Wizard,0,25,0,0,0,0,0,25
John Salgado,0,25,0,0,0,0,0,25
Will Chope,25,0,0,0,0,0,0,25
Ricardo Prasel,25,0,0,0,0,0,0,25
Junya Kudo,0,25,0,0,0,0,0,25
David Gardner,0,25,0,0,0,0,0,25
Sean Daugherty,0,25,0,0,0,0,0,25
Martin Svensson,25,0,0,0,0,0,0,25
Dylan Lockard,0,25,0,0,0,0,0,25
Alexandre Franca Nogueira,25,0,0,0,0,0,0,25
Allan Begosso,0,0,25,0,0,0,0,25
Austin Bashi,0,0,25,0,0,0,0,25
Hiroyuki Abe,0,25,0,0,0,0,0,25
Sim Kai Xiong,25,0,0,0,0,0,0,25
Steve Mensing,25,0,0,0,0,0,0,25
Gigo Jara,0,25,0,0,0,0,0,25
Saeed Hosseini,25,0,0,0,0,0,0,25
Tyra Parker,0,25,0,0,0,0,0,25
Yazan Hajeh,25,0,0,0,0,0,0,25
Sean Alvarez,25,0,0,0,0,0,0,25
Alexander Poppeck,25,0,0,0,0,0,0,25
Edson Gomez,25,0,0,0,0,0,0,25
Joe Duarte,0,0,0,0,25,0,0,25
Dashawn Boatwright,25,0,0,0,0,0,0,25
Soichi Nishida,0,25,0,0,0,0,0,25
Chris Tickle,0,0,25,0,0,0,0,25
Masanori Tonooka,0,25,0,0,0,0,0,25
Danilo Suzart,25,0,0,0,0,0,0,25
Jong Won Kim,25,0,0,0,0,0,0,25
Josh Appelt,25,0,0,0,0,0,0,25
Egidijus Valavicius,0,25,0,0,0,0,0,25
Alonzo Martinez,0,0,25,0,0,0,0,25
Kengo Watanabe,0,0,25,0,0,0,0,25
Adrian Diaz,0,25,0,0,0,0,0,25
Kaloyan Kolev,25,0,0,0,0,0,0,25
Imani Lee,0,25,0,0,0,0,0,25
Jeremia Siregar,25,0,0,0,0,0,0,25
Alexandre Ferreira,25,0,0,0,0,0,0,25
Tebaris Gordon,25,0,0,0,0,0,0,25
Chris Saunders,0,25,0,0,0,0,0,25
Tatsuya Iwasaki,25,0,0,0,0,0,0,25
Andy Anderson,25,0,0,0,0,0,0,25
Nick Sanzo,0,25,0,0,0,0,0,25
Peggy Morgan,0,0,25,0,0,0,0,25
Pauline Macias,0,0,25,0,0,0,0,25
Angga,25,0,0,0,0,0,0,25
Kristian Rothaermel,0,25,0,0,0,0,0,25
Vitor Vianna,25,0,0,0,0,0,0,25
Wataru Sakata,0,25,0,0,0,0,0,25
Jianping Yang,0,0,25,0,0,0,0,25
Fred Ettish,0,25,0,0,0,0,0,25
Chuck O'Neil,0,0,25,0,0,0,0,25
Aliev Makhmud,25,0,0,0,0,0,0,25
Chris Guillen,25,0,0,0,0,0,0,25
Jay Cucciniello,0,0,25,0,0,0,0,25
Michael Imperato,0,0,25,0,0,0,0,25
Daisuke Sugie,0,25,0,0,0,0,0,25
Josh Diekmann,25,0,0,0,0,0,0,25
Jacobi Jones,0,0,25,0,0,0,0,25
Tony Bonello,25,0,0,0,0,0,0,25
Greg Velasco,0,25,0,0,0,0,0,25
Jose Barreto,25,0,0,0,0,0,0,25
Cheyden Leialoha,0,0,25,0,0,0,0,25
John Kolosci,0,25,0,0,0,0,0,25
Jack Cartwright,0,0,25,0,0,0,0,25
Jimmy Lawson,0,0,25,0,0,0,0,25
Rolles Gracie,25,0,0,0,0,0,0,25
Claudio Mattos,0,25,0,0,0,0,0,25
Mark Scanlon,0,0,25,0,0,0,0,25
Raymond Daniels,0,25,0,0,0,0,0,25
Geronimo dos Santos,25,0,0,0,0,0,0,25
Chris Solomon,0,0,25,0,0,0,0,25
Stephanie Webber,25,0,0,0,0,0,0,25
Hugo Duarte,25,0,0,0,0,0,0,25
Larry Parker,0,0,25,0,0,0,0,25
Fiona Muxlow,0,25,0,0,0,0,0,25
Taiga Iwasaki,25,0,0,0,0,0,0,25
Bill Duvall,0,25,0,0,0,0,0,25
Dylan Potter,0,25,0,0,0,0,0,25
Angel De Anda,0,25,0,0,0,0,0,25
Marc Stevens,0,25,0,0,0,0,0,25
Garrett Gross,0,25,0,0,0,0,0,25
Tom Egan,25,0,0,0,0,0,0,25
John Dixson,0,25,0,0,0,0,0,25
Tatsuya Ando,0,0,25,0,0,0,0,25
Nick Roehrick,25,0,0,0,0,0,0,25
Cesar Gracie,25,0,0,0,0,0,0,25
Alexandre Barros,25,0,0,0,0,0,0,25
Jinnosuke Kashimura,25,0,0,0,0,0,0,25
Nikolajus Cilkinas,0,25,0,0,0,0,0,25
Shunichi Shimizu,0,25,0,0,0,0,0,25
Moise Rimbon,0,0,25,0,0,0,0,25
Rene Kronvold,0,25,0,0,0,0,0,25
Nick Serra,0,0,25,0,0,0,0,25
CM Punk,0,25,0,0,0,0,0,25
David Velasquez,25,0,0,0,0,0,0,25
Derek Downey,0,25,0,0,0,0,0,25
Rick Davis,25,0,0,0,0,0,0,25
Anistavio Medeiros,0,25,0,0,0,0,0,25
Floyd Sword,0,25,0,0,0,0,0,25
Damir Mirenic,25,0,0,0,0,0,0,25
Sean O'Haire,25,0,0,0,0,0,0,25
Tatsuya Saika,25,0,0,0,0,0,0,25
Robert Breslin,0,25,0,0,0,0,0,25
Kaik Brito,0,0,0,25,0,0,0,25
Edson Silva,25,0,0,0,0,0,0,25
Joe Giannetti,0,0,0,0,25,0,0,25
Braxton Smith,25,0,0,0,0,0,0,25
Bryson Kamaka,25,0,0,0,0,0,0,25
Maiju Kujala,0,0,25,0,0,0,0,25
Taylor Moore,0,0,25,0,0,0,0,25
Yukiya Naito,25,0,0,0,0,0,0,25
Erick Wanderlei,25,0,0,0,0,0,0,25
Robert Lucarelli,25,0,0,0,0,0,0,25
Kerry Schall,25,0,0,0,0,0,0,25
Young Sam Jung,0,25,0,0,0,0,0,25
Marcin Wrzosek,0,0,0,0,25,0,0,25
Estefani Almeida,0,0,25,0,0,0,0,25
Lucas Stark,0,25,0,0,0,0,0,25
Koichiro Matsumoto,25,0,0,0,0,0,0,25
Shawn Teed,25,0,0,0,0,0,0,25
Rico Farrington,0,0,25,0,0,0,0,25
Matt Foki,0,25,0,0,0,0,0,25
Josh Hendricks,25,0,0,0,0,0,0,25
Cory Walmsley,0,25,0,0,0,0,0,25
Lance Lawrence,0,0,25,0,0,0,0,25
Donnie Chappell,0,25,0,0,0,0,0,25
Kelly Velasco,0,0,25,0,0,0,0,25
Sergey Ignatov,0,25,0,0,0,0,0,25
Gustavo Gabriel,0,25,0,0,0,0,0,25
Ronaldo Candido,0,0,25,0,0,0,0,25
Willie Peeters,0,25,0,0,0,0,0,25
Gilles Arsene,0,25,0,0,0,0,0,25
Ricardo Barros,25,0,0,0,0,0,0,25
Filip Pejic,0,25,0,0,0,0,0,25
Johnny Sampaio,25,0,0,0,0,0,0,25
Karla Benitez,0,25,0,0,0,0,0,25
Antony Rea,25,0,0,0,0,0,0,25
Melinda Fabian,0,0,0,0,25,0,0,25
Joe Benoit,0,25,0,0,0,0,0,25
Fabio Mello,25,0,0,0,0,0,0,25
Chad Johnson,25,0,0,0,0,0,0,25
Thomas Ramirez,25,0,0,0,0,0,0,25
Maka Watson,0,0,0,25,0,0,0,25
Jaimelene Nievera,25,0,0,0,0,0,0,25
Gerald Strebendt,25,0,0,0,0,0,0,25
Rony Sefo,0,25,0,0,0,0,0,25
Ty Flores,0,0,25,0,0,0,0,25
Dino Pezao,25,0,0,0,0,0,0,25
Eric Smith,0,25,0,0,0,0,0,25
Maiara Amanajas dos Santos,25,0,0,0,0,0,0,25
Gilbert Rael,25,0,0,0,0,0,0,25
Shaun Etchell,0,25,0,0,0,0,0,25
Keiichiro Yamamiya,25,0,0,0,0,0,0,25
Derrick Mehmen,0,0,25,0,0,0,0,25
Josh Bryant,25,0,0,0,0,0,0,25
Ian Murphy,0,25,0,0,0,0,0,25
Klaudia Sygula,25,0,0,0,0,0,0,25
Leonardo Damiani,25,0,0,0,0,0,0,25
Miguel Linares,25,0,0,0,0,0,0,25
James Gray,25,0,0,0,0,0,0,25
Hiroko Yamanaka,0,0,25,0,0,0,0,25
Isabela de Padua,0,0,25,0,0,0,0,25
Karl Amoussou,0,0,25,0,0,0,0,25
Ryan Madigan,25,0,0,0,0,0,0,25
Mario Rivera,0,25,0,0,0,0,0,25
Jon Murphy,25,0,0,0,0,0,0,25
Lorenzo Hood,25,0,0,0,0,0,0,25
Art Jimmerson,0,25,0,0,0,0,0,25
Rainy Martinez,0,25,0,0,0,0,0,25
Dustin Neace,0,25,0,0,0,0,0,25
Chelsea Hackett,25,0,0,0,0,0,0,25
Scott Carson,25,0,0,0,0,0,0,25
Alberta Cerra Leon,0,25,0,0,0,0,0,25
Marcelo Brito,0,0,25,0,0,0,0,25
Alexandru Lungu,25,0,0,0,0,0,0,25
Charlene Gellner,25,0,0,0,0,0,0,25
Israel Albuquerque,25,0,0,0,0,0,0,25
Raimond Magomedaliev,25,0,0,0,0,0,0,25
George Hardwick,0,0,25,0,0,0,0,25
Stephen Ledbetter,0,0,25,0,0,0,0,25
Nariman Abbasov,0,0,25,0,0,0,0,25
Adriano Santos,25,0,0,0,0,0,0,25
Robert Bryczek,0,0,25,0,0,0,0,25
Tomohiko Hashimoto,25,0,0,0,0,0,0,25
Noe Hernandez,0,0,25,0,0,0,0,25
Katsuya Inoue,25,0,0,0,0,0,0,25
Abner Lloveras,0,0,25,0,0,0,0,25
Josh Rafferty,25,0,0,0,0,0,0,25
Ibragim Magomedov,25,0,0,0,0,0,0,25
George Allen,0,0,25,0,0,0,0,25
Eric Wray,0,25,0,0,0,0,0,25
Jermaine Andre,25,0,0,0,0,0,0,25
Janaina Silva,0,25,0,0,0,0,0,25
Joshua Wang-Kim,25,0,0,0,0,0,0,25
Ray Routh,25,0,0,0,0,0,0,25
John Matua,25,0,0,0,0,0,0,25
Chris Mickle,25,0,0,0,0,0,0,25
Yokthai Sithoar,0,25,0,0,0,0,0,25
Claudionor Fontinelle,25,0,0,0,0,0,0,25
Justin Burlinson,25,0,0,0,0,0,0,25
Sean Lally,25,0,0,0,0,0,0,25
Elias Urbina,25,0,0,0,0,0,0,25
James Toney,0,25,0,0,0,0,0,25
Valesca Machado,0,0,25,0,0,0,0,25
Gerry Harris,25,0,0,0,0,0,0,25
Manuel Rodriguez,25,0,0,0,0,0,0,25
Zach Zane,0,0,25,0,0,0,0,25
Matej Penaz,0,25,0,0,0,0,0,25
Michel Batista,0,25,0,0,0,0,0,25
Adrian Serrano,0,0,25,0,0,0,0,25
Mabelly Lima,0,0,25,0,0,0,0,25
Sako Chivitchian,0,0,25,0,0,0,0,25
Armando Villarreal,0,25,0,0,0,0,0,25
Sean Sharaf,25,0,0,0,0,0,0,25
Murad Chunkaiev,0,25,0,0,0,0,0,25
Darrill Schoonover,25,0,0,0,0,0,0,25
Rocky Lee,0,0,25,0,0,0,0,25
Crezio de Souza,25,0,0,0,0,0,0,25
Aaron Wilkinson,0,25,0,0,0,0,0,25
Charlie Kohler,25,0,0,0,0,0,0,25
Zoila Frausto,0,25,0,0,0,0,0,25
James Hammortree,0,0,25,0,0,0,0,25
Jack Morrison,0,25,0,0,0,0,0,25
Kaleio Romero,0,0,25,0,0,0,0,25
Ivan Valenzuela,25,0,0,0,0,0,0,25
Brandon Shuey,0,25,0,0,0,0,0,25
Jonathan Piersma,0,0,25,0,0,0,0,25
Rex Holman,25,0,0,0,0,0,0,25
Jose Henrique,25,0,0,0,0,0,0,25
John Devine,25,0,0,0,0,0,0,25
Ivan Lopez,0,0,25,0,0,0,0,25
Jeff Terry,25,0,0,0,0,0,0,25
Marcos Brigagao,0,0,25,0,0,0,0,25
Craig Zellner,25,0,0,0,0,0,0,25
Clint Coronel,0,0,0,0,25,0,0,25
Patricia Alujas,0,25,0,0,0,0,0,25
Ivan Erslan,0,0,0,0,25,0,0,25
Bryan Travers,0,0,25,0,0,0,0,25
James Barnes,25,0,0,0,0,0,0,25
Ralph Dillon,0,25,0,0,0,0,0,25
Anton Berzin,0,0,0,0,25,0,0,25
Jeremiah Billington,25,0,0,0,0,0,0,25
David Avellan,25,0,0,0,0,0,0,25
Cory Peterson,0,25,0,0,0,0,0,25
Andre Pederneiras,0,0,0,0,0,0,25,25
Jeff Newton,0,25,0,0,0,0,0,25
Ryan Parker,0,25,0,0,0,0,0,25
Jason Thacker,25,0,0,0,0,0,0,25
Masuto Kawana,25,0,0,0,0,0,0,25
Nick Agallar,25,0,0,0,0,0,0,25
Yan Pellerin,0,25,0,0,0,0,0,25
Sung Bin Jo,0,0,25,0,0,0,0,25
Raheam Forest,25,0,0,0,0,0,0,25
Lee Higgins,0,25,0,0,0,0,0,25
Richard Jacobi,25,0,0,0,0,0,0,25
Asbel Cancio,25,0,0,0,0,0,0,25
Roberto Romero,0,0,25,0,0,0,0,25
Jhonoven Pati,25,0,0,0,0,0,0,25
Toby Misech,0,0,25,0,0,0,0,25
Bobby Sanchez,0,25,0,0,0,0,0,25
Dan Barrera,0,0,25,0,0,0,0,25
Erik Apple,0,25,0,0,0,0,0,25
John Campetella,25,0,0,0,0,0,0,25
Roberto Traven,0,25,0,0,0,0,0,25
Austin Tweedy,25,0,0,0,0,0,0,25
Nate Schroeder,25,0,0,0,0,0,0,25
Gary Frazier,25,0,0,0,0,0,0,25
Icho Larenas,25,0,0,0,0,0,0,25
Eugenio Tadeu,25,0,0,0,0,0,0,25
Achmed Labasanov,0,0,0,0,25,0,0,25
Scott Baker,0,25,0,0,0,0,0,25
Justin Robbins,0,0,25,0,0,0,0,25
Yuki Ishikawa,25,0,0,0,0,0,0,25
Scott Graham,25,0,0,0,0,0,0,25
Ken Kaneko,0,25,0,0,0,0,0,25
Stefan Klever,25,0,0,0,0,0,0,25
Justin James,0,25,0,0,0,0,0,25
Shang Zhifa,0,0,0,0,25,0,0,25
Eddie Ruiz,0,0,25,0,0,0,0,25
Jason Riley,25,0,0,0,0,0,0,25
Ryuichi Murata,0,25,0,0,0,0,0,25
Richie Hightower,25,0,0,0,0,0,0,25
Jin Oh Kim,0,25,0,0,0,0,0,25
Marcus Jones,25,0,0,0,0,0,0,25
Mando Gutierrez,0,0,25,0,0,0,0,25
Nik Theotikos,0,25,0,0,0,0,0,25
Ryan Stonitsch,0,25,0,0,0,0,0,25
Rico DiSciullo,25,0,0,0,0,0,0,25
Kelly Dullanty,0,25,0,0,0,0,0,25
Stephen Regman,0,25,0,0,0,0,0,25
Paul Herrera,25,0,0,0,0,0,0,25
Karine Gevorgyan,0,25,0,0,0,0,0,25
Manny Vazquez,0,0,25,0,0,0,0,25
Santo Curatolo,0,0,25,0,0,0,0,25
Kasey Tanner,0,0,25,0,0,0,0,25
Chase Gibson,0,0,25,0,0,0,0,25
Cam Teague,25,0,0,0,0,0,0,25
Ho Bae Myeon,25,0,0,0,0,0,0,25
Anvar Boynazarov,25,0,0,0,0,0,0,25
Milco Voorn,0,25,0,0,0,0,0,25
Tony Sylvester,0,25,0,0,0,0,0,25
Nate Smith,0,25,0,0,0,0,0,25
Cindy Dandois,0,0,25,0,0,0,0,25
Jinensibieke Asikeerbai,25,0,0,0,0,0,0,25
Brian Warren,25,0,0,0,0,0,0,25
Takahiro Oba,0,25,0,0,0,0,0,25
Joe Cason,25,0,0,0,0,0,0,25
Osamu Tachihikari,0,25,0,0,0,0,0,25
Todd Gouwenberg,25,0,0,0,0,0,0,25
Eperaim Ginting,0,25,0,0,0,0,0,25
Rudyard Moncayo,0,25,0,0,0,0,0,25
Nayara Maia,0,0,25,0,0,0,0,25
Justin Hawes,25,0,0,0,0,0,0,25
Leon Aliu,25,0,0,0,0,0,0,25
Adam Lynn,25,0,0,0,0,0,0,25
Everett Sims,25,0,0,0,0,0,0,25
Frank Megallon,25,0,0,0,0,0,0,25
Richie Santiago,0,0,25,0,0,0,0,25
Ryo Kawamura,0,0,25,0,0,0,0,25
Chandler Cole,0,25,0,0,0,0,0,25
John Adajar,0,25,0,0,0,0,0,25
Ding Meng,0,0,25,0,0,0,0,25
Achilles Estremadura,0,0,25,0,0,0,0,25
Scott Lighty,25,0,0,0,0,0,0,25
Robbie Ring,25,0,0,0,0,0,0,25
Rilley Dutro,25,0,0,0,0,0,0,25
Baru Harn,0,25,0,0,0,0,0,25
John Renken,0,25,0,0,0,0,0,25
Rick Roufus,0,25,0,0,0,0,0,25
Chad Hanekom,0,0,25,0,0,0,0,25
Mikhail Iloukhine,25,0,0,0,0,0,0,25
Stephen Bass,0,0,25,0,0,0,0,25
Delson Heleno,25,0,0,0,0,0,0,25
Wagner Campos,25,0,0,0,0,0,0,25
Joey Gilbert,25,0,0,0,0,0,0,25
Claudia Leite,0,0,0,0,25,0,0,25
Igor Borisov,0,25,0,0,0,0,0,25
Brady Huang,25,0,0,0,0,0,0,25
Lowell Anderson,25,0,0,0,0,0,0,25
Juan Mott,0,25,0,0,0,0,0,25
Sanford Alton Meeks,25,0,0,0,0,0,0,25
Victor Madrigal,25,0,0,0,0,0,0,25
Colley  Bradford,0,25,0,0,0,0,0,25
Kenneth Alexander,0,0,0,0,25,0,0,25
Ben Sosoli,25,0,0,0,0,0,0,25
Yuma Horiuchi,0,0,25,0,0,0,0,25
Billy Vaughan,0,25,0,0,0,0,0,25
Gleidson Cutis,25,0,0,0,0,0,0,25
Bob Gilstrap,0,25,0,0,0,0,0,25
Ray Perales,0,25,0,0,0,0,0,25
Dylan Salvador,25,0,0,0,0,0,0,25
Gian Siqueira,0,25,0,0,0,0,0,25
Yusaku Nakamura,25,0,0,0,0,0,0,25
Steve Byrnes,0,0,25,0,0,0,0,25
Jadson Costa,25,0,0,0,0,0,0,25
Collin Hart,0,0,25,0,0,0,0,25
Vinicius Queiroz,0,25,0,0,0,0,0,25
Lazar Stojadinovic,25,0,0,0,0,0,0,25
Matt Dixon,25,0,0,0,0,0,0,25
Todd Butler,25,0,0,0,0,0,0,25
Eddie Mendez,0,25,0,0,0,0,0,25
Mark Cherico,25,0,0,0,0,0,0,25
Luis Gomez,0,25,0,0,0,0,0,25
Bentley Syler,25,0,0,0,0,0,0,25
Sam Liera,25,0,0,0,0,0,0,25
Ronal Siahaan,0,25,0,0,0,0,0,25
Kazuhisa Watanabe,0,25,0,0,0,0,0,25
Del Hawkins,0,25,0,0,0,0,0,25
Jason Fairn,25,0,0,0,0,0,0,25
Nate James,0,0,25,0,0,0,0,25
Randall Wallace,0,25,0,0,0,0,0,25
Askar Mozharov,25,0,0,0,0,0,0,25
Igor Zinoviev,25,0,0,0,0,0,0,25
Matthieu Duclos,25,0,0,0,0,0,0,25
James Wallace,0,25,0,0,0,0,0,25
Anthony Leone,0,25,0,0,0,0,0,25
Matt Kovacs,0,0,25,0,0,0,0,25
Dave Dalgliesh,0,25,0,0,0,0,0,25
Paul Creighton,25,0,0,0,0,0,0,25
Angelo Antonio,25,0,0,0,0,0,0,25
Sam Adkins,0,25,0,0,0,0,0,25
Jong Man Kim,0,0,25,0,0,0,0,25
Marcos Conrado Jr.,25,0,0,0,0,0,0,25
Sam Fulton,0,25,0,0,0,0,0,25
Gilbert Aldana,25,0,0,0,0,0,0,25
Aaron Brink,0,25,0,0,0,0,0,25
Chase Waldon,25,0,0,0,0,0,0,25
Jon Manley,0,0,25,0,0,0,0,25
Akihito Tanaka,25,0,0,0,0,0,0,25
Wes Albritton,25,0,0,0,0,0,0,25
Homer Moore,0,25,0,0,0,0,0,25
Chuck Grigsby,25,0,0,0,0,0,0,25
Hilarie Rose,0,0,25,0,0,0,0,25
Dante Rivera,0,0,25,0,0,0,0,25
Federico Lopez,25,0,0,0,0,0,0,25
Jeremiah Constant,25,0,0,0,0,0,0,25
Scott Harper,25,0,0,0,0,0,0,25
Magomed Sultanakhmedov,0,25,0,0,0,0,0,25
Greg Stott,25,0,0,0,0,0,0,25
Lina Kvokov,25,0,0,0,0,0,0,25
Ido Pariente,0,25,0,0,0,0,0,25
Zachary Scroggin,25,0,0,0,0,0,0,25
Art Santore,25,0,0,0,0,0,0,25
Michal Martinek,0,25,0,0,0,0,0,25
Jesse Bongfeldt,0,25,0,0,0,0,0,25
Theo Rlayang,0,0,25,0,0,0,0,25
Tony Juarez,25,0,0,0,0,0,0,25
Desmond Torres,25,0,0,0,0,0,0,25
Guilherme Vasconcelos,0,0,25,0,0,0,0,25
Dave Phillips,0,25,0,0,0,0,0,25
Abdellah Er-Ramy,25,0,0,0,0,0,0,25
Wuziazibieke Jiahefu,0,25,0,0,0,0,0,25
James Giboo,25,0,0,0,0,0,0,25
Tommy Lee,0,25,0,0,0,0,0,25
Brian Geraghty,25,0,0,0,0,0,0,25
Joao Elias,25,0,0,0,0,0,0,25
Kelly Kobold,0,0,25,0,0,0,0,25
Isis Verbeek,0,0,25,0,0,0,0,25
Raou Raou,25,0,0,0,0,0,0,25
Izabela Badurek,0,25,0,0,0,0,0,25
Rana Rudra Pratap Singh,25,0,0,0,0,0,0,25
Darrel Gholar,0,25,0,0,0,0,0,25
Deshaun Johnson,0,0,25,0,0,0,0,25
Tony Petarra,25,0,0,0,0,0,0,25
Katsuaki Furuki,0,0,25,0,0,0,0,25
Ryan Roberts,0,25,0,0,0,0,0,25
Matt Andersen,25,0,0,0,0,0,0,25
Matheus Scheffel,25,0,0,0,0,0,0,25
John Lober,0,25,0,0,0,0,0,25
Mal Foki,25,0,0,0,0,0,0,25
David Roberts,25,0,0,0,0,0,0,25
Eduardo Torres Caut,0,25,0,0,0,0,0,25
Matt Lee,25,0,0,0,0,0,0,25
Minoru Toyonaga,25,0,0,0,0,0,0,25
Kolton Englund,25,0,0,0,0,0,0,25
Houston Dorr,25,0,0,0,0,0,0,25
Sean Gannon,25,0,0,0,0,0,0,25
Korey Kuppe,0,0,25,0,0,0,0,25
Li Yunfeng,0,25,0,0,0,0,0,25
Stevie Lynch,0,25,0,0,0,0,0,25
Shaheen Santana,0,25,0,0,0,0,0,25
Diego Henrique da Silva,0,0,25,0,0,0,0,25
Chris Liguori,0,25,0,0,0,0,0,25
JungHyun Lee,0,0,25,0,0,0,0,25
Leon Shahbazyan,25,0,0,0,0,0,0,25
Jason Suttie,0,25,0,0,0,0,0,25
Alex Torres,0,0,0,0,25,0,0,25
Rubin Williams,0,25,0,0,0,0,0,25
Tina Lahdemaki,0,0,25,0,0,0,0,25
Justin Frazier,0,25,0,0,0,0,0,25
Solomon Hutcherson,25,0,0,0,0,0,0,25
Steven Koslow,25,0,0,0,0,0,0,25
Ravena Oliveira,0,0,25,0,0,0,0,25
Kailan Hill,0,0,25,0,0,0,0,25
Sidney Silva,25,0,0,0,0,0,0,25
Mike Wessel,25,0,0,0,0,0,0,25
Jules Bruchez,0,25,0,0,0,0,0,25
Tsuyoshi Kurihara,25,0,0,0,0,0,0,25
Pedro Otavio,0,25,0,0,0,0,0,25
Tyler Hill,25,0,0,0,0,0,0,25
Joe Son,0,25,0,0,0,0,0,25
Andre Walker,25,0,0,0,0,0,0,25
Jason Ireland,0,25,0,0,0,0,0,25
Leo Sylvest,25,0,0,0,0,0,0,25
Kengo Ura,25,0,0,0,0,0,0,25
Kevin Gray,0,25,0,0,0,0,0,25
Lewis Gonzalez,0,0,25,0,0,0,0,25
Kazunori Yokota,0,0,25,0,0,0,0,25
Chris Sanford,25,0,0,0,0,0,0,25
Roland Payne,25,0,0,0,0,0,0,25
Yuri Vaulin,0,0,25,0,0,0,0,25
Ron Fields,25,0,0,0,0,0,0,25
Carlos Leal,0,0,25,0,0,0,0,25
Jae Suk Lim,0,25,0,0,0,0,0,25
John Doyle,25,0,0,0,0,0,0,25
Thaddeus Luster,0,25,0,0,0,0,0,25
Mario Neto,25,0,0,0,0,0,0,25
Maimaitituoheti Keremuaili,0,0,25,0,0,0,0,25
Artur Oumakhanov,0,0,25,0,0,0,0,25
Hans Nijman,0,25,0,0,0,0,0,25
Rainn Guerrero,0,25,0,0,0,0,0,25
Iouri Kotchkine,25,0,0,0,0,0,0,25
Will Santiago,0,0,25,0,0,0,0,25
Marcus Silveira,0,25,0,0,0,0,0,25
Raquel Pa'aluhi,0,25,0,0,0,0,0,25
Jeremy  Freitag,25,0,0,0,0,0,0,25
Caio Bittencourt,0,25,0,0,0,0,0,25
Tim Catalfo,0,25,0,0,0,0,0,25
Allen Berube,0,25,0,0,0,0,0,25
Bharat Kandare,0,25,0,0,0,0,0,25
Hashem Arkhagha,0,25,0,0,0,0,0,25
Fabio Gurgel,0,0,25,0,0,0,0,25
Chris Condo,25,0,0,0,0,0,0,25
Oscar Cota,0,0,25,0,0,0,0,25
Masakatsu Okuda,25,0,0,0,0,0,0,25
Ross Ebanez,0,25,0,0,0,0,0,25
Dennis Bryant,25,0,0,0,0,0,0,25
Rafael Cerqueira,25,0,0,0,0,0,0,25
Brad Gumm,0,0,25,0,0,0,0,25
Josh Shockman,0,0,25,0,0,0,0,25
Bo Cantrell,25,0,0,0,0,0,0,25
Keith Berish,0,0,25,0,0,0,0,25
Jeremy Lang,0,25,0,0,0,0,0,25
Dinis Paiva Jr.,0,0,25,0,0,0,0,25
Stephanie Frausto,25,0,0,0,0,0,0,25
Bekzat Almakhan,0,0,25,0,0,0,0,25
Chris Haseman,0,0,25,0,0,0,0,25
Sumit Kumar,0,0,25,0,0,0,0,25
Josh Smith,0,0,0,25,0,0,0,25
Rubens Xavier,25,0,0,0,0,0,0,25
Kathryn Paprocki,0,0,25,0,0,0,0,25
Rudy Bears,0,25,0,0,0,0,0,25
Tsuyoshi Tamakairiki,25,0,0,0,0,0,0,25
Kyle Jensen,0,25,0,0,0,0,0,25
Ricky Johnson,25,0,0,0,0,0,0,25
Carter Williams,25,0,0,0,0,0,0,25
Vince Murdock,25,0,0,0,0,0,0,25
Melton Bowen,0,25,0,0,0,0,0,25
Mack Brewer,25,0,0,0,0,0,0,25
Billy Pasulatan,25,0,0,0,0,0,0,25
CJ Hamilton,0,0,25,0,0,0,0,25
Keigo Kunihara,0,25,0,0,0,0,0,25
Jason Guida,0,0,25,0,0,0,0,25
Emrah Sonmez,0,0,25,0,0,0,0,25
Antonio Jones,25,0,0,0,0,0,0,25
Greg Nagy,25,0,0,0,0,0,0,25
Takayuki Okada,0,25,0,0,0,0,0,25
Brady Fink,0,25,0,0,0,0,0,25
Christian Ocon,0,0,25,0,0,0,0,25
Roman Bogatov,0,0,25,0,0,0,0,25
Mikey Gonzalez,25,0,0,0,0,0,0,25
Scott McAfee,0,25,0,0,0,0,0,25
Cameron Church,0,0,25,0,0,0,0,25
Nick Gonzalez,0,25,0,0,0,0,0,25
Maia Stevenson,0,25,0,0,0,0,0,25
SeongChan Hong,25,0,0,0,0,0,0,25
Mariusz Ksiazkiewicz,0,0,25,0,0,0,0,25
Michael Lerma,25,0,0,0,0,0,0,25
Masutatsu Yano,25,0,0,0,0,0,0,25
Tony Halme,0,25,0,0,0,0,0,25
Jansey Silva,0,25,0,0,0,0,0,25
Zachary Borrego,0,25,0,0,0,0,0,25
Dorian Price,0,25,0,0,0,0,0,25
Dieusel Berto,25,0,0,0,0,0,0,25
Lucas Fernando,0,0,25,0,0,0,0,25
Jim Mullen,25,0,0,0,0,0,0,25
James Mulheron,0,0,25,0,0,0,0,25
Mikheil Sazhiniani,25,0,0,0,0,0,0,25
Junior Barata,25,0,0,0,0,0,0,25
Eddy Millis,0,25,0,0,0,0,0,25
Zviad Lazishvili,0,0,25,0,0,0,0,25
Reza Nasri,25,0,0,0,0,0,0,25
Adam Yandiev,0,25,0,0,0,0,0,25
Rafael Freitas,25,0,0,0,0,0,0,25
Frank Lester,0,25,0,0,0,0,0,25
Adam Cella,0,25,0,0,0,0,0,25
Tom Gallicchio,0,0,25,0,0,0,0,25
Amaury Bitetti,25,0,0,0,0,0,0,25
Brandon Saling,25,0,0,0,0,0,0,25
JJ Ambrose,0,25,0,0,0,0,0,25
Jose Alday,0,0,0,0,25,0,0,25
Windri Patilima,25,0,0,0,0,0,0,25
Henrique Shiguemoto,0,25,0,0,0,0,0,25
Dimitiri Wanderley,25,0,0,0,0,0,0,25
Alavutdin Gadjiev,0,25,0,0,0,0,0,25
Ryan Healy,0,0,25,0,0,0,0,25
Donavon Frelow,0,0,0,0,25,0,0,25
Carl Seumanutafa,25,0,0,0,0,0,0,25
Phil Johns,0,25,0,0,0,0,0,25
Luiz Dutra,25,0,0,0,0,0,0,25
Billy Elekana,0,25,0,0,0,0,0,25
Leigh Remedios,0,25,0,0,0,0,0,25
Rama Supandhi,0,0,25,0,0,0,0,25
Joe Pardo,0,25,0,0,0,0,0,25
Gilbert Smith,0,25,0,0,0,0,0,25
Murtaza Talha,25,0,0,0,0,0,0,25
Martin Sano,25,0,0,0,0,0,0,25
Shane Primm,0,25,0,0,0,0,0,25
Dean Barry,0,0,0,0,0,18,0,18
Joey Roberts,0,0,0,0,0,8,0,8
Mark Schultz,0,0,0,0,0,7,0,7
Roger Zapata,0,0,0,0,0,5,0,5
Josh LaBerge,0,0,0,0,0,4,0,4
Mario Piazzon,0,0,0,0,0,2,0,2
Daniel Swain,0,0,0,0,0,0,0,0
Luciano Azevedo,0,0,0,0,0,0,0,0
Max Rohskopf,0,0,0,0,0,0,0,0
Sione Latu,0,0,0,0,0,0,0,0
Alexander Soldatkin,0,0,0,0,0,0,0,0
Motoki Miyazawa,0,0,0,0,0,0,0,0
Kaitlin Young,0,0,0,0,0,0,0,0
Eun Soo Lee,0,0,0,0,0,0,0,0
Andrei Kopylov,0,0,0,0,0,0,0,0
Josh Bennett,0,0,0,0,0,0,0,0
Max Mustaki,0,0,0,0,0,0,0,0
Albert Cheng,0,0,0,0,0,0,0,0
Rodrigo Gripp de Sousa,0,0,0,0,0,0,0,0
Marcelo Aguiar,0,0,0,0,0,0,0,0
Tai Bowden,0,0,0,0,0,0,0,0
Kiril Sidelnikov,0,0,0,0,0,0,0,0
